"","id","home_team","home_score","away_team","away_score","total_score","diff_score","home_win","date","year","month","decade","temperature","humidity","wind_mph"
"1","196009230ram","Los Angeles Rams",21,"St. Louis Cardinals",43,64,-22,FALSE,"9/23/1960",1960,"September","1960s",66,78,8
"2","196009240dal","Dallas Cowboys",28,"Pittsburgh Steelers",35,63,-7,FALSE,"9/24/1960",1960,"September","1960s",72,80,16
"3","196009250gnb","Green Bay Packers",14,"Chicago Bears",17,31,-3,FALSE,"9/25/1960",1960,"September","1960s",60,76,13
"4","196009250sfo","San Francisco 49ers",19,"New York Giants",21,40,-2,FALSE,"9/25/1960",1960,"September","1960s",72,44,10
"5","196009250clt","Baltimore Colts",20,"Washington Redskins",0,20,20,TRUE,"9/25/1960",1960,"September","1960s",62,80,9
"6","196009250phi","Philadelphia Eagles",24,"Cleveland Browns",41,65,-17,FALSE,"9/25/1960",1960,"September","1960s",61,77,9
"7","196009300dal","Dallas Cowboys",25,"Philadelphia Eagles",27,52,-2,FALSE,"9/30/1960",1960,"September","1960s",77,50,11
"8","196010020gnb","Green Bay Packers",28,"Detroit Lions",9,37,19,TRUE,"10/2/1960",1960,"October","1960s",53,78,16
"9","196010020cle","Cleveland Browns",28,"Pittsburgh Steelers",20,48,8,TRUE,"10/2/1960",1960,"October","1960s",54,78,15
"10","196010020clt","Baltimore Colts",42,"Chicago Bears",7,49,35,TRUE,"10/2/1960",1960,"October","1960s",54,76,9
"11","196010020crd","St. Louis Cardinals",14,"New York Giants",35,49,-21,FALSE,"10/2/1960",1960,"October","1960s",72,56,14
"12","196010020sfo","San Francisco 49ers",13,"Los Angeles Rams",9,22,4,TRUE,"10/2/1960",1960,"October","1960s",60,74,12
"13","196010090det","Detroit Lions",10,"San Francisco 49ers",14,24,-4,FALSE,"10/9/1960",1960,"October","1960s",58,62,9
"14","196010090pit","Pittsburgh Steelers",17,"New York Giants",19,36,-2,FALSE,"10/9/1960",1960,"October","1960s",61,72,6
"15","196010090phi","Philadelphia Eagles",31,"St. Louis Cardinals",27,58,4,TRUE,"10/9/1960",1960,"October","1960s",56,65,5
"16","196010090was","Washington Redskins",26,"Dallas Cowboys",14,40,12,TRUE,"10/9/1960",1960,"October","1960s",59,85,1
"17","196010090gnb","Green Bay Packers",35,"Baltimore Colts",21,56,14,TRUE,"10/9/1960",1960,"October","1960s",49,84,6
"18","196010090chi","Chicago Bears",34,"Los Angeles Rams",27,61,7,TRUE,"10/9/1960",1960,"October","1960s",57,69,9
"19","196010160phi","Philadelphia Eagles",28,"Detroit Lions",10,38,18,TRUE,"10/16/1960",1960,"October","1960s",66,88,7
"20","196010160dal","Dallas Cowboys",7,"Cleveland Browns",48,55,-41,FALSE,"10/16/1960",1960,"October","1960s",70,82,12
"21","196010160pit","Pittsburgh Steelers",27,"St. Louis Cardinals",14,41,13,TRUE,"10/16/1960",1960,"October","1960s",62,69,7
"22","196010160chi","Chicago Bears",27,"San Francisco 49ers",10,37,17,TRUE,"10/16/1960",1960,"October","1960s",57,62,14
"23","196010160nyg","New York Giants",24,"Washington Redskins",24,48,0,FALSE,"10/16/1960",1960,"October","1960s",70,77,9
"24","196010160clt","Baltimore Colts",31,"Los Angeles Rams",17,48,14,TRUE,"10/16/1960",1960,"October","1960s",67,81,7
"25","196010230gnb","Green Bay Packers",41,"San Francisco 49ers",14,55,27,TRUE,"10/23/1960",1960,"October","1960s",49,71,21
"26","196010230cle","Cleveland Browns",29,"Philadelphia Eagles",31,60,-2,FALSE,"10/23/1960",1960,"October","1960s",52,61,18
"27","196010230was","Washington Redskins",27,"Pittsburgh Steelers",27,54,0,FALSE,"10/23/1960",1960,"October","1960s",51,64,8
"28","196010230crd","St. Louis Cardinals",12,"Dallas Cowboys",10,22,2,TRUE,"10/23/1960",1960,"October","1960s",61,55,11
"29","196010230det","Detroit Lions",30,"Baltimore Colts",17,47,13,TRUE,"10/23/1960",1960,"October","1960s",53,60,22
"30","196010230ram","Los Angeles Rams",24,"Chicago Bears",24,48,0,FALSE,"10/23/1960",1960,"October","1960s",63,85,7
"31","196010300pit","Pittsburgh Steelers",13,"Green Bay Packers",19,32,-6,FALSE,"10/30/1960",1960,"October","1960s",50,50,7
"32","196010300was","Washington Redskins",10,"Cleveland Browns",31,41,-21,FALSE,"10/30/1960",1960,"October","1960s",54,56,3
"33","196010300ram","Los Angeles Rams",48,"Detroit Lions",35,83,13,TRUE,"10/30/1960",1960,"October","1960s",62,88,6
"34","196010300sfo","San Francisco 49ers",25,"Chicago Bears",7,32,18,TRUE,"10/30/1960",1960,"October","1960s",60,65,9
"35","196010300nyg","New York Giants",13,"St. Louis Cardinals",20,33,-7,FALSE,"10/30/1960",1960,"October","1960s",54,52,27
"36","196010300dal","Dallas Cowboys",7,"Baltimore Colts",45,52,-38,FALSE,"10/30/1960",1960,"October","1960s",65,62,23
"37","196011060sfo","San Francisco 49ers",0,"Detroit Lions",24,24,-24,FALSE,"11/6/1960",1960,"November","1960s",57,87,10
"38","196011060cle","Cleveland Browns",13,"New York Giants",17,30,-4,FALSE,"11/6/1960",1960,"November","1960s",34,91,13
"39","196011060phi","Philadelphia Eagles",34,"Pittsburgh Steelers",7,41,27,TRUE,"11/6/1960",1960,"November","1960s",42,71,12
"40","196011060clt","Baltimore Colts",38,"Green Bay Packers",24,62,14,TRUE,"11/6/1960",1960,"November","1960s",44,65,14
"41","196011060dal","Dallas Cowboys",13,"Los Angeles Rams",38,51,-25,FALSE,"11/6/1960",1960,"November","1960s",52,51,13
"42","196011060crd","St. Louis Cardinals",44,"Washington Redskins",7,51,37,TRUE,"11/6/1960",1960,"November","1960s",44,55,16
"43","196011130nyg","New York Giants",27,"Pittsburgh Steelers",24,51,3,TRUE,"11/13/1960",1960,"November","1960s",48,61,7
"44","196011130cle","Cleveland Browns",28,"St. Louis Cardinals",27,55,1,TRUE,"11/13/1960",1960,"November","1960s",45,60,12
"45","196011130chi","Chicago Bears",20,"Baltimore Colts",24,44,-4,FALSE,"11/13/1960",1960,"November","1960s",47,63,12
"46","196011130det","Detroit Lions",12,"Los Angeles Rams",10,22,2,TRUE,"11/13/1960",1960,"November","1960s",45,59,11
"47","196011130phi","Philadelphia Eagles",19,"Washington Redskins",13,32,6,TRUE,"11/13/1960",1960,"November","1960s",39,68,5
"48","196011130gnb","Green Bay Packers",41,"Dallas Cowboys",7,48,34,TRUE,"11/13/1960",1960,"November","1960s",42,70,12
"49","196011200nyg","New York Giants",10,"Philadelphia Eagles",17,27,-7,FALSE,"11/20/1960",1960,"November","1960s",49,51,12
"50","196011200pit","Pittsburgh Steelers",14,"Cleveland Browns",10,24,4,TRUE,"11/20/1960",1960,"November","1960s",38,72,7
"51","196011200gnb","Green Bay Packers",31,"Los Angeles Rams",33,64,-2,FALSE,"11/20/1960",1960,"November","1960s",41,80,8
"52","196011200chi","Chicago Bears",28,"Detroit Lions",7,35,21,TRUE,"11/20/1960",1960,"November","1960s",43,76,10
"53","196011200dal","Dallas Cowboys",14,"San Francisco 49ers",26,40,-12,FALSE,"11/20/1960",1960,"November","1960s",57,74,11
"54","196011200was","Washington Redskins",14,"St. Louis Cardinals",26,40,-12,FALSE,"11/20/1960",1960,"November","1960s",49,55,5
"55","196011240det","Detroit Lions",23,"Green Bay Packers",10,33,13,TRUE,"11/24/1960",1960,"November","1960s",36,55,10
"56","196011270crd","St. Louis Cardinals",17,"Cleveland Browns",17,34,0,FALSE,"11/27/1960",1960,"November","1960s",63,80,12
"57","196011270clt","Baltimore Colts",22,"San Francisco 49ers",30,52,-8,FALSE,"11/27/1960",1960,"November","1960s",47,83,7
"58","196011270phi","Philadelphia Eagles",31,"New York Giants",23,54,8,TRUE,"11/27/1960",1960,"November","1960s",49,85,7
"59","196011270chi","Chicago Bears",17,"Dallas Cowboys",7,24,10,TRUE,"11/27/1960",1960,"November","1960s",54,90,14
"60","196011270pit","Pittsburgh Steelers",22,"Washington Redskins",10,32,12,TRUE,"11/27/1960",1960,"November","1960s",49,78,11
"61","196012040chi","Chicago Bears",13,"Green Bay Packers",41,54,-28,FALSE,"12/4/1960",1960,"December","1960s",49,50,19
"62","196012040cle","Cleveland Browns",27,"Washington Redskins",16,43,11,TRUE,"12/4/1960",1960,"December","1960s",41,56,12
"63","196012040ram","Los Angeles Rams",7,"San Francisco 49ers",23,30,-16,FALSE,"12/4/1960",1960,"December","1960s",54,58,8
"64","196012040clt","Baltimore Colts",15,"Detroit Lions",20,35,-5,FALSE,"12/4/1960",1960,"December","1960s",38,42,8
"65","196012040nyg","New York Giants",31,"Dallas Cowboys",31,62,0,FALSE,"12/4/1960",1960,"December","1960s",42,56,6
"66","196012040crd","St. Louis Cardinals",6,"Philadelphia Eagles",20,26,-14,FALSE,"12/4/1960",1960,"December","1960s",53,40,16
"67","196012100sfo","San Francisco 49ers",0,"Green Bay Packers",13,13,-13,FALSE,"12/10/1960",1960,"December","1960s",47,83,7
"68","196012110cle","Cleveland Browns",42,"Chicago Bears",0,42,42,TRUE,"12/11/1960",1960,"December","1960s",24,76,15
"69","196012110was","Washington Redskins",3,"New York Giants",17,20,-14,FALSE,"12/11/1960",1960,"December","1960s",36,55,7
"70","196012110pit","Pittsburgh Steelers",27,"Philadelphia Eagles",21,48,6,TRUE,"12/11/1960",1960,"December","1960s",28,76,12
"71","196012110ram","Los Angeles Rams",10,"Baltimore Colts",3,13,7,TRUE,"12/11/1960",1960,"December","1960s",55,72,5
"72","196012110det","Detroit Lions",23,"Dallas Cowboys",14,37,9,TRUE,"12/11/1960",1960,"December","1960s",21,62,16
"73","196012170ram","Los Angeles Rams",21,"Green Bay Packers",35,56,-14,FALSE,"12/17/1960",1960,"December","1960s",54,61,5
"74","196012180was","Washington Redskins",28,"Philadelphia Eagles",38,66,-10,FALSE,"12/18/1960",1960,"December","1960s",29,66,3
"75","196012180det","Detroit Lions",36,"Chicago Bears",0,36,36,TRUE,"12/18/1960",1960,"December","1960s",23,69,18
"76","196012180crd","St. Louis Cardinals",38,"Pittsburgh Steelers",7,45,31,TRUE,"12/18/1960",1960,"December","1960s",33,51,10
"77","196012180sfo","San Francisco 49ers",34,"Baltimore Colts",10,44,24,TRUE,"12/18/1960",1960,"December","1960s",53,87,7
"78","196012180nyg","New York Giants",34,"Cleveland Browns",48,82,-14,FALSE,"12/18/1960",1960,"December","1960s",31,52,14
"79","196012260phi","Philadelphia Eagles",17,"Green Bay Packers",13,30,4,TRUE,"12/26/1960",1960,"December","1960s",28,84,7
"80","196109170min","Minnesota Vikings",37,"Chicago Bears",13,50,24,TRUE,"9/17/1961",1961,"September","1960s",61,63,13
"81","196109170phi","Philadelphia Eagles",27,"Cleveland Browns",20,47,7,TRUE,"9/17/1961",1961,"September","1960s",61,55,13
"82","196109170nyg","New York Giants",10,"St. Louis Cardinals",21,31,-11,FALSE,"9/17/1961",1961,"September","1960s",63,54,18
"83","196109170dal","Dallas Cowboys",27,"Pittsburgh Steelers",24,51,3,TRUE,"9/17/1961",1961,"September","1960s",66,55,11
"84","196109170gnb","Green Bay Packers",13,"Detroit Lions",17,30,-4,FALSE,"9/17/1961",1961,"September","1960s",60,63,9
"85","196109170clt","Baltimore Colts",27,"Los Angeles Rams",24,51,3,TRUE,"9/17/1961",1961,"September","1960s",61,62,12
"86","196109170sfo","San Francisco 49ers",35,"Washington Redskins",3,38,32,TRUE,"9/17/1961",1961,"September","1960s",61,77,9
"87","196109230ram","Los Angeles Rams",17,"Chicago Bears",21,38,-4,FALSE,"9/23/1961",1961,"September","1960s",65,69,10
"88","196109240pit","Pittsburgh Steelers",14,"New York Giants",17,31,-3,FALSE,"9/24/1961",1961,"September","1960s",74,74,5
"89","196109240cle","Cleveland Browns",20,"St. Louis Cardinals",17,37,3,TRUE,"9/24/1961",1961,"September","1960s",74,74,9
"90","196109240dal","Dallas Cowboys",21,"Minnesota Vikings",7,28,14,TRUE,"9/24/1961",1961,"September","1960s",82,64,17
"91","196109240phi","Philadelphia Eagles",14,"Washington Redskins",7,21,7,TRUE,"9/24/1961",1961,"September","1960s",75,70,8
"92","196109240clt","Baltimore Colts",15,"Detroit Lions",16,31,-1,FALSE,"9/24/1961",1961,"September","1960s",78,66,8
"93","196109240gnb","Green Bay Packers",30,"San Francisco 49ers",10,40,20,TRUE,"9/24/1961",1961,"September","1960s",50,90,17
"94","196110010clt","Baltimore Colts",34,"Minnesota Vikings",33,67,1,TRUE,"10/1/1961",1961,"October","1960s",58,73,6
"95","196110010ram","Los Angeles Rams",24,"Pittsburgh Steelers",14,38,10,TRUE,"10/1/1961",1961,"October","1960s",62,78,9
"96","196110010was","Washington Redskins",21,"New York Giants",24,45,-3,FALSE,"10/1/1961",1961,"October","1960s",64,68,4
"97","196110010det","Detroit Lions",0,"San Francisco 49ers",49,49,-49,FALSE,"10/1/1961",1961,"October","1960s",59,73,16
"98","196110010phi","Philadelphia Eagles",27,"St. Louis Cardinals",30,57,-3,FALSE,"10/1/1961",1961,"October","1960s",59,78,6
"99","196110010cle","Cleveland Browns",25,"Dallas Cowboys",7,32,18,TRUE,"10/1/1961",1961,"October","1960s",62,65,15
"100","196110010gnb","Green Bay Packers",24,"Chicago Bears",0,24,24,TRUE,"10/1/1961",1961,"October","1960s",46,76,19
"101","196110080cle","Cleveland Browns",31,"Washington Redskins",7,38,24,TRUE,"10/8/1961",1961,"October","1960s",60,58,6
"102","196110080gnb","Green Bay Packers",45,"Baltimore Colts",7,52,38,TRUE,"10/8/1961",1961,"October","1960s",60,71,11
"103","196110080det","Detroit Lions",17,"Chicago Bears",31,48,-14,FALSE,"10/8/1961",1961,"October","1960s",60,71,7
"104","196110080phi","Philadelphia Eagles",21,"Pittsburgh Steelers",16,37,5,TRUE,"10/8/1961",1961,"October","1960s",63,75,6
"105","196110080sfo","San Francisco 49ers",35,"Los Angeles Rams",0,35,35,TRUE,"10/8/1961",1961,"October","1960s",61,37,25
"106","196110080min","Minnesota Vikings",0,"Dallas Cowboys",28,28,-28,FALSE,"10/8/1961",1961,"October","1960s",66,67,7
"107","196110080crd","St. Louis Cardinals",9,"New York Giants",24,33,-15,FALSE,"10/8/1961",1961,"October","1960s",67,59,12
"108","196110150dal","Dallas Cowboys",10,"New York Giants",31,41,-21,FALSE,"10/15/1961",1961,"October","1960s",60,58,11
"109","196110150det","Detroit Lions",14,"Los Angeles Rams",13,27,1,TRUE,"10/15/1961",1961,"October","1960s",42,78,9
"110","196110150crd","St. Louis Cardinals",7,"Philadelphia Eagles",20,27,-13,FALSE,"10/15/1961",1961,"October","1960s",51,50,10
"111","196110150cle","Cleveland Browns",17,"Green Bay Packers",49,66,-32,FALSE,"10/15/1961",1961,"October","1960s",44,62,16
"112","196110150min","Minnesota Vikings",24,"San Francisco 49ers",38,62,-14,FALSE,"10/15/1961",1961,"October","1960s",56,63,10
"113","196110150pit","Pittsburgh Steelers",20,"Washington Redskins",0,20,20,TRUE,"10/15/1961",1961,"October","1960s",39,88,15
"114","196110150chi","Chicago Bears",24,"Baltimore Colts",10,34,14,TRUE,"10/15/1961",1961,"October","1960s",50,66,13
"115","196110220nyg","New York Giants",24,"Los Angeles Rams",14,38,10,TRUE,"10/22/1961",1961,"October","1960s",52,65,26
"116","196110220pit","Pittsburgh Steelers",28,"Cleveland Browns",30,58,-2,FALSE,"10/22/1961",1961,"October","1960s",50,70,11
"117","196110220was","Washington Redskins",0,"St. Louis Cardinals",24,24,-24,FALSE,"10/22/1961",1961,"October","1960s",57,68,13
"118","196110220chi","Chicago Bears",31,"San Francisco 49ers",0,31,31,TRUE,"10/22/1961",1961,"October","1960s",49,82,8
"119","196110220dal","Dallas Cowboys",7,"Philadelphia Eagles",43,50,-36,FALSE,"10/22/1961",1961,"October","1960s",68,58,18
"120","196110220det","Detroit Lions",14,"Baltimore Colts",17,31,-3,FALSE,"10/22/1961",1961,"October","1960s",50,72,8
"121","196110220min","Minnesota Vikings",7,"Green Bay Packers",33,40,-26,FALSE,"10/22/1961",1961,"October","1960s",48,82,13
"122","196110290pit","Pittsburgh Steelers",20,"San Francisco 49ers",10,30,10,TRUE,"10/29/1961",1961,"October","1960s",55,49,9
"123","196110290clt","Baltimore Colts",20,"Chicago Bears",21,41,-1,FALSE,"10/29/1961",1961,"October","1960s",52,62,8
"124","196110290nyg","New York Giants",16,"Dallas Cowboys",17,33,-1,FALSE,"10/29/1961",1961,"October","1960s",58,53,18
"125","196110290crd","St. Louis Cardinals",10,"Cleveland Browns",21,31,-11,FALSE,"10/29/1961",1961,"October","1960s",68,60,18
"126","196110290gnb","Green Bay Packers",28,"Minnesota Vikings",10,38,18,TRUE,"10/29/1961",1961,"October","1960s",57,87,16
"127","196110290ram","Los Angeles Rams",10,"Detroit Lions",28,38,-18,FALSE,"10/29/1961",1961,"October","1960s",62,23,17
"128","196110290was","Washington Redskins",24,"Philadelphia Eagles",27,51,-3,FALSE,"10/29/1961",1961,"October","1960s",58,48,4
"129","196111050nyg","New York Giants",53,"Washington Redskins",0,53,53,TRUE,"11/5/1961",1961,"November","1960s",65,84,14
"130","196111050clt","Baltimore Colts",45,"Green Bay Packers",21,66,24,TRUE,"11/5/1961",1961,"November","1960s",69,78,11
"131","196111050phi","Philadelphia Eagles",16,"Chicago Bears",14,30,2,TRUE,"11/5/1961",1961,"November","1960s",68,81,9
"132","196111050sfo","San Francisco 49ers",20,"Detroit Lions",20,40,0,FALSE,"11/5/1961",1961,"November","1960s",54,62,10
"133","196111050cle","Cleveland Browns",13,"Pittsburgh Steelers",17,30,-4,FALSE,"11/5/1961",1961,"November","1960s",49,72,9
"134","196111050dal","Dallas Cowboys",17,"St. Louis Cardinals",31,48,-14,FALSE,"11/5/1961",1961,"November","1960s",50,66,22
"135","196111050ram","Los Angeles Rams",31,"Minnesota Vikings",17,48,14,TRUE,"11/5/1961",1961,"November","1960s",65,52,4
"136","196111120chi","Chicago Bears",28,"Green Bay Packers",31,59,-3,FALSE,"11/12/1961",1961,"November","1960s",52,78,13
"137","196111120was","Washington Redskins",6,"Cleveland Browns",17,23,-11,FALSE,"11/12/1961",1961,"November","1960s",48,67,4
"138","196111120pit","Pittsburgh Steelers",37,"Dallas Cowboys",7,44,30,TRUE,"11/12/1961",1961,"November","1960s",50,77,6
"139","196111120ram","Los Angeles Rams",17,"San Francisco 49ers",7,24,10,TRUE,"11/12/1961",1961,"November","1960s",59,73,5
"140","196111120min","Minnesota Vikings",28,"Baltimore Colts",20,48,8,TRUE,"11/12/1961",1961,"November","1960s",50,77,12
"141","196111120nyg","New York Giants",38,"Philadelphia Eagles",21,59,17,TRUE,"11/12/1961",1961,"November","1960s",49,63,11
"142","196111120crd","St. Louis Cardinals",14,"Detroit Lions",45,59,-31,FALSE,"11/12/1961",1961,"November","1960s",55,84,14
"143","196111190clt","Baltimore Colts",16,"St. Louis Cardinals",0,16,16,TRUE,"11/19/1961",1961,"November","1960s",34,61,8
"144","196111190gnb","Green Bay Packers",35,"Los Angeles Rams",17,52,18,TRUE,"11/19/1961",1961,"November","1960s",26,81,5
"145","196111190cle","Cleveland Browns",45,"Philadelphia Eagles",24,69,21,TRUE,"11/19/1961",1961,"November","1960s",35,59,10
"146","196111190min","Minnesota Vikings",10,"Detroit Lions",37,47,-27,FALSE,"11/19/1961",1961,"November","1960s",23,76,7
"147","196111190dal","Dallas Cowboys",28,"Washington Redskins",28,56,0,FALSE,"11/19/1961",1961,"November","1960s",43,87,9
"148","196111190sfo","San Francisco 49ers",41,"Chicago Bears",31,72,10,TRUE,"11/19/1961",1961,"November","1960s",48,79,7
"149","196111190nyg","New York Giants",42,"Pittsburgh Steelers",21,63,21,TRUE,"11/19/1961",1961,"November","1960s",39,48,18
"150","196111230det","Detroit Lions",9,"Green Bay Packers",17,26,-8,FALSE,"11/23/1961",1961,"November","1960s",43,97,8
"151","196111260sfo","San Francisco 49ers",38,"Minnesota Vikings",28,66,10,TRUE,"11/26/1961",1961,"November","1960s",53,86,9
"152","196111260cle","Cleveland Browns",21,"New York Giants",37,58,-16,FALSE,"11/26/1961",1961,"November","1960s",48,52,16
"153","196111260was","Washington Redskins",6,"Baltimore Colts",27,33,-21,FALSE,"11/26/1961",1961,"November","1960s",48,51,4
"154","196111260chi","Chicago Bears",28,"Los Angeles Rams",24,52,4,TRUE,"11/26/1961",1961,"November","1960s",49,70,12
"155","196111260pit","Pittsburgh Steelers",30,"St. Louis Cardinals",27,57,3,TRUE,"11/26/1961",1961,"November","1960s",45,57,9
"156","196111260phi","Philadelphia Eagles",35,"Dallas Cowboys",13,48,22,TRUE,"11/26/1961",1961,"November","1960s",45,41,8
"157","196112030clt","Baltimore Colts",20,"San Francisco 49ers",17,37,3,TRUE,"12/3/1961",1961,"December","1960s",47,58,8
"158","196112030dal","Dallas Cowboys",17,"Cleveland Browns",38,55,-21,FALSE,"12/3/1961",1961,"December","1960s",64,84,18
"159","196112030crd","St. Louis Cardinals",38,"Washington Redskins",24,62,14,TRUE,"12/3/1961",1961,"December","1960s",52,77,13
"160","196112030pit","Pittsburgh Steelers",24,"Philadelphia Eagles",35,59,-11,FALSE,"12/3/1961",1961,"December","1960s",42,82,5
"161","196112030min","Minnesota Vikings",42,"Los Angeles Rams",21,63,21,TRUE,"12/3/1961",1961,"December","1960s",37,100,13
"162","196112030gnb","Green Bay Packers",20,"New York Giants",17,37,3,TRUE,"12/3/1961",1961,"December","1960s",38,96,8
"163","196112030chi","Chicago Bears",15,"Detroit Lions",16,31,-1,FALSE,"12/3/1961",1961,"December","1960s",44,84,10
"164","196112090ram","Los Angeles Rams",34,"Baltimore Colts",17,51,17,TRUE,"12/9/1961",1961,"December","1960s",52,79,5
"165","196112100was","Washington Redskins",14,"Pittsburgh Steelers",30,44,-16,FALSE,"12/10/1961",1961,"December","1960s",34,90,1
"166","196112100chi","Chicago Bears",17,"Cleveland Browns",14,31,3,TRUE,"12/10/1961",1961,"December","1960s",30,87,15
"167","196112100phi","Philadelphia Eagles",24,"New York Giants",28,52,-4,FALSE,"12/10/1961",1961,"December","1960s",30,91,7
"168","196112100det","Detroit Lions",13,"Minnesota Vikings",7,20,6,TRUE,"12/10/1961",1961,"December","1960s",36,92,11
"169","196112100crd","St. Louis Cardinals",31,"Dallas Cowboys",13,44,18,TRUE,"12/10/1961",1961,"December","1960s",34,84,11
"170","196112100sfo","San Francisco 49ers",22,"Green Bay Packers",21,43,1,TRUE,"12/10/1961",1961,"December","1960s",48,72,12
"171","196112160sfo","San Francisco 49ers",24,"Baltimore Colts",27,51,-3,FALSE,"12/16/1961",1961,"December","1960s",44,88,4
"172","196112170nyg","New York Giants",7,"Cleveland Browns",7,14,0,FALSE,"12/17/1961",1961,"December","1960s",31,82,16
"173","196112170was","Washington Redskins",34,"Dallas Cowboys",24,58,10,TRUE,"12/17/1961",1961,"December","1960s",34,89,2
"174","196112170chi","Chicago Bears",52,"Minnesota Vikings",35,87,17,TRUE,"12/17/1961",1961,"December","1960s",33,91,13
"175","196112170crd","St. Louis Cardinals",20,"Pittsburgh Steelers",0,20,20,TRUE,"12/17/1961",1961,"December","1960s",38,87,9
"176","196112170ram","Los Angeles Rams",17,"Green Bay Packers",24,41,-7,FALSE,"12/17/1961",1961,"December","1960s",52,78,8
"177","196112170det","Detroit Lions",24,"Philadelphia Eagles",27,51,-3,FALSE,"12/17/1961",1961,"December","1960s",35,92,9
"178","196112310gnb","Green Bay Packers",37,"New York Giants",0,37,37,TRUE,"12/31/1961",1961,"December","1960s",17,82,10
"179","196209160sfo","San Francisco 49ers",14,"Chicago Bears",30,44,-16,FALSE,"9/16/1962",1962,"September","1960s",64,70,13
"180","196209160cle","Cleveland Browns",17,"New York Giants",7,24,10,TRUE,"9/16/1962",1962,"September","1960s",67,64,8
"181","196209160phi","Philadelphia Eagles",21,"St. Louis Cardinals",27,48,-6,FALSE,"9/16/1962",1962,"September","1960s",67,51,7
"182","196209160det","Detroit Lions",45,"Pittsburgh Steelers",7,52,38,TRUE,"9/16/1962",1962,"September","1960s",65,69,9
"183","196209160gnb","Green Bay Packers",34,"Minnesota Vikings",7,41,27,TRUE,"9/16/1962",1962,"September","1960s",62,79,9
"184","196209160clt","Baltimore Colts",30,"Los Angeles Rams",27,57,3,TRUE,"9/16/1962",1962,"September","1960s",68,56,8
"185","196209160dal","Dallas Cowboys",35,"Washington Redskins",35,70,0,FALSE,"9/16/1962",1962,"September","1960s",79,72,9
"186","196209230phi","Philadelphia Eagles",13,"New York Giants",29,42,-16,FALSE,"9/23/1962",1962,"September","1960s",61,66,15
"187","196209230min","Minnesota Vikings",7,"Baltimore Colts",34,41,-27,FALSE,"9/23/1962",1962,"September","1960s",53,79,9
"188","196209230cle","Cleveland Browns",16,"Washington Redskins",17,33,-1,FALSE,"9/23/1962",1962,"September","1960s",58,74,7
"189","196209230gnb","Green Bay Packers",17,"St. Louis Cardinals",0,17,17,TRUE,"9/23/1962",1962,"September","1960s",54,82,10
"190","196209230det","Detroit Lions",45,"San Francisco 49ers",24,69,21,TRUE,"9/23/1962",1962,"September","1960s",54,78,8
"191","196209230ram","Los Angeles Rams",23,"Chicago Bears",27,50,-4,FALSE,"9/23/1962",1962,"September","1960s",68,76,9
"192","196209230dal","Dallas Cowboys",28,"Pittsburgh Steelers",30,58,-2,FALSE,"9/23/1962",1962,"September","1960s",77,56,11
"193","196209300pit","Pittsburgh Steelers",27,"New York Giants",31,58,-4,FALSE,"9/30/1962",1962,"September","1960s",51,67,6
"194","196209300clt","Baltimore Colts",20,"Detroit Lions",29,49,-9,FALSE,"9/30/1962",1962,"September","1960s",57,68,8
"195","196209300was","Washington Redskins",24,"St. Louis Cardinals",14,38,10,TRUE,"9/30/1962",1962,"September","1960s",61,62,3
"196","196209300phi","Philadelphia Eagles",35,"Cleveland Browns",7,42,28,TRUE,"9/30/1962",1962,"September","1960s",56,69,8
"197","196209300ram","Los Angeles Rams",17,"Dallas Cowboys",27,44,-10,FALSE,"9/30/1962",1962,"September","1960s",66,84,7
"198","196209300gnb","Green Bay Packers",49,"Chicago Bears",0,49,49,TRUE,"9/30/1962",1962,"September","1960s",54,66,3
"199","196209300sfo","San Francisco 49ers",21,"Minnesota Vikings",7,28,14,TRUE,"9/30/1962",1962,"September","1960s",62,70,10
"200","196210060pit","Pittsburgh Steelers",13,"Philadelphia Eagles",7,20,6,TRUE,"10/6/1962",1962,"October","1960s",55,83,5
"201","196210070clt","Baltimore Colts",13,"San Francisco 49ers",21,34,-8,FALSE,"10/7/1962",1962,"October","1960s",64,67,12
"202","196210070min","Minnesota Vikings",0,"Chicago Bears",13,13,-13,FALSE,"10/7/1962",1962,"October","1960s",56,93,10
"203","196210070gnb","Green Bay Packers",9,"Detroit Lions",7,16,2,TRUE,"10/7/1962",1962,"October","1960s",56,94,8
"204","196210070cle","Cleveland Browns",19,"Dallas Cowboys",10,29,9,TRUE,"10/7/1962",1962,"October","1960s",58,82,5
"205","196210070was","Washington Redskins",20,"Los Angeles Rams",14,34,6,TRUE,"10/7/1962",1962,"October","1960s",67,59,11
"206","196210070crd","St. Louis Cardinals",14,"New York Giants",31,45,-17,FALSE,"10/7/1962",1962,"October","1960s",71,74,6
"207","196210140nyg","New York Giants",17,"Pittsburgh Steelers",20,37,-3,FALSE,"10/14/1962",1962,"October","1960s",57,36,9
"208","196210140dal","Dallas Cowboys",41,"Philadelphia Eagles",19,60,22,TRUE,"10/14/1962",1962,"October","1960s",77,75,12
"209","196210140min","Minnesota Vikings",21,"Green Bay Packers",48,69,-27,FALSE,"10/14/1962",1962,"October","1960s",70,90,11
"210","196210140crd","St. Louis Cardinals",17,"Washington Redskins",17,34,0,FALSE,"10/14/1962",1962,"October","1960s",71,80,5
"211","196210140det","Detroit Lions",13,"Los Angeles Rams",10,23,3,TRUE,"10/14/1962",1962,"October","1960s",61,82,6
"212","196210140chi","Chicago Bears",27,"San Francisco 49ers",34,61,-7,FALSE,"10/14/1962",1962,"October","1960s",70,74,11
"213","196210140cle","Cleveland Browns",14,"Baltimore Colts",36,50,-22,FALSE,"10/14/1962",1962,"October","1960s",63,70,6
"214","196210210gnb","Green Bay Packers",31,"San Francisco 49ers",13,44,18,TRUE,"10/21/1962",1962,"October","1960s",46,72,11
"215","196210210crd","St. Louis Cardinals",7,"Cleveland Browns",34,41,-27,FALSE,"10/21/1962",1962,"October","1960s",57,70,12
"216","196210210nyg","New York Giants",17,"Detroit Lions",14,31,3,TRUE,"10/21/1962",1962,"October","1960s",61,64,10
"217","196210210phi","Philadelphia Eagles",21,"Washington Redskins",27,48,-6,FALSE,"10/21/1962",1962,"October","1960s",60,62,9
"218","196210210ram","Los Angeles Rams",14,"Minnesota Vikings",38,52,-24,FALSE,"10/21/1962",1962,"October","1960s",64,74,8
"219","196210210pit","Pittsburgh Steelers",27,"Dallas Cowboys",42,69,-15,FALSE,"10/21/1962",1962,"October","1960s",58,60,11
"220","196210210chi","Chicago Bears",35,"Baltimore Colts",15,50,20,TRUE,"10/21/1962",1962,"October","1960s",49,72,11
"221","196210280min","Minnesota Vikings",31,"Philadelphia Eagles",21,52,10,TRUE,"10/28/1962",1962,"October","1960s",48,69,13
"222","196210280dal","Dallas Cowboys",24,"St. Louis Cardinals",28,52,-4,FALSE,"10/28/1962",1962,"October","1960s",68,79,16
"223","196210280pit","Pittsburgh Steelers",14,"Cleveland Browns",41,55,-27,FALSE,"10/28/1962",1962,"October","1960s",50,51,18
"224","196210280det","Detroit Lions",11,"Chicago Bears",3,14,8,TRUE,"10/28/1962",1962,"October","1960s",52,67,15
"225","196210280nyg","New York Giants",49,"Washington Redskins",34,83,15,TRUE,"10/28/1962",1962,"October","1960s",50,47,17
"226","196210280clt","Baltimore Colts",6,"Green Bay Packers",17,23,-11,FALSE,"10/28/1962",1962,"October","1960s",50,38,12
"227","196210280sfo","San Francisco 49ers",14,"Los Angeles Rams",28,42,-14,FALSE,"10/28/1962",1962,"October","1960s",56,87,8
"228","196211040chi","Chicago Bears",7,"Green Bay Packers",38,45,-31,FALSE,"11/4/1962",1962,"November","1960s",36,90,12
"229","196211040nyg","New York Giants",31,"St. Louis Cardinals",28,59,3,TRUE,"11/4/1962",1962,"November","1960s",42,74,14
"230","196211040ram","Los Angeles Rams",3,"Detroit Lions",12,15,-9,FALSE,"11/4/1962",1962,"November","1960s",60,86,7
"231","196211040was","Washington Redskins",10,"Dallas Cowboys",38,48,-28,FALSE,"11/4/1962",1962,"November","1960s",42,79,8
"232","196211040sfo","San Francisco 49ers",3,"Baltimore Colts",22,25,-19,FALSE,"11/4/1962",1962,"November","1960s",57,85,11
"233","196211040cle","Cleveland Browns",14,"Philadelphia Eagles",14,28,0,FALSE,"11/4/1962",1962,"November","1960s",42,84,8
"234","196211040pit","Pittsburgh Steelers",39,"Minnesota Vikings",31,70,8,TRUE,"11/4/1962",1962,"November","1960s",39,79,7
"235","196211110was","Washington Redskins",17,"Cleveland Browns",9,26,8,TRUE,"11/11/1962",1962,"November","1960s",54,63,19
"236","196211110phi","Philadelphia Eagles",0,"Green Bay Packers",49,49,-49,FALSE,"11/11/1962",1962,"November","1960s",50,69,16
"237","196211110chi","Chicago Bears",31,"Minnesota Vikings",30,61,1,TRUE,"11/11/1962",1962,"November","1960s",41,78,9
"238","196211110crd","St. Louis Cardinals",17,"Pittsburgh Steelers",26,43,-9,FALSE,"11/11/1962",1962,"November","1960s",44,56,9
"239","196211110dal","Dallas Cowboys",10,"New York Giants",41,51,-31,FALSE,"11/11/1962",1962,"November","1960s",66,43,20
"240","196211110ram","Los Angeles Rams",2,"Baltimore Colts",14,16,-12,FALSE,"11/11/1962",1962,"November","1960s",58,85,7
"241","196211110sfo","San Francisco 49ers",24,"Detroit Lions",38,62,-14,FALSE,"11/11/1962",1962,"November","1960s",56,85,8
"242","196211180gnb","Green Bay Packers",17,"Baltimore Colts",13,30,4,TRUE,"11/18/1962",1962,"November","1960s",35,65,5
"243","196211180min","Minnesota Vikings",6,"Detroit Lions",17,23,-11,FALSE,"11/18/1962",1962,"November","1960s",30,63,8
"244","196211180cle","Cleveland Browns",38,"St. Louis Cardinals",14,52,24,TRUE,"11/18/1962",1962,"November","1960s",40,79,10
"245","196211180pit","Pittsburgh Steelers",23,"Washington Redskins",21,44,2,TRUE,"11/18/1962",1962,"November","1960s",37,88,13
"246","196211180nyg","New York Giants",19,"Philadelphia Eagles",14,33,5,TRUE,"11/18/1962",1962,"November","1960s",41,75,13
"247","196211180dal","Dallas Cowboys",33,"Chicago Bears",34,67,-1,FALSE,"11/18/1962",1962,"November","1960s",42,80,16
"248","196211180ram","Los Angeles Rams",17,"San Francisco 49ers",24,41,-7,FALSE,"11/18/1962",1962,"November","1960s",58,32,13
"249","196211220det","Detroit Lions",26,"Green Bay Packers",14,40,12,TRUE,"11/22/1962",1962,"November","1960s",37,70,15
"250","196211250was","Washington Redskins",24,"New York Giants",42,66,-18,FALSE,"11/25/1962",1962,"November","1960s",41,55,6
"251","196211250min","Minnesota Vikings",24,"Los Angeles Rams",24,48,0,FALSE,"11/25/1962",1962,"November","1960s",30,76,10
"252","196211250crd","St. Louis Cardinals",17,"San Francisco 49ers",24,41,-7,FALSE,"11/25/1962",1962,"November","1960s",45,58,6
"253","196211250cle","Cleveland Browns",35,"Pittsburgh Steelers",14,49,21,TRUE,"11/25/1962",1962,"November","1960s",36,75,8
"254","196211250phi","Philadelphia Eagles",28,"Dallas Cowboys",14,42,14,TRUE,"11/25/1962",1962,"November","1960s",37,53,8
"255","196211250clt","Baltimore Colts",0,"Chicago Bears",57,57,-57,FALSE,"11/25/1962",1962,"November","1960s",35,59,8
"256","196212020was","Washington Redskins",14,"Philadelphia Eagles",37,51,-23,FALSE,"12/2/1962",1962,"December","1960s",50,39,5
"257","196212020dal","Dallas Cowboys",45,"Cleveland Browns",21,66,24,TRUE,"12/2/1962",1962,"December","1960s",59,88,12
"258","196212020det","Detroit Lions",21,"Baltimore Colts",14,35,7,TRUE,"12/2/1962",1962,"December","1960s",34,84,3
"259","196212020chi","Chicago Bears",24,"New York Giants",26,50,-2,FALSE,"12/2/1962",1962,"December","1960s",41,74,6
"260","196212020pit","Pittsburgh Steelers",19,"St. Louis Cardinals",7,26,12,TRUE,"12/2/1962",1962,"December","1960s",41,44,3
"261","196212020min","Minnesota Vikings",12,"San Francisco 49ers",35,47,-23,FALSE,"12/2/1962",1962,"December","1960s",53,70,12
"262","196212020gnb","Green Bay Packers",41,"Los Angeles Rams",10,51,31,TRUE,"12/2/1962",1962,"December","1960s",40,77,6
"263","196212080clt","Baltimore Colts",34,"Washington Redskins",21,55,13,TRUE,"12/8/1962",1962,"December","1960s",35,54,12
"264","196212090det","Detroit Lions",37,"Minnesota Vikings",23,60,14,TRUE,"12/9/1962",1962,"December","1960s",20,81,10
"265","196212090crd","St. Louis Cardinals",52,"Dallas Cowboys",20,72,32,TRUE,"12/9/1962",1962,"December","1960s",26,46,20
"266","196212090sfo","San Francisco 49ers",21,"Green Bay Packers",31,52,-10,FALSE,"12/9/1962",1962,"December","1960s",48,94,8
"267","196212090nyg","New York Giants",17,"Cleveland Browns",13,30,4,TRUE,"12/9/1962",1962,"December","1960s",35,62,10
"268","196212090chi","Chicago Bears",30,"Los Angeles Rams",14,44,16,TRUE,"12/9/1962",1962,"December","1960s",20,76,14
"269","196212090phi","Philadelphia Eagles",17,"Pittsburgh Steelers",26,43,-9,FALSE,"12/9/1962",1962,"December","1960s",35,55,9
"270","196212150sfo","San Francisco 49ers",10,"Cleveland Browns",13,23,-3,FALSE,"12/15/1962",1962,"December","1960s",60,87,14
"271","196212160was","Washington Redskins",24,"Pittsburgh Steelers",27,51,-3,FALSE,"12/16/1962",1962,"December","1960s",35,55,6
"272","196212160chi","Chicago Bears",3,"Detroit Lions",0,3,3,TRUE,"12/16/1962",1962,"December","1960s",30,69,10
"273","196212160ram","Los Angeles Rams",17,"Green Bay Packers",20,37,-3,FALSE,"12/16/1962",1962,"December","1960s",60,83,10
"274","196212160nyg","New York Giants",41,"Dallas Cowboys",31,72,10,TRUE,"12/16/1962",1962,"December","1960s",27,78,11
"275","196212160crd","St. Louis Cardinals",45,"Philadelphia Eagles",35,80,10,TRUE,"12/16/1962",1962,"December","1960s",33,75,6
"276","196212160clt","Baltimore Colts",42,"Minnesota Vikings",17,59,25,TRUE,"12/16/1962",1962,"December","1960s",30,63,10
"277","196212300nyg","New York Giants",7,"Green Bay Packers",16,23,-9,FALSE,"12/30/1962",1962,"December","1960s",25,58,27
"278","196309140dal","Dallas Cowboys",7,"St. Louis Cardinals",34,41,-27,FALSE,"9/14/1963",1963,"September","1960s",76,79,9
"279","196309140ram","Los Angeles Rams",2,"Detroit Lions",23,25,-21,FALSE,"9/14/1963",1963,"September","1960s",70,77,10
"280","196309150gnb","Green Bay Packers",3,"Chicago Bears",10,13,-7,FALSE,"9/15/1963",1963,"September","1960s",54,76,7
"281","196309150sfo","San Francisco 49ers",20,"Minnesota Vikings",24,44,-4,FALSE,"9/15/1963",1963,"September","1960s",64,73,17
"282","196309150cle","Cleveland Browns",37,"Washington Redskins",14,51,23,TRUE,"9/15/1963",1963,"September","1960s",59,65,9
"283","196309150clt","Baltimore Colts",28,"New York Giants",37,65,-9,FALSE,"9/15/1963",1963,"September","1960s",54,78,11
"284","196309150phi","Philadelphia Eagles",21,"Pittsburgh Steelers",21,42,0,FALSE,"9/15/1963",1963,"September","1960s",55,77,13
"285","196309210ram","Los Angeles Rams",14,"Washington Redskins",37,51,-23,FALSE,"9/21/1963",1963,"September","1960s",70,78,8
"286","196309220sfo","San Francisco 49ers",14,"Baltimore Colts",20,34,-6,FALSE,"9/22/1963",1963,"September","1960s",62,73,10
"287","196309220pit","Pittsburgh Steelers",31,"New York Giants",0,31,31,TRUE,"9/22/1963",1963,"September","1960s",52,63,12
"288","196309220phi","Philadelphia Eagles",24,"St. Louis Cardinals",28,52,-4,FALSE,"9/22/1963",1963,"September","1960s",56,59,14
"289","196309220min","Minnesota Vikings",7,"Chicago Bears",28,35,-21,FALSE,"9/22/1963",1963,"September","1960s",51,78,9
"290","196309220dal","Dallas Cowboys",24,"Cleveland Browns",41,65,-17,FALSE,"9/22/1963",1963,"September","1960s",77,57,9
"291","196309220gnb","Green Bay Packers",31,"Detroit Lions",10,41,21,TRUE,"9/22/1963",1963,"September","1960s",56,70,14
"292","196309290phi","Philadelphia Eagles",14,"New York Giants",37,51,-23,FALSE,"9/29/1963",1963,"September","1960s",64,81,12
"293","196309290det","Detroit Lions",21,"Chicago Bears",37,58,-16,FALSE,"9/29/1963",1963,"September","1960s",54,76,13
"294","196309290min","Minnesota Vikings",45,"San Francisco 49ers",14,59,31,TRUE,"9/29/1963",1963,"September","1960s",48,84,9
"295","196309290gnb","Green Bay Packers",31,"Baltimore Colts",20,51,11,TRUE,"9/29/1963",1963,"September","1960s",47,79,10
"296","196309290pit","Pittsburgh Steelers",23,"St. Louis Cardinals",10,33,13,TRUE,"9/29/1963",1963,"September","1960s",61,62,12
"297","196309290cle","Cleveland Browns",20,"Los Angeles Rams",6,26,14,TRUE,"9/29/1963",1963,"September","1960s",56,77,12
"298","196309290was","Washington Redskins",21,"Dallas Cowboys",17,38,4,TRUE,"9/29/1963",1963,"September","1960s",67,69,9
"299","196310050cle","Cleveland Browns",35,"Pittsburgh Steelers",23,58,12,TRUE,"10/5/1963",1963,"October","1960s",54,55,7
"300","196310060chi","Chicago Bears",10,"Baltimore Colts",3,13,7,TRUE,"10/6/1963",1963,"October","1960s",73,37,11
"301","196310060gnb","Green Bay Packers",42,"Los Angeles Rams",10,52,32,TRUE,"10/6/1963",1963,"October","1960s",67,59,13
"302","196310060det","Detroit Lions",26,"San Francisco 49ers",3,29,23,TRUE,"10/6/1963",1963,"October","1960s",64,52,10
"303","196310060was","Washington Redskins",14,"New York Giants",24,38,-10,FALSE,"10/6/1963",1963,"October","1960s",60,56,4
"304","196310060phi","Philadelphia Eagles",24,"Dallas Cowboys",21,45,3,TRUE,"10/6/1963",1963,"October","1960s",56,62,9
"305","196310060min","Minnesota Vikings",14,"St. Louis Cardinals",56,70,-42,FALSE,"10/6/1963",1963,"October","1960s",71,40,9
"306","196310130clt","Baltimore Colts",20,"San Francisco 49ers",3,23,17,TRUE,"10/13/1963",1963,"October","1960s",51,54,8
"307","196310130crd","St. Louis Cardinals",24,"Pittsburgh Steelers",23,47,1,TRUE,"10/13/1963",1963,"October","1960s",64,41,13
"308","196310130nyg","New York Giants",24,"Cleveland Browns",35,59,-11,FALSE,"10/13/1963",1963,"October","1960s",55,45,12
"309","196310130min","Minnesota Vikings",28,"Green Bay Packers",37,65,-9,FALSE,"10/13/1963",1963,"October","1960s",56,63,9
"310","196310130was","Washington Redskins",24,"Philadelphia Eagles",37,61,-13,FALSE,"10/13/1963",1963,"October","1960s",57,48,3
"311","196310130dal","Dallas Cowboys",17,"Detroit Lions",14,31,3,TRUE,"10/13/1963",1963,"October","1960s",76,37,8
"312","196310130ram","Los Angeles Rams",14,"Chicago Bears",52,66,-38,FALSE,"10/13/1963",1963,"October","1960s",66,63,9
"313","196310200crd","St. Louis Cardinals",7,"Green Bay Packers",30,37,-23,FALSE,"10/20/1963",1963,"October","1960s",72,54,8
"314","196310200nyg","New York Giants",37,"Dallas Cowboys",21,58,16,TRUE,"10/20/1963",1963,"October","1960s",62,80,7
"315","196310200ram","Los Angeles Rams",27,"Minnesota Vikings",24,51,3,TRUE,"10/20/1963",1963,"October","1960s",66,72,11
"316","196310200pit","Pittsburgh Steelers",38,"Washington Redskins",27,65,11,TRUE,"10/20/1963",1963,"October","1960s",66,39,5
"317","196310200sfo","San Francisco 49ers",20,"Chicago Bears",14,34,6,TRUE,"10/20/1963",1963,"October","1960s",61,70,11
"318","196310200cle","Cleveland Browns",37,"Philadelphia Eagles",7,44,30,TRUE,"10/20/1963",1963,"October","1960s",63,52,7
"319","196310200det","Detroit Lions",21,"Baltimore Colts",25,46,-4,FALSE,"10/20/1963",1963,"October","1960s",62,74,6
"320","196310270ram","Los Angeles Rams",28,"San Francisco 49ers",21,49,7,TRUE,"10/27/1963",1963,"October","1960s",66,79,7
"321","196310270pit","Pittsburgh Steelers",27,"Dallas Cowboys",21,48,6,TRUE,"10/27/1963",1963,"October","1960s",65,64,7
"322","196310270was","Washington Redskins",7,"St. Louis Cardinals",21,28,-14,FALSE,"10/27/1963",1963,"October","1960s",68,69,3
"323","196310270cle","Cleveland Browns",6,"New York Giants",33,39,-27,FALSE,"10/27/1963",1963,"October","1960s",60,80,9
"324","196310270det","Detroit Lions",28,"Minnesota Vikings",10,38,18,TRUE,"10/27/1963",1963,"October","1960s",62,57,10
"325","196310270clt","Baltimore Colts",20,"Green Bay Packers",34,54,-14,FALSE,"10/27/1963",1963,"October","1960s",62,77,5
"326","196310270chi","Chicago Bears",16,"Philadelphia Eagles",7,23,9,TRUE,"10/27/1963",1963,"October","1960s",59,51,9
"327","196311030phi","Philadelphia Eagles",17,"Cleveland Browns",23,40,-6,FALSE,"11/3/1963",1963,"November","1960s",43,51,18
"328","196311030min","Minnesota Vikings",21,"Los Angeles Rams",13,34,8,TRUE,"11/3/1963",1963,"November","1960s",45,47,12
"329","196311030dal","Dallas Cowboys",35,"Washington Redskins",20,55,15,TRUE,"11/3/1963",1963,"November","1960s",57,50,16
"330","196311030sfo","San Francisco 49ers",7,"Detroit Lions",45,52,-38,FALSE,"11/3/1963",1963,"November","1960s",54,74,8
"331","196311030gnb","Green Bay Packers",33,"Pittsburgh Steelers",14,47,19,TRUE,"11/3/1963",1963,"November","1960s",37,53,12
"332","196311030crd","St. Louis Cardinals",21,"New York Giants",38,59,-17,FALSE,"11/3/1963",1963,"November","1960s",43,47,10
"333","196311030clt","Baltimore Colts",7,"Chicago Bears",17,24,-10,FALSE,"11/3/1963",1963,"November","1960s",44,51,18
"334","196311100sfo","San Francisco 49ers",31,"Dallas Cowboys",24,55,7,TRUE,"11/10/1963",1963,"November","1960s",57,89,7
"335","196311100nyg","New York Giants",42,"Philadelphia Eagles",14,56,28,TRUE,"11/10/1963",1963,"November","1960s",55,72,10
"336","196311100crd","St. Louis Cardinals",24,"Washington Redskins",20,44,4,TRUE,"11/10/1963",1963,"November","1960s",54,62,9
"337","196311100chi","Chicago Bears",6,"Los Angeles Rams",0,6,6,TRUE,"11/10/1963",1963,"November","1960s",49,72,11
"338","196311100pit","Pittsburgh Steelers",9,"Cleveland Browns",7,16,2,TRUE,"11/10/1963",1963,"November","1960s",47,66,7
"339","196311100clt","Baltimore Colts",24,"Detroit Lions",21,45,3,TRUE,"11/10/1963",1963,"November","1960s",50,73,6
"340","196311100gnb","Green Bay Packers",28,"Minnesota Vikings",7,35,21,TRUE,"11/10/1963",1963,"November","1960s",44,67,12
"341","196311170was","Washington Redskins",28,"Pittsburgh Steelers",34,62,-6,FALSE,"11/17/1963",1963,"November","1960s",60,40,4
"342","196311170det","Detroit Lions",21,"Los Angeles Rams",28,49,-7,FALSE,"11/17/1963",1963,"November","1960s",56,66,11
"343","196311170nyg","New York Giants",48,"San Francisco 49ers",14,62,34,TRUE,"11/17/1963",1963,"November","1960s",55,51,10
"344","196311170min","Minnesota Vikings",34,"Baltimore Colts",37,71,-3,FALSE,"11/17/1963",1963,"November","1960s",43,69,7
"345","196311170dal","Dallas Cowboys",27,"Philadelphia Eagles",20,47,7,TRUE,"11/17/1963",1963,"November","1960s",72,64,18
"346","196311170chi","Chicago Bears",26,"Green Bay Packers",7,33,19,TRUE,"11/17/1963",1963,"November","1960s",62,74,16
"347","196311170cle","Cleveland Browns",14,"St. Louis Cardinals",20,34,-6,FALSE,"11/17/1963",1963,"November","1960s",54,56,16
"348","196311240ram","Los Angeles Rams",17,"Baltimore Colts",16,33,1,TRUE,"11/24/1963",1963,"November","1960s",59,76,8
"349","196311240cle","Cleveland Browns",27,"Dallas Cowboys",17,44,10,TRUE,"11/24/1963",1963,"November","1960s",35,64,11
"350","196311240gnb","Green Bay Packers",28,"San Francisco 49ers",10,38,18,TRUE,"11/24/1963",1963,"November","1960s",31,63,8
"351","196311240nyg","New York Giants",17,"St. Louis Cardinals",24,41,-7,FALSE,"11/24/1963",1963,"November","1960s",48,56,19
"352","196311240pit","Pittsburgh Steelers",17,"Chicago Bears",17,34,0,FALSE,"11/24/1963",1963,"November","1960s",35,63,15
"353","196311240min","Minnesota Vikings",34,"Detroit Lions",31,65,3,TRUE,"11/24/1963",1963,"November","1960s",25,70,12
"354","196311240phi","Philadelphia Eagles",10,"Washington Redskins",13,23,-3,FALSE,"11/24/1963",1963,"November","1960s",47,60,14
"355","196311280det","Detroit Lions",13,"Green Bay Packers",13,26,0,FALSE,"11/28/1963",1963,"November","1960s",40,77,8
"356","196312010crd","St. Louis Cardinals",10,"Cleveland Browns",24,34,-14,FALSE,"12/1/1963",1963,"December","1960s",34,62,12
"357","196312010was","Washington Redskins",20,"Baltimore Colts",36,56,-16,FALSE,"12/1/1963",1963,"December","1960s",38,44,11
"358","196312010pit","Pittsburgh Steelers",20,"Philadelphia Eagles",20,40,0,FALSE,"12/1/1963",1963,"December","1960s",26,78,13
"359","196312010chi","Chicago Bears",17,"Minnesota Vikings",17,34,0,FALSE,"12/1/1963",1963,"December","1960s",23,72,10
"360","196312010sfo","San Francisco 49ers",17,"Los Angeles Rams",21,38,-4,FALSE,"12/1/1963",1963,"December","1960s",48,83,8
"361","196312010dal","Dallas Cowboys",27,"New York Giants",34,61,-7,FALSE,"12/1/1963",1963,"December","1960s",51,47,12
"362","196312070ram","Los Angeles Rams",14,"Green Bay Packers",31,45,-17,FALSE,"12/7/1963",1963,"December","1960s",55,76,7
"363","196312080chi","Chicago Bears",27,"San Francisco 49ers",7,34,20,TRUE,"12/8/1963",1963,"December","1960s",36,86,15
"364","196312080nyg","New York Giants",44,"Washington Redskins",14,58,30,TRUE,"12/8/1963",1963,"December","1960s",44,72,12
"365","196312080det","Detroit Lions",38,"Cleveland Browns",10,48,28,TRUE,"12/8/1963",1963,"December","1960s",39,74,12
"366","196312080crd","St. Louis Cardinals",38,"Philadelphia Eagles",14,52,24,TRUE,"12/8/1963",1963,"December","1960s",35,66,22
"367","196312080dal","Dallas Cowboys",19,"Pittsburgh Steelers",24,43,-5,FALSE,"12/8/1963",1963,"December","1960s",47,26,21
"368","196312080clt","Baltimore Colts",41,"Minnesota Vikings",10,51,31,TRUE,"12/8/1963",1963,"December","1960s",42,76,11
"369","196312140sfo","San Francisco 49ers",17,"Green Bay Packers",21,38,-4,FALSE,"12/14/1963",1963,"December","1960s",42,82,7
"370","196312150crd","St. Louis Cardinals",24,"Dallas Cowboys",28,52,-4,FALSE,"12/15/1963",1963,"December","1960s",6,65,11
"371","196312150chi","Chicago Bears",24,"Detroit Lions",14,38,10,TRUE,"12/15/1963",1963,"December","1960s",1,74,11
"372","196312150clt","Baltimore Colts",19,"Los Angeles Rams",16,35,3,TRUE,"12/15/1963",1963,"December","1960s",21,50,19
"373","196312150nyg","New York Giants",33,"Pittsburgh Steelers",17,50,16,TRUE,"12/15/1963",1963,"December","1960s",23,51,20
"374","196312150was","Washington Redskins",20,"Cleveland Browns",27,47,-7,FALSE,"12/15/1963",1963,"December","1960s",24,35,13
"375","196312150phi","Philadelphia Eagles",13,"Minnesota Vikings",34,47,-21,FALSE,"12/15/1963",1963,"December","1960s",21,57,18
"376","196312290chi","Chicago Bears",14,"New York Giants",10,24,4,TRUE,"12/29/1963",1963,"December","1960s",4,60,11
"377","196409120dal","Dallas Cowboys",6,"St. Louis Cardinals",16,22,-10,FALSE,"9/12/1964",1964,"September","1960s",76,58,13
"378","196409130gnb","Green Bay Packers",23,"Chicago Bears",12,35,11,TRUE,"9/13/1964",1964,"September","1960s",53,64,10
"379","196409130pit","Pittsburgh Steelers",14,"Los Angeles Rams",26,40,-12,FALSE,"9/13/1964",1964,"September","1960s",54,46,12
"380","196409130was","Washington Redskins",13,"Cleveland Browns",27,40,-14,FALSE,"9/13/1964",1964,"September","1960s",58,73,11
"381","196409130phi","Philadelphia Eagles",38,"New York Giants",7,45,31,TRUE,"9/13/1964",1964,"September","1960s",58,64,12
"382","196409130sfo","San Francisco 49ers",17,"Detroit Lions",26,43,-9,FALSE,"9/13/1964",1964,"September","1960s",59,75,16
"383","196409130min","Minnesota Vikings",34,"Baltimore Colts",24,58,10,TRUE,"9/13/1964",1964,"September","1960s",54,71,11
"384","196409190ram","Los Angeles Rams",17,"Detroit Lions",17,34,0,FALSE,"9/19/1964",1964,"September","1960s",64,75,12
"385","196409200gnb","Green Bay Packers",20,"Baltimore Colts",21,41,-1,FALSE,"9/20/1964",1964,"September","1960s",65,92,9
"386","196409200pit","Pittsburgh Steelers",27,"New York Giants",24,51,3,TRUE,"9/20/1964",1964,"September","1960s",64,84,10
"387","196409200phi","Philadelphia Eagles",24,"San Francisco 49ers",28,52,-4,FALSE,"9/20/1964",1964,"September","1960s",62,67,14
"388","196409200cle","Cleveland Browns",33,"St. Louis Cardinals",33,66,0,FALSE,"9/20/1964",1964,"September","1960s",67,87,7
"389","196409200dal","Dallas Cowboys",24,"Washington Redskins",18,42,6,TRUE,"9/20/1964",1964,"September","1960s",75,82,9
"390","196409200min","Minnesota Vikings",28,"Chicago Bears",34,62,-6,FALSE,"9/20/1964",1964,"September","1960s",57,95,11
"391","196409250nyg","New York Giants",13,"Washington Redskins",10,23,3,TRUE,"9/25/1964",1964,"September","1960s",64,41,17
"392","196409270pit","Pittsburgh Steelers",23,"Dallas Cowboys",17,40,6,TRUE,"9/27/1964",1964,"September","1960s",64,54,15
"393","196409270phi","Philadelphia Eagles",20,"Cleveland Browns",28,48,-8,FALSE,"9/27/1964",1964,"September","1960s",64,70,12
"394","196409270ram","Los Angeles Rams",22,"Minnesota Vikings",13,35,9,TRUE,"9/27/1964",1964,"September","1960s",66,72,13
"395","196409270sfo","San Francisco 49ers",13,"St. Louis Cardinals",23,36,-10,FALSE,"9/27/1964",1964,"September","1960s",57,65,11
"396","196409270clt","Baltimore Colts",52,"Chicago Bears",0,52,52,TRUE,"9/27/1964",1964,"September","1960s",65,66,12
"397","196409280det","Detroit Lions",10,"Green Bay Packers",14,24,-4,FALSE,"9/28/1964",1964,"September","1960s",46,65,8
"398","196410040was","Washington Redskins",17,"St. Louis Cardinals",23,40,-6,FALSE,"10/4/1964",1964,"October","1960s",62,76,6
"399","196410040clt","Baltimore Colts",35,"Los Angeles Rams",20,55,15,TRUE,"10/4/1964",1964,"October","1960s",58,84,6
"400","196410040det","Detroit Lions",26,"New York Giants",3,29,23,TRUE,"10/4/1964",1964,"October","1960s",55,45,15
"401","196410040gnb","Green Bay Packers",23,"Minnesota Vikings",24,47,-1,FALSE,"10/4/1964",1964,"October","1960s",52,58,15
"402","196410040phi","Philadelphia Eagles",21,"Pittsburgh Steelers",7,28,14,TRUE,"10/4/1964",1964,"October","1960s",59,84,10
"403","196410040sfo","San Francisco 49ers",31,"Chicago Bears",21,52,10,TRUE,"10/4/1964",1964,"October","1960s",59,78,16
"404","196410040cle","Cleveland Browns",27,"Dallas Cowboys",6,33,21,TRUE,"10/4/1964",1964,"October","1960s",56,58,13
"405","196410100cle","Cleveland Browns",7,"Pittsburgh Steelers",23,30,-16,FALSE,"10/10/1964",1964,"October","1960s",40,69,14
"406","196410110was","Washington Redskins",35,"Philadelphia Eagles",20,55,15,TRUE,"10/11/1964",1964,"October","1960s",46,43,13
"407","196410110chi","Chicago Bears",38,"Los Angeles Rams",17,55,21,TRUE,"10/11/1964",1964,"October","1960s",38,69,7
"408","196410110min","Minnesota Vikings",20,"Detroit Lions",24,44,-4,FALSE,"10/11/1964",1964,"October","1960s",42,71,10
"409","196410110dal","Dallas Cowboys",13,"New York Giants",13,26,0,FALSE,"10/11/1964",1964,"October","1960s",60,49,12
"410","196410110gnb","Green Bay Packers",24,"San Francisco 49ers",14,38,10,TRUE,"10/11/1964",1964,"October","1960s",38,68,8
"411","196410120crd","St. Louis Cardinals",27,"Baltimore Colts",47,74,-20,FALSE,"10/12/1964",1964,"October","1960s",44,58,10
"412","196410180crd","St. Louis Cardinals",38,"Washington Redskins",24,62,14,TRUE,"10/18/1964",1964,"October","1960s",61,51,15
"413","196410180chi","Chicago Bears",0,"Detroit Lions",10,10,-10,FALSE,"10/18/1964",1964,"October","1960s",57,54,12
"414","196410180min","Minnesota Vikings",30,"Pittsburgh Steelers",10,40,20,TRUE,"10/18/1964",1964,"October","1960s",44,66,14
"415","196410180nyg","New York Giants",17,"Philadelphia Eagles",23,40,-6,FALSE,"10/18/1964",1964,"October","1960s",63,80,14
"416","196410180dal","Dallas Cowboys",16,"Cleveland Browns",20,36,-4,FALSE,"10/18/1964",1964,"October","1960s",68,60,16
"417","196410180ram","Los Angeles Rams",42,"San Francisco 49ers",14,56,28,TRUE,"10/18/1964",1964,"October","1960s",65,81,10
"418","196410180clt","Baltimore Colts",24,"Green Bay Packers",21,45,3,TRUE,"10/18/1964",1964,"October","1960s",64,70,12
"419","196410250det","Detroit Lions",0,"Baltimore Colts",34,34,-34,FALSE,"10/25/1964",1964,"October","1960s",50,46,12
"420","196410250sfo","San Francisco 49ers",22,"Minnesota Vikings",27,49,-5,FALSE,"10/25/1964",1964,"October","1960s",54,80,10
"421","196410250pit","Pittsburgh Steelers",10,"Philadelphia Eagles",34,44,-24,FALSE,"10/25/1964",1964,"October","1960s",47,47,10
"422","196410250was","Washington Redskins",27,"Chicago Bears",20,47,7,TRUE,"10/25/1964",1964,"October","1960s",50,58,4
"423","196410250gnb","Green Bay Packers",17,"Los Angeles Rams",27,44,-10,FALSE,"10/25/1964",1964,"October","1960s",56,48,14
"424","196410250cle","Cleveland Browns",42,"New York Giants",20,62,22,TRUE,"10/25/1964",1964,"October","1960s",50,57,14
"425","196410250crd","St. Louis Cardinals",13,"Dallas Cowboys",31,44,-18,FALSE,"10/25/1964",1964,"October","1960s",58,48,10
"426","196411010det","Detroit Lions",37,"Los Angeles Rams",17,54,20,TRUE,"11/1/1964",1964,"November","1960s",44,65,6
"427","196411010min","Minnesota Vikings",13,"Green Bay Packers",42,55,-29,FALSE,"11/1/1964",1964,"November","1960s",56,54,12
"428","196411010chi","Chicago Bears",10,"Dallas Cowboys",24,34,-14,FALSE,"11/1/1964",1964,"November","1960s",51,64,8
"429","196411010clt","Baltimore Colts",37,"San Francisco 49ers",7,44,30,TRUE,"11/1/1964",1964,"November","1960s",48,54,7
"430","196411010phi","Philadelphia Eagles",10,"Washington Redskins",21,31,-11,FALSE,"11/1/1964",1964,"November","1960s",48,48,5
"431","196411010pit","Pittsburgh Steelers",17,"Cleveland Browns",30,47,-13,FALSE,"11/1/1964",1964,"November","1960s",51,51,6
"432","196411010nyg","New York Giants",34,"St. Louis Cardinals",17,51,17,TRUE,"11/1/1964",1964,"November","1960s",51,41,9
"433","196411080gnb","Green Bay Packers",30,"Detroit Lions",7,37,23,TRUE,"11/8/1964",1964,"November","1960s",44,98,8
"434","196411080cle","Cleveland Browns",34,"Washington Redskins",24,58,10,TRUE,"11/8/1964",1964,"November","1960s",45,94,6
"435","196411080chi","Chicago Bears",24,"Baltimore Colts",40,64,-16,FALSE,"11/8/1964",1964,"November","1960s",51,83,5
"436","196411080min","Minnesota Vikings",24,"San Francisco 49ers",7,31,17,TRUE,"11/8/1964",1964,"November","1960s",48,90,7
"437","196411080crd","St. Louis Cardinals",34,"Pittsburgh Steelers",30,64,4,TRUE,"11/8/1964",1964,"November","1960s",58,65,6
"438","196411080ram","Los Angeles Rams",20,"Philadelphia Eagles",10,30,10,TRUE,"11/8/1964",1964,"November","1960s",63,78,10
"439","196411080nyg","New York Giants",21,"Dallas Cowboys",31,52,-10,FALSE,"11/8/1964",1964,"November","1960s",55,65,8
"440","196411150ram","Los Angeles Rams",24,"Chicago Bears",34,58,-10,FALSE,"11/15/1964",1964,"November","1960s",52,27,15
"441","196411150cle","Cleveland Browns",37,"Detroit Lions",21,58,16,TRUE,"11/15/1964",1964,"November","1960s",51,60,9
"442","196411150pit","Pittsburgh Steelers",0,"Washington Redskins",30,30,-30,FALSE,"11/15/1964",1964,"November","1960s",49,59,6
"443","196411150crd","St. Louis Cardinals",10,"New York Giants",10,20,0,FALSE,"11/15/1964",1964,"November","1960s",65,71,14
"444","196411150clt","Baltimore Colts",17,"Minnesota Vikings",14,31,3,TRUE,"11/15/1964",1964,"November","1960s",52,47,8
"445","196411150dal","Dallas Cowboys",14,"Philadelphia Eagles",17,31,-3,FALSE,"11/15/1964",1964,"November","1960s",74,80,15
"446","196411150sfo","San Francisco 49ers",24,"Green Bay Packers",14,38,10,TRUE,"11/15/1964",1964,"November","1960s",49,39,17
"447","196411220nyg","New York Giants",17,"Pittsburgh Steelers",44,61,-27,FALSE,"11/22/1964",1964,"November","1960s",30,47,19
"448","196411220gnb","Green Bay Packers",28,"Cleveland Browns",21,49,7,TRUE,"11/22/1964",1964,"November","1960s",15,66,15
"449","196411220det","Detroit Lions",23,"Minnesota Vikings",23,46,0,FALSE,"11/22/1964",1964,"November","1960s",17,67,16
"450","196411220ram","Los Angeles Rams",7,"Baltimore Colts",24,31,-17,FALSE,"11/22/1964",1964,"November","1960s",55,53,9
"451","196411220chi","Chicago Bears",23,"San Francisco 49ers",21,44,2,TRUE,"11/22/1964",1964,"November","1960s",16,63,12
"452","196411220phi","Philadelphia Eagles",13,"St. Louis Cardinals",38,51,-25,FALSE,"11/22/1964",1964,"November","1960s",27,44,14
"453","196411220was","Washington Redskins",28,"Dallas Cowboys",16,44,12,TRUE,"11/22/1964",1964,"November","1960s",31,46,14
"454","196411260det","Detroit Lions",24,"Chicago Bears",27,51,-3,FALSE,"11/26/1964",1964,"November","1960s",41,77,13
"455","196411290cle","Cleveland Browns",38,"Philadelphia Eagles",24,62,14,TRUE,"11/29/1964",1964,"November","1960s",32,65,15
"456","196411290sfo","San Francisco 49ers",3,"Baltimore Colts",14,17,-11,FALSE,"11/29/1964",1964,"November","1960s",53,90,7
"457","196411290pit","Pittsburgh Steelers",20,"St. Louis Cardinals",21,41,-1,FALSE,"11/29/1964",1964,"November","1960s",37,64,14
"458","196411290min","Minnesota Vikings",34,"Los Angeles Rams",13,47,21,TRUE,"11/29/1964",1964,"November","1960s",2,68,14
"459","196411290was","Washington Redskins",36,"New York Giants",21,57,15,TRUE,"11/29/1964",1964,"November","1960s",52,57,12
"460","196411290dal","Dallas Cowboys",21,"Green Bay Packers",45,66,-24,FALSE,"11/29/1964",1964,"November","1960s",48,53,7
"461","196412050chi","Chicago Bears",3,"Green Bay Packers",17,20,-14,FALSE,"12/5/1964",1964,"December","1960s",21,81,14
"462","196412060crd","St. Louis Cardinals",28,"Cleveland Browns",19,47,9,TRUE,"12/6/1964",1964,"December","1960s",18,93,8
"463","196412060was","Washington Redskins",7,"Pittsburgh Steelers",14,21,-7,FALSE,"12/6/1964",1964,"December","1960s",40,74,15
"464","196412060sfo","San Francisco 49ers",28,"Los Angeles Rams",7,35,21,TRUE,"12/6/1964",1964,"December","1960s",48,71,8
"465","196412060clt","Baltimore Colts",14,"Detroit Lions",31,45,-17,FALSE,"12/6/1964",1964,"December","1960s",39,74,14
"466","196412060nyg","New York Giants",21,"Minnesota Vikings",30,51,-9,FALSE,"12/6/1964",1964,"December","1960s",33,83,15
"467","196412060phi","Philadelphia Eagles",24,"Dallas Cowboys",14,38,10,TRUE,"12/6/1964",1964,"December","1960s",36,72,14
"468","196412120nyg","New York Giants",20,"Cleveland Browns",52,72,-32,FALSE,"12/12/1964",1964,"December","1960s",49,98,7
"469","196412130det","Detroit Lions",24,"San Francisco 49ers",7,31,17,TRUE,"12/13/1964",1964,"December","1960s",37,84,15
"470","196412130dal","Dallas Cowboys",17,"Pittsburgh Steelers",14,31,3,TRUE,"12/13/1964",1964,"December","1960s",48,56,14
"471","196412130ram","Los Angeles Rams",24,"Green Bay Packers",24,48,0,FALSE,"12/13/1964",1964,"December","1960s",56,38,7
"472","196412130crd","St. Louis Cardinals",36,"Philadelphia Eagles",34,70,2,TRUE,"12/13/1964",1964,"December","1960s",40,66,17
"473","196412130chi","Chicago Bears",14,"Minnesota Vikings",41,55,-27,FALSE,"12/13/1964",1964,"December","1960s",33,84,12
"474","196412130clt","Baltimore Colts",45,"Washington Redskins",17,62,28,TRUE,"12/13/1964",1964,"December","1960s",46,98,7
"475","196412270cle","Cleveland Browns",27,"Baltimore Colts",0,27,27,TRUE,"12/27/1964",1964,"December","1960s",34,75,15
"476","196509190sfo","San Francisco 49ers",52,"Chicago Bears",24,76,28,TRUE,"9/19/1965",1965,"September","1960s",60,55,11
"477","196509190was","Washington Redskins",7,"Cleveland Browns",17,24,-10,FALSE,"9/19/1965",1965,"September","1960s",82,74,4
"478","196509190pit","Pittsburgh Steelers",9,"Green Bay Packers",41,50,-32,FALSE,"9/19/1965",1965,"September","1960s",73,79,5
"479","196509190dal","Dallas Cowboys",31,"New York Giants",2,33,29,TRUE,"9/19/1965",1965,"September","1960s",80,75,15
"480","196509190det","Detroit Lions",20,"Los Angeles Rams",0,20,20,TRUE,"9/19/1965",1965,"September","1960s",74,83,9
"481","196509190phi","Philadelphia Eagles",34,"St. Louis Cardinals",27,61,7,TRUE,"9/19/1965",1965,"September","1960s",80,77,8
"482","196509190clt","Baltimore Colts",35,"Minnesota Vikings",16,51,19,TRUE,"9/19/1965",1965,"September","1960s",80,76,9
"483","196509250ram","Los Angeles Rams",30,"Chicago Bears",28,58,2,TRUE,"9/25/1965",1965,"September","1960s",66,80,9
"484","196509260phi","Philadelphia Eagles",14,"New York Giants",16,30,-2,FALSE,"9/26/1965",1965,"September","1960s",58,64,8
"485","196509260dal","Dallas Cowboys",27,"Washington Redskins",7,34,20,TRUE,"9/26/1965",1965,"September","1960s",68,65,10
"486","196509260gnb","Green Bay Packers",20,"Baltimore Colts",17,37,3,TRUE,"9/26/1965",1965,"September","1960s",47,78,16
"487","196509260min","Minnesota Vikings",29,"Detroit Lions",31,60,-2,FALSE,"9/26/1965",1965,"September","1960s",37,56,14
"488","196509260sfo","San Francisco 49ers",27,"Pittsburgh Steelers",17,44,10,TRUE,"9/26/1965",1965,"September","1960s",60,70,9
"489","196509260cle","Cleveland Browns",13,"St. Louis Cardinals",49,62,-36,FALSE,"9/26/1965",1965,"September","1960s",54,69,11
"490","196510030pit","Pittsburgh Steelers",13,"New York Giants",23,36,-10,FALSE,"10/3/1965",1965,"October","1960s",52,70,16
"491","196510030clt","Baltimore Colts",27,"San Francisco 49ers",24,51,3,TRUE,"10/3/1965",1965,"October","1960s",58,63,15
"492","196510030phi","Philadelphia Eagles",17,"Cleveland Browns",35,52,-18,FALSE,"10/3/1965",1965,"October","1960s",57,63,14
"493","196510030ram","Los Angeles Rams",35,"Minnesota Vikings",38,73,-3,FALSE,"10/3/1965",1965,"October","1960s",70,50,9
"494","196510030gnb","Green Bay Packers",23,"Chicago Bears",14,37,9,TRUE,"10/3/1965",1965,"October","1960s",52,50,13
"495","196510030det","Detroit Lions",14,"Washington Redskins",10,24,4,TRUE,"10/3/1965",1965,"October","1960s",52,63,18
"496","196510040crd","St. Louis Cardinals",20,"Dallas Cowboys",13,33,7,TRUE,"10/4/1965",1965,"October","1960s",52,70,8
"497","196510090cle","Cleveland Browns",24,"Pittsburgh Steelers",19,43,5,TRUE,"10/9/1965",1965,"October","1960s",54,79,15
"498","196510090min","Minnesota Vikings",40,"New York Giants",14,54,26,TRUE,"10/9/1965",1965,"October","1960s",51,70,12
"499","196510100chi","Chicago Bears",31,"Los Angeles Rams",6,37,25,TRUE,"10/10/1965",1965,"October","1960s",55,70,8
"500","196510100dal","Dallas Cowboys",24,"Philadelphia Eagles",35,59,-11,FALSE,"10/10/1965",1965,"October","1960s",74,57,8
"501","196510100gnb","Green Bay Packers",27,"San Francisco 49ers",10,37,17,TRUE,"10/10/1965",1965,"October","1960s",52,77,9
"502","196510100clt","Baltimore Colts",31,"Detroit Lions",7,38,24,TRUE,"10/10/1965",1965,"October","1960s",54,73,12
"503","196510100was","Washington Redskins",16,"St. Louis Cardinals",37,53,-21,FALSE,"10/10/1965",1965,"October","1960s",58,64,11
"504","196510170cle","Cleveland Browns",23,"Dallas Cowboys",17,40,6,TRUE,"10/17/1965",1965,"October","1960s",54,67,7
"505","196510170was","Washington Redskins",7,"Baltimore Colts",38,45,-31,FALSE,"10/17/1965",1965,"October","1960s",57,60,8
"506","196510170det","Detroit Lions",21,"Green Bay Packers",31,52,-10,FALSE,"10/17/1965",1965,"October","1960s",55,71,10
"507","196510170pit","Pittsburgh Steelers",7,"St. Louis Cardinals",20,27,-13,FALSE,"10/17/1965",1965,"October","1960s",51,67,7
"508","196510170nyg","New York Giants",35,"Philadelphia Eagles",27,62,8,TRUE,"10/17/1965",1965,"October","1960s",53,59,12
"509","196510170min","Minnesota Vikings",37,"Chicago Bears",45,82,-8,FALSE,"10/17/1965",1965,"October","1960s",65,78,12
"510","196510170ram","Los Angeles Rams",21,"San Francisco 49ers",45,66,-24,FALSE,"10/17/1965",1965,"October","1960s",62,55,14
"511","196510240gnb","Green Bay Packers",13,"Dallas Cowboys",3,16,10,TRUE,"10/24/1965",1965,"October","1960s",39,55,15
"512","196510240nyg","New York Giants",14,"Cleveland Browns",38,52,-24,FALSE,"10/24/1965",1965,"October","1960s",56,55,13
"513","196510240crd","St. Louis Cardinals",20,"Washington Redskins",24,44,-4,FALSE,"10/24/1965",1965,"October","1960s",43,52,13
"514","196510240sfo","San Francisco 49ers",41,"Minnesota Vikings",42,83,-1,FALSE,"10/24/1965",1965,"October","1960s",70,40,3
"515","196510240clt","Baltimore Colts",35,"Los Angeles Rams",20,55,15,TRUE,"10/24/1965",1965,"October","1960s",50,60,15
"516","196510240phi","Philadelphia Eagles",14,"Pittsburgh Steelers",20,34,-6,FALSE,"10/24/1965",1965,"October","1960s",52,60,13
"517","196510240chi","Chicago Bears",38,"Detroit Lions",10,48,28,TRUE,"10/24/1965",1965,"October","1960s",40,59,12
"518","196510310pit","Pittsburgh Steelers",22,"Dallas Cowboys",13,35,9,TRUE,"10/31/1965",1965,"October","1960s",51,41,21
"519","196510310sfo","San Francisco 49ers",28,"Baltimore Colts",34,62,-6,FALSE,"10/31/1965",1965,"October","1960s",54,78,11
"520","196510310nyg","New York Giants",14,"St. Louis Cardinals",10,24,4,TRUE,"10/31/1965",1965,"October","1960s",55,29,14
"521","196510310cle","Cleveland Browns",17,"Minnesota Vikings",27,44,-10,FALSE,"10/31/1965",1965,"October","1960s",55,49,23
"522","196510310was","Washington Redskins",23,"Philadelphia Eagles",21,44,2,TRUE,"10/31/1965",1965,"October","1960s",55,44,9
"523","196510310ram","Los Angeles Rams",7,"Detroit Lions",31,38,-24,FALSE,"10/31/1965",1965,"October","1960s",64,80,10
"524","196510310chi","Chicago Bears",31,"Green Bay Packers",10,41,21,TRUE,"10/31/1965",1965,"October","1960s",57,54,14
"525","196511070dal","Dallas Cowboys",39,"San Francisco 49ers",31,70,8,TRUE,"11/7/1965",1965,"November","1960s",62,87,4
"526","196511070nyg","New York Giants",7,"Washington Redskins",23,30,-16,FALSE,"11/7/1965",1965,"November","1960s",58,60,11
"527","196511070chi","Chicago Bears",21,"Baltimore Colts",26,47,-5,FALSE,"11/7/1965",1965,"November","1960s",55,91,7
"528","196511070crd","St. Louis Cardinals",21,"Pittsburgh Steelers",17,38,4,TRUE,"11/7/1965",1965,"November","1960s",64,71,6
"529","196511070min","Minnesota Vikings",24,"Los Angeles Rams",13,37,11,TRUE,"11/7/1965",1965,"November","1960s",41,82,9
"530","196511070gnb","Green Bay Packers",7,"Detroit Lions",12,19,-5,FALSE,"11/7/1965",1965,"November","1960s",43,94,9
"531","196511070cle","Cleveland Browns",38,"Philadelphia Eagles",34,72,4,TRUE,"11/7/1965",1965,"November","1960s",55,88,8
"532","196511140phi","Philadelphia Eagles",21,"Washington Redskins",14,35,7,TRUE,"11/14/1965",1965,"November","1960s",49,65,12
"533","196511140gnb","Green Bay Packers",6,"Los Angeles Rams",3,9,3,TRUE,"11/14/1965",1965,"November","1960s",28,55,12
"534","196511140dal","Dallas Cowboys",24,"Pittsburgh Steelers",17,41,7,TRUE,"11/14/1965",1965,"November","1960s",65,82,9
"535","196511140cle","Cleveland Browns",34,"New York Giants",21,55,13,TRUE,"11/14/1965",1965,"November","1960s",37,64,14
"536","196511140det","Detroit Lions",21,"San Francisco 49ers",27,48,-6,FALSE,"11/14/1965",1965,"November","1960s",34,54,13
"537","196511140min","Minnesota Vikings",21,"Baltimore Colts",41,62,-20,FALSE,"11/14/1965",1965,"November","1960s",21,67,12
"538","196511140chi","Chicago Bears",34,"St. Louis Cardinals",13,47,21,TRUE,"11/14/1965",1965,"November","1960s",32,57,9
"539","196511210min","Minnesota Vikings",13,"Green Bay Packers",38,51,-25,FALSE,"11/21/1965",1965,"November","1960s",33,92,8
"540","196511210dal","Dallas Cowboys",17,"Cleveland Browns",24,41,-7,FALSE,"11/21/1965",1965,"November","1960s",63,82,9
"541","196511210sfo","San Francisco 49ers",30,"Los Angeles Rams",27,57,3,TRUE,"11/21/1965",1965,"November","1960s",53,72,4
"542","196511210clt","Baltimore Colts",34,"Philadelphia Eagles",24,58,10,TRUE,"11/21/1965",1965,"November","1960s",43,66,6
"543","196511210crd","St. Louis Cardinals",15,"New York Giants",28,43,-13,FALSE,"11/21/1965",1965,"November","1960s",50,69,8
"544","196511210pit","Pittsburgh Steelers",3,"Washington Redskins",31,34,-28,FALSE,"11/21/1965",1965,"November","1960s",39,67,7
"545","196511210det","Detroit Lions",10,"Chicago Bears",17,27,-7,FALSE,"11/21/1965",1965,"November","1960s",41,68,10
"546","196511250det","Detroit Lions",24,"Baltimore Colts",24,48,0,FALSE,"11/25/1965",1965,"November","1960s",41,75,10
"547","196511280ram","Los Angeles Rams",21,"Green Bay Packers",10,31,11,TRUE,"11/28/1965",1965,"November","1960s",59,41,8
"548","196511280pit","Pittsburgh Steelers",21,"Cleveland Browns",42,63,-21,FALSE,"11/28/1965",1965,"November","1960s",38,53,23
"549","196511280min","Minnesota Vikings",24,"San Francisco 49ers",45,69,-21,FALSE,"11/28/1965",1965,"November","1960s",16,83,20
"550","196511280nyg","New York Giants",14,"Chicago Bears",35,49,-21,FALSE,"11/28/1965",1965,"November","1960s",48,36,17
"551","196511280crd","St. Louis Cardinals",24,"Philadelphia Eagles",28,52,-4,FALSE,"11/28/1965",1965,"November","1960s",37,48,16
"552","196511280was","Washington Redskins",34,"Dallas Cowboys",31,65,3,TRUE,"11/28/1965",1965,"November","1960s",50,38,14
"553","196512050nyg","New York Giants",35,"Pittsburgh Steelers",10,45,25,TRUE,"12/5/1965",1965,"December","1960s",40,49,16
"554","196512050cle","Cleveland Browns",24,"Washington Redskins",16,40,8,TRUE,"12/5/1965",1965,"December","1960s",35,79,12
"555","196512050clt","Baltimore Colts",0,"Chicago Bears",13,13,-13,FALSE,"12/5/1965",1965,"December","1960s",36,52,10
"556","196512050crd","St. Louis Cardinals",3,"Los Angeles Rams",27,30,-24,FALSE,"12/5/1965",1965,"December","1960s",52,39,14
"557","196512050sfo","San Francisco 49ers",17,"Detroit Lions",14,31,3,TRUE,"12/5/1965",1965,"December","1960s",46,71,6
"558","196512050phi","Philadelphia Eagles",19,"Dallas Cowboys",21,40,-2,FALSE,"12/5/1965",1965,"December","1960s",37,60,15
"559","196512050gnb","Green Bay Packers",24,"Minnesota Vikings",19,43,5,TRUE,"12/5/1965",1965,"December","1960s",30,68,16
"560","196512110dal","Dallas Cowboys",27,"St. Louis Cardinals",13,40,14,TRUE,"12/11/1965",1965,"December","1960s",69,80,16
"561","196512120pit","Pittsburgh Steelers",13,"Philadelphia Eagles",47,60,-34,FALSE,"12/12/1965",1965,"December","1960s",54,71,8
"562","196512120ram","Los Angeles Rams",42,"Cleveland Browns",7,49,35,TRUE,"12/12/1965",1965,"December","1960s",55,83,10
"563","196512120was","Washington Redskins",10,"New York Giants",27,37,-17,FALSE,"12/12/1965",1965,"December","1960s",50,80,5
"564","196512120chi","Chicago Bears",61,"San Francisco 49ers",20,81,41,TRUE,"12/12/1965",1965,"December","1960s",54,94,11
"565","196512120clt","Baltimore Colts",27,"Green Bay Packers",42,69,-15,FALSE,"12/12/1965",1965,"December","1960s",44,88,8
"566","196512120det","Detroit Lions",7,"Minnesota Vikings",29,36,-22,FALSE,"12/12/1965",1965,"December","1960s",47,92,10
"567","196512180ram","Los Angeles Rams",17,"Baltimore Colts",20,37,-3,FALSE,"12/18/1965",1965,"December","1960s",50,48,9
"568","196512190phi","Philadelphia Eagles",28,"Detroit Lions",35,63,-7,FALSE,"12/19/1965",1965,"December","1960s",34,56,11
"569","196512190was","Washington Redskins",35,"Pittsburgh Steelers",14,49,21,TRUE,"12/19/1965",1965,"December","1960s",38,55,13
"570","196512190chi","Chicago Bears",17,"Minnesota Vikings",24,41,-7,FALSE,"12/19/1965",1965,"December","1960s",25,70,5
"571","196512190nyg","New York Giants",20,"Dallas Cowboys",38,58,-18,FALSE,"12/19/1965",1965,"December","1960s",36,53,15
"572","196512190sfo","San Francisco 49ers",24,"Green Bay Packers",24,48,0,FALSE,"12/19/1965",1965,"December","1960s",42,68,8
"573","196512190crd","St. Louis Cardinals",24,"Cleveland Browns",27,51,-3,FALSE,"12/19/1965",1965,"December","1960s",31,83,8
"574","196512260gnb","Green Bay Packers",13,"Baltimore Colts",10,23,3,TRUE,"12/26/1965",1965,"December","1960s",22,85,10
"575","196601020gnb","Green Bay Packers",23,"Cleveland Browns",12,35,11,TRUE,"1/2/1966",1966,"January","1960s",26,92,11
"576","196609100gnb","Green Bay Packers",24,"Baltimore Colts",3,27,21,TRUE,"9/10/1966",1966,"September","1960s",64,62,8
"577","196609110atl","Atlanta Falcons",14,"Los Angeles Rams",19,33,-5,FALSE,"9/11/1966",1966,"September","1960s",71,57,7
"578","196609110det","Detroit Lions",14,"Chicago Bears",3,17,11,TRUE,"9/11/1966",1966,"September","1960s",67,73,7
"579","196609110was","Washington Redskins",14,"Cleveland Browns",38,52,-24,FALSE,"9/11/1966",1966,"September","1960s",65,52,8
"580","196609110pit","Pittsburgh Steelers",34,"New York Giants",34,68,0,FALSE,"9/11/1966",1966,"September","1960s",64,70,5
"581","196609110crd","St. Louis Cardinals",16,"Philadelphia Eagles",13,29,3,TRUE,"9/11/1966",1966,"September","1960s",72,70,5
"582","196609110sfo","San Francisco 49ers",20,"Minnesota Vikings",20,40,0,FALSE,"9/11/1966",1966,"September","1960s",60,75,25
"583","196609160ram","Los Angeles Rams",31,"Chicago Bears",17,48,14,TRUE,"9/16/1966",1966,"September","1960s",72,52,10
"584","196609180dal","Dallas Cowboys",52,"New York Giants",7,59,45,TRUE,"9/18/1966",1966,"September","1960s",72,82,9
"585","196609180cle","Cleveland Browns",20,"Green Bay Packers",21,41,-1,FALSE,"9/18/1966",1966,"September","1960s",62,57,6
"586","196609180pit","Pittsburgh Steelers",17,"Detroit Lions",3,20,14,TRUE,"9/18/1966",1966,"September","1960s",62,67,4
"587","196609180crd","St. Louis Cardinals",23,"Washington Redskins",7,30,16,TRUE,"9/18/1966",1966,"September","1960s",63,72,5
"588","196609180min","Minnesota Vikings",23,"Baltimore Colts",38,61,-15,FALSE,"9/18/1966",1966,"September","1960s",60,64,4
"589","196609180phi","Philadelphia Eagles",23,"Atlanta Falcons",10,33,13,TRUE,"9/18/1966",1966,"September","1960s",61,74,5
"590","196609250dal","Dallas Cowboys",28,"Minnesota Vikings",17,45,11,TRUE,"9/25/1966",1966,"September","1960s",76,60,12
"591","196609250pit","Pittsburgh Steelers",27,"Washington Redskins",33,60,-6,FALSE,"9/25/1966",1966,"September","1960s",53,80,10
"592","196609250cle","Cleveland Browns",28,"St. Louis Cardinals",34,62,-6,FALSE,"9/25/1966",1966,"September","1960s",53,72,9
"593","196609250phi","Philadelphia Eagles",35,"New York Giants",17,52,18,TRUE,"9/25/1966",1966,"September","1960s",55,74,11
"594","196609250gnb","Green Bay Packers",24,"Los Angeles Rams",13,37,11,TRUE,"9/25/1966",1966,"September","1960s",46,56,9
"595","196609250det","Detroit Lions",28,"Atlanta Falcons",10,38,18,TRUE,"9/25/1966",1966,"September","1960s",56,58,9
"596","196609250clt","Baltimore Colts",36,"San Francisco 49ers",14,50,22,TRUE,"9/25/1966",1966,"September","1960s",56,68,7
"597","196609300ram","Los Angeles Rams",34,"San Francisco 49ers",3,37,31,TRUE,"9/30/1966",1966,"September","1960s",70,76,9
"598","196610020min","Minnesota Vikings",10,"Chicago Bears",13,23,-3,FALSE,"10/2/1966",1966,"October","1960s",50,62,12
"599","196610020atl","Atlanta Falcons",14,"Dallas Cowboys",47,61,-33,FALSE,"10/2/1966",1966,"October","1960s",53,63,12
"600","196610020was","Washington Redskins",24,"Pittsburgh Steelers",10,34,14,TRUE,"10/2/1966",1966,"October","1960s",48,74,5
"601","196610020phi","Philadelphia Eagles",10,"St. Louis Cardinals",41,51,-31,FALSE,"10/2/1966",1966,"October","1960s",50,74,10
"602","196610020nyg","New York Giants",7,"Cleveland Browns",28,35,-21,FALSE,"10/2/1966",1966,"October","1960s",52,70,13
"603","196610020gnb","Green Bay Packers",23,"Detroit Lions",14,37,9,TRUE,"10/2/1966",1966,"October","1960s",49,63,10
"604","196610080cle","Cleveland Browns",41,"Pittsburgh Steelers",10,51,31,TRUE,"10/8/1966",1966,"October","1960s",58,46,12
"605","196610090chi","Chicago Bears",27,"Baltimore Colts",17,44,10,TRUE,"10/9/1966",1966,"October","1960s",67,54,12
"606","196610090dal","Dallas Cowboys",56,"Philadelphia Eagles",7,63,49,TRUE,"10/9/1966",1966,"October","1960s",74,59,8
"607","196610090det","Detroit Lions",7,"Los Angeles Rams",14,21,-7,FALSE,"10/9/1966",1966,"October","1960s",62,63,12
"608","196610090crd","St. Louis Cardinals",24,"New York Giants",19,43,5,TRUE,"10/9/1966",1966,"October","1960s",64,84,10
"609","196610090sfo","San Francisco 49ers",21,"Green Bay Packers",20,41,1,TRUE,"10/9/1966",1966,"October","1960s",64,62,10
"610","196610090was","Washington Redskins",33,"Atlanta Falcons",20,53,13,TRUE,"10/9/1966",1966,"October","1960s",59,77,4
"611","196610160clt","Baltimore Colts",45,"Detroit Lions",14,59,31,TRUE,"10/16/1966",1966,"October","1960s",64,73,12
"612","196610160min","Minnesota Vikings",35,"Los Angeles Rams",7,42,28,TRUE,"10/16/1966",1966,"October","1960s",36,77,9
"613","196610160chi","Chicago Bears",0,"Green Bay Packers",17,17,-17,FALSE,"10/16/1966",1966,"October","1960s",43,66,11
"614","196610160nyg","New York Giants",13,"Washington Redskins",10,23,3,TRUE,"10/16/1966",1966,"October","1960s",64,81,14
"615","196610160crd","St. Louis Cardinals",10,"Dallas Cowboys",10,20,0,FALSE,"10/16/1966",1966,"October","1960s",44,74,13
"616","196610160pit","Pittsburgh Steelers",14,"Philadelphia Eagles",31,45,-17,FALSE,"10/16/1966",1966,"October","1960s",51,66,15
"617","196610160atl","Atlanta Falcons",7,"San Francisco 49ers",44,51,-37,FALSE,"10/16/1966",1966,"October","1960s",66,76,9
"618","196610230chi","Chicago Bears",17,"Los Angeles Rams",10,27,7,TRUE,"10/23/1966",1966,"October","1960s",48,41,10
"619","196610230clt","Baltimore Colts",20,"Minnesota Vikings",17,37,3,TRUE,"10/23/1966",1966,"October","1960s",56,81,6
"620","196610230cle","Cleveland Browns",30,"Dallas Cowboys",21,51,9,TRUE,"10/23/1966",1966,"October","1960s",51,64,10
"621","196610230was","Washington Redskins",26,"St. Louis Cardinals",20,46,6,TRUE,"10/23/1966",1966,"October","1960s",58,83,6
"622","196610230nyg","New York Giants",3,"Philadelphia Eagles",31,34,-28,FALSE,"10/23/1966",1966,"October","1960s",59,78,10
"623","196610230sfo","San Francisco 49ers",27,"Detroit Lions",24,51,3,TRUE,"10/23/1966",1966,"October","1960s",60,72,9
"624","196610230gnb","Green Bay Packers",56,"Atlanta Falcons",3,59,53,TRUE,"10/23/1966",1966,"October","1960s",46,43,14
"625","196610300dal","Dallas Cowboys",52,"Pittsburgh Steelers",21,73,31,TRUE,"10/30/1966",1966,"October","1960s",64,58,6
"626","196610300ram","Los Angeles Rams",3,"Baltimore Colts",17,20,-14,FALSE,"10/30/1966",1966,"October","1960s",64,76,9
"627","196610300min","Minnesota Vikings",28,"San Francisco 49ers",3,31,25,TRUE,"10/30/1966",1966,"October","1960s",39,62,13
"628","196610300det","Detroit Lions",7,"Green Bay Packers",31,38,-24,FALSE,"10/30/1966",1966,"October","1960s",37,59,9
"629","196610300atl","Atlanta Falcons",17,"Cleveland Browns",49,66,-32,FALSE,"10/30/1966",1966,"October","1960s",58,62,10
"630","196610300phi","Philadelphia Eagles",13,"Washington Redskins",27,40,-14,FALSE,"10/30/1966",1966,"October","1960s",43,42,13
"631","196610310crd","St. Louis Cardinals",24,"Chicago Bears",17,41,7,TRUE,"10/31/1966",1966,"October","1960s",53,59,12
"632","196611060phi","Philadelphia Eagles",24,"Dallas Cowboys",23,47,1,TRUE,"11/6/1966",1966,"November","1960s",46,62,14
"633","196611060chi","Chicago Bears",10,"Detroit Lions",10,20,0,FALSE,"11/6/1966",1966,"November","1960s",38,73,11
"634","196611060pit","Pittsburgh Steelers",16,"Cleveland Browns",6,22,10,TRUE,"11/6/1966",1966,"November","1960s",35,83,11
"635","196611060clt","Baltimore Colts",37,"Washington Redskins",10,47,27,TRUE,"11/6/1966",1966,"November","1960s",47,52,15
"636","196611060sfo","San Francisco 49ers",21,"Los Angeles Rams",13,34,8,TRUE,"11/6/1966",1966,"November","1960s",54,79,15
"637","196611060gnb","Green Bay Packers",17,"Minnesota Vikings",20,37,-3,FALSE,"11/6/1966",1966,"November","1960s",31,80,13
"638","196611060nyg","New York Giants",17,"St. Louis Cardinals",20,37,-3,FALSE,"11/6/1966",1966,"November","1960s",48,66,14
"639","196611130was","Washington Redskins",30,"Dallas Cowboys",31,61,-1,FALSE,"11/13/1966",1966,"November","1960s",40,71,8
"640","196611130atl","Atlanta Falcons",7,"Baltimore Colts",19,26,-12,FALSE,"11/13/1966",1966,"November","1960s",58,80,12
"641","196611130ram","Los Angeles Rams",55,"New York Giants",14,69,41,TRUE,"11/13/1966",1966,"November","1960s",62,77,9
"642","196611130chi","Chicago Bears",30,"San Francisco 49ers",30,60,0,FALSE,"11/13/1966",1966,"November","1960s",34,70,7
"643","196611130cle","Cleveland Browns",27,"Philadelphia Eagles",7,34,20,TRUE,"11/13/1966",1966,"November","1960s",38,78,8
"644","196611130pit","Pittsburgh Steelers",30,"St. Louis Cardinals",9,39,21,TRUE,"11/13/1966",1966,"November","1960s",39,64,9
"645","196611130min","Minnesota Vikings",31,"Detroit Lions",32,63,-1,FALSE,"11/13/1966",1966,"November","1960s",30,74,13
"646","196611200pit","Pittsburgh Steelers",7,"Dallas Cowboys",20,27,-13,FALSE,"11/20/1966",1966,"November","1960s",30,60,8
"647","196611200det","Detroit Lions",20,"Baltimore Colts",14,34,6,TRUE,"11/20/1966",1966,"November","1960s",32,77,7
"648","196611200nyg","New York Giants",16,"Atlanta Falcons",27,43,-11,FALSE,"11/20/1966",1966,"November","1960s",36,44,16
"649","196611200cle","Cleveland Browns",14,"Washington Redskins",3,17,11,TRUE,"11/20/1966",1966,"November","1960s",32,69,8
"650","196611200ram","Los Angeles Rams",21,"Minnesota Vikings",6,27,15,TRUE,"11/20/1966",1966,"November","1960s",63,79,8
"651","196611200gnb","Green Bay Packers",13,"Chicago Bears",6,19,7,TRUE,"11/20/1966",1966,"November","1960s",32,76,8
"652","196611200sfo","San Francisco 49ers",34,"Philadelphia Eagles",35,69,-1,FALSE,"11/20/1966",1966,"November","1960s",58,79,20
"653","196611240dal","Dallas Cowboys",26,"Cleveland Browns",14,40,12,TRUE,"11/24/1966",1966,"November","1960s",71,68,15
"654","196611240det","Detroit Lions",14,"San Francisco 49ers",41,55,-27,FALSE,"11/24/1966",1966,"November","1960s",55,80,11
"655","196611270chi","Chicago Bears",23,"Atlanta Falcons",6,29,17,TRUE,"11/27/1966",1966,"November","1960s",49,90,11
"656","196611270min","Minnesota Vikings",16,"Green Bay Packers",28,44,-12,FALSE,"11/27/1966",1966,"November","1960s",33,78,19
"657","196611270was","Washington Redskins",72,"New York Giants",41,113,31,TRUE,"11/27/1966",1966,"November","1960s",42,83,5
"658","196611270clt","Baltimore Colts",7,"Los Angeles Rams",23,30,-16,FALSE,"11/27/1966",1966,"November","1960s",44,70,8
"659","196611270crd","St. Louis Cardinals",6,"Pittsburgh Steelers",3,9,3,TRUE,"11/27/1966",1966,"November","1960s",50,94,19
"660","196612040phi","Philadelphia Eagles",27,"Pittsburgh Steelers",23,50,4,TRUE,"12/4/1966",1966,"December","1960s",20,39,12
"661","196612040dal","Dallas Cowboys",31,"St. Louis Cardinals",17,48,14,TRUE,"12/4/1966",1966,"December","1960s",43,90,9
"662","196612040cle","Cleveland Browns",49,"New York Giants",40,89,9,TRUE,"12/4/1966",1966,"December","1960s",18,78,8
"663","196612040min","Minnesota Vikings",13,"Atlanta Falcons",20,33,-7,FALSE,"12/4/1966",1966,"December","1960s",20,75,14
"664","196612040clt","Baltimore Colts",21,"Chicago Bears",16,37,5,TRUE,"12/4/1966",1966,"December","1960s",21,40,10
"665","196612040gnb","Green Bay Packers",20,"San Francisco 49ers",7,27,13,TRUE,"12/4/1966",1966,"December","1960s",20,72,12
"666","196612040ram","Los Angeles Rams",23,"Detroit Lions",3,26,20,TRUE,"12/4/1966",1966,"December","1960s",57,86,8
"667","196612100clt","Baltimore Colts",10,"Green Bay Packers",14,24,-4,FALSE,"12/10/1966",1966,"December","1960s",58,82,11
"668","196612110phi","Philadelphia Eagles",33,"Cleveland Browns",21,54,12,TRUE,"12/11/1966",1966,"December","1960s",53,74,15
"669","196612110dal","Dallas Cowboys",31,"Washington Redskins",34,65,-3,FALSE,"12/11/1966",1966,"December","1960s",30,57,8
"670","196612110sfo","San Francisco 49ers",41,"Chicago Bears",14,55,27,TRUE,"12/11/1966",1966,"December","1960s",52,71,6
"671","196612110nyg","New York Giants",28,"Pittsburgh Steelers",47,75,-19,FALSE,"12/11/1966",1966,"December","1960s",54,79,15
"672","196612110atl","Atlanta Falcons",16,"St. Louis Cardinals",10,26,6,TRUE,"12/11/1966",1966,"December","1960s",41,79,14
"673","196612110det","Detroit Lions",16,"Minnesota Vikings",28,44,-12,FALSE,"12/11/1966",1966,"December","1960s",28,76,13
"674","196612170crd","St. Louis Cardinals",10,"Cleveland Browns",38,48,-28,FALSE,"12/17/1966",1966,"December","1960s",39,79,8
"675","196612180nyg","New York Giants",7,"Dallas Cowboys",17,24,-10,FALSE,"12/18/1966",1966,"December","1960s",50,49,14
"676","196612180atl","Atlanta Falcons",33,"Pittsburgh Steelers",57,90,-24,FALSE,"12/18/1966",1966,"December","1960s",47,77,8
"677","196612180sfo","San Francisco 49ers",14,"Baltimore Colts",30,44,-16,FALSE,"12/18/1966",1966,"December","1960s",46,86,7
"678","196612180was","Washington Redskins",28,"Philadelphia Eagles",37,65,-9,FALSE,"12/18/1966",1966,"December","1960s",44,66,8
"679","196612180chi","Chicago Bears",41,"Minnesota Vikings",28,69,13,TRUE,"12/18/1966",1966,"December","1960s",35,82,10
"680","196612180ram","Los Angeles Rams",23,"Green Bay Packers",27,50,-4,FALSE,"12/18/1966",1966,"December","1960s",58,61,8
"681","196701010dal","Dallas Cowboys",27,"Green Bay Packers",34,61,-7,FALSE,"1/1/1967",1967,"January","1960s",40,75,8
"682","196701150gnb","Green Bay Packers",35,"Kansas City Chiefs",10,45,25,TRUE,"1/15/1967",1967,"January","1960s",54,90,7
"683","196709170clt","Baltimore Colts",38,"Atlanta Falcons",31,69,7,TRUE,"9/17/1967",1967,"September","1960s",70,80,12
"684","196709170phi","Philadelphia Eagles",35,"Washington Redskins",24,59,11,TRUE,"9/17/1967",1967,"September","1960s",69,78,12
"685","196709170nor","New Orleans Saints",13,"Los Angeles Rams",27,40,-14,FALSE,"9/17/1967",1967,"September","1960s",75,66,7
"686","196709170pit","Pittsburgh Steelers",41,"Chicago Bears",13,54,28,TRUE,"9/17/1967",1967,"September","1960s",71,71,5
"687","196709170gnb","Green Bay Packers",17,"Detroit Lions",17,34,0,FALSE,"9/17/1967",1967,"September","1960s",69,77,6
"688","196709170crd","St. Louis Cardinals",20,"New York Giants",37,57,-17,FALSE,"9/17/1967",1967,"September","1960s",72,90,5
"689","196709170cle","Cleveland Browns",14,"Dallas Cowboys",21,35,-7,FALSE,"9/17/1967",1967,"September","1960s",68,71,7
"690","196709170min","Minnesota Vikings",21,"San Francisco 49ers",27,48,-6,FALSE,"9/17/1967",1967,"September","1960s",67,79,6
"691","196709220ram","Los Angeles Rams",39,"Minnesota Vikings",3,42,36,TRUE,"9/22/1967",1967,"September","1960s",70,72,11
"692","196709240det","Detroit Lions",31,"Cleveland Browns",14,45,17,TRUE,"9/24/1967",1967,"September","1960s",55,57,14
"693","196709240gnb","Green Bay Packers",13,"Chicago Bears",10,23,3,TRUE,"9/24/1967",1967,"September","1960s",49,60,9
"694","196709240nor","New Orleans Saints",10,"Washington Redskins",30,40,-20,FALSE,"9/24/1967",1967,"September","1960s",72,63,6
"695","196709240phi","Philadelphia Eagles",6,"Baltimore Colts",38,44,-32,FALSE,"9/24/1967",1967,"September","1960s",54,73,11
"696","196709240dal","Dallas Cowboys",38,"New York Giants",24,62,14,TRUE,"9/24/1967",1967,"September","1960s",77,65,4
"697","196709240pit","Pittsburgh Steelers",14,"St. Louis Cardinals",28,42,-14,FALSE,"9/24/1967",1967,"September","1960s",54,63,14
"698","196709240sfo","San Francisco 49ers",38,"Atlanta Falcons",7,45,31,TRUE,"9/24/1967",1967,"September","1960s",62,78,14
"699","196710010clt","Baltimore Colts",41,"San Francisco 49ers",7,48,34,TRUE,"10/1/1967",1967,"October","1960s",56,64,12
"700","196710010nor","New Orleans Saints",7,"Cleveland Browns",42,49,-35,FALSE,"10/1/1967",1967,"October","1960s",61,68,8
"701","196710010dal","Dallas Cowboys",13,"Los Angeles Rams",35,48,-22,FALSE,"10/1/1967",1967,"October","1960s",71,57,12
"702","196710010crd","St. Louis Cardinals",38,"Detroit Lions",28,66,10,TRUE,"10/1/1967",1967,"October","1960s",68,62,12
"703","196710010was","Washington Redskins",38,"New York Giants",34,72,4,TRUE,"10/1/1967",1967,"October","1960s",56,66,9
"704","196710010phi","Philadelphia Eagles",34,"Pittsburgh Steelers",24,58,10,TRUE,"10/1/1967",1967,"October","1960s",58,64,11
"705","196710010min","Minnesota Vikings",7,"Chicago Bears",17,24,-10,FALSE,"10/1/1967",1967,"October","1960s",65,56,15
"706","196710010gnb","Green Bay Packers",23,"Atlanta Falcons",0,23,23,TRUE,"10/1/1967",1967,"October","1960s",53,81,8
"707","196710070cle","Cleveland Browns",21,"Pittsburgh Steelers",10,31,11,TRUE,"10/7/1967",1967,"October","1960s",50,72,9
"708","196710080min","Minnesota Vikings",24,"St. Louis Cardinals",34,58,-10,FALSE,"10/8/1967",1967,"October","1960s",44,93,15
"709","196710080was","Washington Redskins",14,"Dallas Cowboys",17,31,-3,FALSE,"10/8/1967",1967,"October","1960s",57,86,7
"710","196710080atl","Atlanta Falcons",7,"Philadelphia Eagles",38,45,-31,FALSE,"10/8/1967",1967,"October","1960s",61,88,12
"711","196710080ram","Los Angeles Rams",24,"San Francisco 49ers",27,51,-3,FALSE,"10/8/1967",1967,"October","1960s",72,33,9
"712","196710080chi","Chicago Bears",3,"Baltimore Colts",24,27,-21,FALSE,"10/8/1967",1967,"October","1960s",61,78,12
"713","196710080nyg","New York Giants",27,"New Orleans Saints",21,48,6,TRUE,"10/8/1967",1967,"October","1960s",55,60,10
"714","196710080det","Detroit Lions",17,"Green Bay Packers",27,44,-10,FALSE,"10/8/1967",1967,"October","1960s",60,82,14
"715","196710150phi","Philadelphia Eagles",27,"San Francisco 49ers",28,55,-1,FALSE,"10/15/1967",1967,"October","1960s",58,70,6
"716","196710150gnb","Green Bay Packers",7,"Minnesota Vikings",10,17,-3,FALSE,"10/15/1967",1967,"October","1960s",56,84,6
"717","196710150dal","Dallas Cowboys",14,"New Orleans Saints",10,24,4,TRUE,"10/15/1967",1967,"October","1960s",72,83,13
"718","196710150pit","Pittsburgh Steelers",24,"New York Giants",27,51,-3,FALSE,"10/15/1967",1967,"October","1960s",54,77,6
"719","196710150atl","Atlanta Falcons",20,"Washington Redskins",20,40,0,FALSE,"10/15/1967",1967,"October","1960s",67,64,6
"720","196710150cle","Cleveland Browns",20,"St. Louis Cardinals",16,36,4,TRUE,"10/15/1967",1967,"October","1960s",59,76,13
"721","196710150chi","Chicago Bears",14,"Detroit Lions",3,17,11,TRUE,"10/15/1967",1967,"October","1960s",58,79,8
"722","196710150clt","Baltimore Colts",24,"Los Angeles Rams",24,48,0,FALSE,"10/15/1967",1967,"October","1960s",55,87,7
"723","196710220det","Detroit Lions",24,"Atlanta Falcons",3,27,21,TRUE,"10/22/1967",1967,"October","1960s",40,68,8
"724","196710220pit","Pittsburgh Steelers",21,"Dallas Cowboys",24,45,-3,FALSE,"10/22/1967",1967,"October","1960s",43,59,5
"725","196710220ram","Los Angeles Rams",28,"Washington Redskins",28,56,0,FALSE,"10/22/1967",1967,"October","1960s",63,73,10
"726","196710220crd","St. Louis Cardinals",48,"Philadelphia Eagles",14,62,34,TRUE,"10/22/1967",1967,"October","1960s",59,39,12
"727","196710220min","Minnesota Vikings",20,"Baltimore Colts",20,40,0,FALSE,"10/22/1967",1967,"October","1960s",54,51,17
"728","196710220cle","Cleveland Browns",24,"Chicago Bears",0,24,24,TRUE,"10/22/1967",1967,"October","1960s",44,70,4
"729","196710220sfo","San Francisco 49ers",27,"New Orleans Saints",13,40,14,TRUE,"10/22/1967",1967,"October","1960s",61,87,11
"730","196710220nyg","New York Giants",21,"Green Bay Packers",48,69,-27,FALSE,"10/22/1967",1967,"October","1960s",54,46,10
"731","196710290nor","New Orleans Saints",10,"Pittsburgh Steelers",14,24,-4,FALSE,"10/29/1967",1967,"October","1960s",66,75,12
"732","196710290nyg","New York Giants",38,"Cleveland Browns",34,72,4,TRUE,"10/29/1967",1967,"October","1960s",46,47,12
"733","196710290chi","Chicago Bears",17,"Los Angeles Rams",28,45,-11,FALSE,"10/29/1967",1967,"October","1960s",42,70,13
"734","196710290sfo","San Francisco 49ers",3,"Detroit Lions",45,48,-42,FALSE,"10/29/1967",1967,"October","1960s",58,52,15
"735","196710290phi","Philadelphia Eagles",21,"Dallas Cowboys",14,35,7,TRUE,"10/29/1967",1967,"October","1960s",46,51,8
"736","196710290atl","Atlanta Falcons",21,"Minnesota Vikings",20,41,1,TRUE,"10/29/1967",1967,"October","1960s",49,49,8
"737","196710290was","Washington Redskins",13,"Baltimore Colts",17,30,-4,FALSE,"10/29/1967",1967,"October","1960s",43,69,5
"738","196710300crd","St. Louis Cardinals",23,"Green Bay Packers",31,54,-8,FALSE,"10/30/1967",1967,"October","1960s",60,63,13
"739","196711050nor","New Orleans Saints",31,"Philadelphia Eagles",24,55,7,TRUE,"11/5/1967",1967,"November","1960s",50,61,12
"740","196711050sfo","San Francisco 49ers",7,"Los Angeles Rams",17,24,-10,FALSE,"11/5/1967",1967,"November","1960s",59,79,8
"741","196711050min","Minnesota Vikings",27,"New York Giants",24,51,3,TRUE,"11/5/1967",1967,"November","1960s",26,60,13
"742","196711050det","Detroit Lions",13,"Chicago Bears",27,40,-14,FALSE,"11/5/1967",1967,"November","1960s",32,72,15
"743","196711050clt","Baltimore Colts",13,"Green Bay Packers",10,23,3,TRUE,"11/5/1967",1967,"November","1960s",39,51,15
"744","196711050dal","Dallas Cowboys",37,"Atlanta Falcons",7,44,30,TRUE,"11/5/1967",1967,"November","1960s",46,56,6
"745","196711050was","Washington Redskins",21,"St. Louis Cardinals",27,48,-6,FALSE,"11/5/1967",1967,"November","1960s",38,58,12
"746","196711050pit","Pittsburgh Steelers",14,"Cleveland Browns",34,48,-20,FALSE,"11/5/1967",1967,"November","1960s",31,65,17
"747","196711120min","Minnesota Vikings",10,"Detroit Lions",10,20,0,FALSE,"11/12/1967",1967,"November","1960s",42,56,18
"748","196711120ram","Los Angeles Rams",33,"Philadelphia Eagles",17,50,16,TRUE,"11/12/1967",1967,"November","1960s",68,65,9
"749","196711120nor","New Orleans Saints",10,"Dallas Cowboys",27,37,-17,FALSE,"11/12/1967",1967,"November","1960s",65,88,6
"750","196711120chi","Chicago Bears",34,"New York Giants",7,41,27,TRUE,"11/12/1967",1967,"November","1960s",51,62,15
"751","196711120crd","St. Louis Cardinals",14,"Pittsburgh Steelers",14,28,0,FALSE,"11/12/1967",1967,"November","1960s",55,62,13
"752","196711120was","Washington Redskins",31,"San Francisco 49ers",28,59,3,TRUE,"11/12/1967",1967,"November","1960s",60,52,12
"753","196711120gnb","Green Bay Packers",55,"Cleveland Browns",7,62,48,TRUE,"11/12/1967",1967,"November","1960s",49,64,15
"754","196711120atl","Atlanta Falcons",7,"Baltimore Colts",49,56,-42,FALSE,"11/12/1967",1967,"November","1960s",60,58,8
"755","196711190phi","Philadelphia Eagles",48,"New Orleans Saints",21,69,27,TRUE,"11/19/1967",1967,"November","1960s",44,53,18
"756","196711190gnb","Green Bay Packers",13,"San Francisco 49ers",0,13,13,TRUE,"11/19/1967",1967,"November","1960s",32,63,12
"757","196711190cle","Cleveland Browns",14,"Minnesota Vikings",10,24,4,TRUE,"11/19/1967",1967,"November","1960s",0,0,NA
"758","196711190chi","Chicago Bears",30,"St. Louis Cardinals",3,33,27,TRUE,"11/19/1967",1967,"November","1960s",33,67,10
"759","196711190nyg","New York Giants",28,"Pittsburgh Steelers",20,48,8,TRUE,"11/19/1967",1967,"November","1960s",43,52,20
"760","196711190atl","Atlanta Falcons",3,"Los Angeles Rams",31,34,-28,FALSE,"11/19/1967",1967,"November","1960s",46,36,11
"761","196711190dal","Dallas Cowboys",20,"Washington Redskins",27,47,-7,FALSE,"11/19/1967",1967,"November","1960s",55,50,8
"762","196711190clt","Baltimore Colts",41,"Detroit Lions",7,48,34,TRUE,"11/19/1967",1967,"November","1960s",45,44,24
"763","196711230dal","Dallas Cowboys",46,"St. Louis Cardinals",21,67,25,TRUE,"11/23/1967",1967,"November","1960s",57,55,12
"764","196711230det","Detroit Lions",7,"Los Angeles Rams",31,38,-24,FALSE,"11/23/1967",1967,"November","1960s",33,73,11
"765","196711260pit","Pittsburgh Steelers",27,"Minnesota Vikings",41,68,-14,FALSE,"11/26/1967",1967,"November","1960s",41,70,11
"766","196711260chi","Chicago Bears",13,"Green Bay Packers",17,30,-4,FALSE,"11/26/1967",1967,"November","1960s",39,72,14
"767","196711260sfo","San Francisco 49ers",9,"Baltimore Colts",26,35,-17,FALSE,"11/26/1967",1967,"November","1960s",55,43,12
"768","196711260nor","New Orleans Saints",27,"Atlanta Falcons",24,51,3,TRUE,"11/26/1967",1967,"November","1960s",72,84,10
"769","196711260nyg","New York Giants",44,"Philadelphia Eagles",7,51,37,TRUE,"11/26/1967",1967,"November","1960s",48,56,14
"770","196711260cle","Cleveland Browns",42,"Washington Redskins",37,79,5,TRUE,"11/26/1967",1967,"November","1960s",46,59,15
"771","196712030was","Washington Redskins",35,"Philadelphia Eagles",35,70,0,FALSE,"12/3/1967",1967,"December","1960s",36,93,9
"772","196712030sfo","San Francisco 49ers",14,"Chicago Bears",28,42,-14,FALSE,"12/3/1967",1967,"December","1960s",53,82,13
"773","196712030ram","Los Angeles Rams",20,"Atlanta Falcons",3,23,17,TRUE,"12/3/1967",1967,"December","1960s",56,43,8
"774","196712030min","Minnesota Vikings",27,"Green Bay Packers",30,57,-3,FALSE,"12/3/1967",1967,"December","1960s",25,79,8
"775","196712030crd","St. Louis Cardinals",31,"New Orleans Saints",20,51,11,TRUE,"12/3/1967",1967,"December","1960s",34,86,16
"776","196712030clt","Baltimore Colts",23,"Dallas Cowboys",17,40,6,TRUE,"12/3/1967",1967,"December","1960s",37,90,12
"777","196712030det","Detroit Lions",14,"Pittsburgh Steelers",24,38,-10,FALSE,"12/3/1967",1967,"December","1960s",34,76,12
"778","196712030cle","Cleveland Browns",24,"New York Giants",14,38,10,TRUE,"12/3/1967",1967,"December","1960s",39,73,15
"779","196712090ram","Los Angeles Rams",27,"Green Bay Packers",24,51,3,TRUE,"12/9/1967",1967,"December","1960s",55,53,7
"780","196712100clt","Baltimore Colts",30,"New Orleans Saints",10,40,20,TRUE,"12/10/1967",1967,"December","1960s",40,78,14
"781","196712100dal","Dallas Cowboys",38,"Philadelphia Eagles",17,55,21,TRUE,"12/10/1967",1967,"December","1960s",44,72,18
"782","196712100atl","Atlanta Falcons",28,"San Francisco 49ers",34,62,-6,FALSE,"12/10/1967",1967,"December","1960s",61,87,13
"783","196712100crd","St. Louis Cardinals",16,"Cleveland Browns",20,36,-4,FALSE,"12/10/1967",1967,"December","1960s",43,100,10
"784","196712100chi","Chicago Bears",10,"Minnesota Vikings",10,20,0,FALSE,"12/10/1967",1967,"December","1960s",37,94,15
"785","196712100nyg","New York Giants",7,"Detroit Lions",30,37,-23,FALSE,"12/10/1967",1967,"December","1960s",36,53,14
"786","196712100pit","Pittsburgh Steelers",10,"Washington Redskins",15,25,-5,FALSE,"12/10/1967",1967,"December","1960s",42,74,14
"787","196712160sfo","San Francisco 49ers",24,"Dallas Cowboys",16,40,8,TRUE,"12/16/1967",1967,"December","1960s",44,76,9
"788","196712170ram","Los Angeles Rams",34,"Baltimore Colts",10,44,24,TRUE,"12/17/1967",1967,"December","1960s",52,46,14
"789","196712170nyg","New York Giants",37,"St. Louis Cardinals",14,51,23,TRUE,"12/17/1967",1967,"December","1960s",38,52,15
"790","196712170gnb","Green Bay Packers",17,"Pittsburgh Steelers",24,41,-7,FALSE,"12/17/1967",1967,"December","1960s",30,76,11
"791","196712170was","Washington Redskins",14,"New Orleans Saints",30,44,-16,FALSE,"12/17/1967",1967,"December","1960s",36,50,6
"792","196712170atl","Atlanta Falcons",14,"Chicago Bears",23,37,-9,FALSE,"12/17/1967",1967,"December","1960s",46,68,7
"793","196712170phi","Philadelphia Eagles",28,"Cleveland Browns",24,52,4,TRUE,"12/17/1967",1967,"December","1960s",37,58,12
"794","196712170det","Detroit Lions",14,"Minnesota Vikings",3,17,11,TRUE,"12/17/1967",1967,"December","1960s",29,71,11
"795","196712230gnb","Green Bay Packers",28,"Los Angeles Rams",7,35,21,TRUE,"12/23/1967",1967,"December","1960s",13,60,15
"796","196712240dal","Dallas Cowboys",52,"Cleveland Browns",14,66,38,TRUE,"12/24/1967",1967,"December","1960s",44,54,12
"797","196712310gnb","Green Bay Packers",21,"Dallas Cowboys",17,38,4,TRUE,"12/31/1967",1967,"December","1960s",-2,55,15
"798","196801140gnb","Green Bay Packers",33,"Oakland Raiders",14,47,19,TRUE,"1/14/1968",1968,"January","1960s",60,74,12
"799","196809140min","Minnesota Vikings",47,"Atlanta Falcons",7,54,40,TRUE,"9/14/1968",1968,"September","1960s",73,58,13
"800","196809150gnb","Green Bay Packers",30,"Philadelphia Eagles",13,43,17,TRUE,"9/15/1968",1968,"September","1960s",67,66,11
"801","196809150dal","Dallas Cowboys",59,"Detroit Lions",13,72,46,TRUE,"9/15/1968",1968,"September","1960s",70,89,6
"802","196809150pit","Pittsburgh Steelers",20,"New York Giants",34,54,-14,FALSE,"9/15/1968",1968,"September","1960s",64,63,5
"803","196809150clt","Baltimore Colts",27,"San Francisco 49ers",10,37,17,TRUE,"9/15/1968",1968,"September","1960s",67,56,6
"804","196809150chi","Chicago Bears",28,"Washington Redskins",38,66,-10,FALSE,"9/15/1968",1968,"September","1960s",71,61,8
"805","196809150nor","New Orleans Saints",10,"Cleveland Browns",24,34,-14,FALSE,"9/15/1968",1968,"September","1960s",78,81,9
"806","196809160crd","St. Louis Cardinals",13,"Los Angeles Rams",24,37,-11,FALSE,"9/16/1968",1968,"September","1960s",69,79,14
"807","196809220det","Detroit Lions",42,"Chicago Bears",0,42,42,TRUE,"9/22/1968",1968,"September","1960s",70,84,7
"808","196809220nor","New Orleans Saints",37,"Washington Redskins",17,54,20,TRUE,"9/22/1968",1968,"September","1960s",77,75,10
"809","196809220gnb","Green Bay Packers",13,"Minnesota Vikings",26,39,-13,FALSE,"9/22/1968",1968,"September","1960s",68,83,6
"810","196809220dal","Dallas Cowboys",28,"Cleveland Browns",7,35,21,TRUE,"9/22/1968",1968,"September","1960s",79,80,10
"811","196809220phi","Philadelphia Eagles",25,"New York Giants",34,59,-9,FALSE,"9/22/1968",1968,"September","1960s",70,65,9
"812","196809220atl","Atlanta Falcons",20,"Baltimore Colts",28,48,-8,FALSE,"9/22/1968",1968,"September","1960s",71,67,8
"813","196809220sfo","San Francisco 49ers",35,"St. Louis Cardinals",17,52,18,TRUE,"9/22/1968",1968,"September","1960s",62,37,11
"814","196809220ram","Los Angeles Rams",45,"Pittsburgh Steelers",10,55,35,TRUE,"9/22/1968",1968,"September","1960s",67,66,8
"815","196809290phi","Philadelphia Eagles",13,"Dallas Cowboys",45,58,-32,FALSE,"9/29/1968",1968,"September","1960s",61,51,12
"816","196809290sfo","San Francisco 49ers",28,"Atlanta Falcons",13,41,15,TRUE,"9/29/1968",1968,"September","1960s",57,74,13
"817","196809290cle","Cleveland Browns",6,"Los Angeles Rams",24,30,-18,FALSE,"9/29/1968",1968,"September","1960s",51,77,4
"818","196809290pit","Pittsburgh Steelers",7,"Baltimore Colts",41,48,-34,FALSE,"9/29/1968",1968,"September","1960s",53,59,6
"819","196809290nyg","New York Giants",48,"Washington Redskins",21,69,27,TRUE,"9/29/1968",1968,"September","1960s",62,49,13
"820","196809290gnb","Green Bay Packers",17,"Detroit Lions",23,40,-6,FALSE,"9/29/1968",1968,"September","1960s",52,72,8
"821","196809290min","Minnesota Vikings",17,"Chicago Bears",27,44,-10,FALSE,"9/29/1968",1968,"September","1960s",54,79,7
"822","196809290nor","New Orleans Saints",20,"St. Louis Cardinals",21,41,-1,FALSE,"9/29/1968",1968,"September","1960s",73,66,5
"823","196810050cle","Cleveland Browns",31,"Pittsburgh Steelers",24,55,7,TRUE,"10/5/1968",1968,"October","1960s",43,71,7
"824","196810060crd","St. Louis Cardinals",10,"Dallas Cowboys",27,37,-17,FALSE,"10/6/1968",1968,"October","1960s",53,74,11
"825","196810060min","Minnesota Vikings",24,"Detroit Lions",10,34,14,TRUE,"10/6/1968",1968,"October","1960s",49,85,10
"826","196810060ram","Los Angeles Rams",24,"San Francisco 49ers",10,34,14,TRUE,"10/6/1968",1968,"October","1960s",62,88,7
"827","196810060atl","Atlanta Falcons",7,"Green Bay Packers",38,45,-31,FALSE,"10/6/1968",1968,"October","1960s",57,73,9
"828","196810060clt","Baltimore Colts",28,"Chicago Bears",7,35,21,TRUE,"10/6/1968",1968,"October","1960s",51,55,9
"829","196810060was","Washington Redskins",17,"Philadelphia Eagles",14,31,3,TRUE,"10/6/1968",1968,"October","1960s",46,62,9
"830","196810060nyg","New York Giants",38,"New Orleans Saints",21,59,17,TRUE,"10/6/1968",1968,"October","1960s",54,45,10
"831","196810130atl","Atlanta Falcons",24,"New York Giants",21,45,3,TRUE,"10/13/1968",1968,"October","1960s",69,83,5
"832","196810130was","Washington Redskins",16,"Pittsburgh Steelers",13,29,3,TRUE,"10/13/1968",1968,"October","1960s",62,79,3
"833","196810130dal","Dallas Cowboys",34,"Philadelphia Eagles",14,48,20,TRUE,"10/13/1968",1968,"October","1960s",77,78,12
"834","196810130gnb","Green Bay Packers",14,"Los Angeles Rams",16,30,-2,FALSE,"10/13/1968",1968,"October","1960s",62,81,8
"835","196810130chi","Chicago Bears",10,"Detroit Lions",28,38,-18,FALSE,"10/13/1968",1968,"October","1960s",67,72,9
"836","196810130cle","Cleveland Browns",21,"St. Louis Cardinals",27,48,-6,FALSE,"10/13/1968",1968,"October","1960s",58,82,6
"837","196810130nor","New Orleans Saints",20,"Minnesota Vikings",17,37,3,TRUE,"10/13/1968",1968,"October","1960s",74,85,7
"838","196810130sfo","San Francisco 49ers",14,"Baltimore Colts",42,56,-28,FALSE,"10/13/1968",1968,"October","1960s",58,85,7
"839","196810200pit","Pittsburgh Steelers",12,"New Orleans Saints",16,28,-4,FALSE,"10/20/1968",1968,"October","1960s",50,52,10
"840","196810200crd","St. Louis Cardinals",41,"Washington Redskins",14,55,27,TRUE,"10/20/1968",1968,"October","1960s",56,58,8
"841","196810200nyg","New York Giants",10,"San Francisco 49ers",26,36,-16,FALSE,"10/20/1968",1968,"October","1960s",63,58,13
"842","196810200min","Minnesota Vikings",7,"Dallas Cowboys",20,27,-13,FALSE,"10/20/1968",1968,"October","1960s",45,74,6
"843","196810200det","Detroit Lions",14,"Green Bay Packers",14,28,0,FALSE,"10/20/1968",1968,"October","1960s",49,65,11
"844","196810200clt","Baltimore Colts",20,"Cleveland Browns",30,50,-10,FALSE,"10/20/1968",1968,"October","1960s",64,50,14
"845","196810200ram","Los Angeles Rams",27,"Atlanta Falcons",14,41,13,TRUE,"10/20/1968",1968,"October","1960s",63,84,8
"846","196810200phi","Philadelphia Eagles",16,"Chicago Bears",29,45,-13,FALSE,"10/20/1968",1968,"October","1960s",62,49,12
"847","196810270det","Detroit Lions",7,"San Francisco 49ers",14,21,-7,FALSE,"10/27/1968",1968,"October","1960s",46,64,18
"848","196810270chi","Chicago Bears",26,"Minnesota Vikings",24,50,2,TRUE,"10/27/1968",1968,"October","1960s",51,54,17
"849","196810270clt","Baltimore Colts",27,"Los Angeles Rams",10,37,17,TRUE,"10/27/1968",1968,"October","1960s",49,44,12
"850","196810270crd","St. Louis Cardinals",31,"New Orleans Saints",17,48,14,TRUE,"10/27/1968",1968,"October","1960s",57,41,18
"851","196810270was","Washington Redskins",10,"New York Giants",13,23,-3,FALSE,"10/27/1968",1968,"October","1960s",46,54,12
"852","196810270pit","Pittsburgh Steelers",6,"Philadelphia Eagles",3,9,3,TRUE,"10/27/1968",1968,"October","1960s",45,56,14
"853","196810270cle","Cleveland Browns",30,"Atlanta Falcons",7,37,23,TRUE,"10/27/1968",1968,"October","1960s",45,63,17
"854","196810280dal","Dallas Cowboys",17,"Green Bay Packers",28,45,-11,FALSE,"10/28/1968",1968,"October","1960s",55,44,7
"855","196811030phi","Philadelphia Eagles",17,"St. Louis Cardinals",45,62,-28,FALSE,"11/3/1968",1968,"November","1960s",55,58,9
"856","196811030sfo","San Francisco 49ers",21,"Cleveland Browns",33,54,-12,FALSE,"11/3/1968",1968,"November","1960s",56,88,10
"857","196811030min","Minnesota Vikings",27,"Washington Redskins",14,41,13,TRUE,"11/3/1968",1968,"November","1960s",40,75,8
"858","196811030atl","Atlanta Falcons",21,"Pittsburgh Steelers",41,62,-20,FALSE,"11/3/1968",1968,"November","1960s",62,72,6
"859","196811030nor","New Orleans Saints",3,"Dallas Cowboys",17,20,-14,FALSE,"11/3/1968",1968,"November","1960s",65,84,8
"860","196811030ram","Los Angeles Rams",10,"Detroit Lions",7,17,3,TRUE,"11/3/1968",1968,"November","1960s",61,79,10
"861","196811030nyg","New York Giants",0,"Baltimore Colts",26,26,-26,FALSE,"11/3/1968",1968,"November","1960s",58,51,8
"862","196811030gnb","Green Bay Packers",10,"Chicago Bears",13,23,-3,FALSE,"11/3/1968",1968,"November","1960s",36,67,9
"863","196811100dal","Dallas Cowboys",21,"New York Giants",27,48,-6,FALSE,"11/10/1968",1968,"November","1960s",50,68,16
"864","196811100chi","Chicago Bears",27,"San Francisco 49ers",19,46,8,TRUE,"11/10/1968",1968,"November","1960s",35,59,6
"865","196811100cle","Cleveland Browns",35,"New Orleans Saints",17,52,18,TRUE,"11/10/1968",1968,"November","1960s",35,81,7
"866","196811100det","Detroit Lions",10,"Baltimore Colts",27,37,-17,FALSE,"11/10/1968",1968,"November","1960s",33,72,7
"867","196811100phi","Philadelphia Eagles",10,"Washington Redskins",16,26,-6,FALSE,"11/10/1968",1968,"November","1960s",40,78,15
"868","196811100min","Minnesota Vikings",14,"Green Bay Packers",10,24,4,TRUE,"11/10/1968",1968,"November","1960s",32,69,7
"869","196811100atl","Atlanta Falcons",10,"Los Angeles Rams",17,27,-7,FALSE,"11/10/1968",1968,"November","1960s",39,80,12
"870","196811100crd","St. Louis Cardinals",28,"Pittsburgh Steelers",28,56,0,FALSE,"11/10/1968",1968,"November","1960s",34,73,9
"871","196811170sfo","San Francisco 49ers",20,"Los Angeles Rams",20,40,0,FALSE,"11/17/1968",1968,"November","1960s",55,78,7
"872","196811170chi","Chicago Bears",13,"Atlanta Falcons",16,29,-3,FALSE,"11/17/1968",1968,"November","1960s",42,85,8
"873","196811170det","Detroit Lions",6,"Minnesota Vikings",13,19,-7,FALSE,"11/17/1968",1968,"November","1960s",42,86,11
"874","196811170nyg","New York Giants",7,"Philadelphia Eagles",6,13,1,TRUE,"11/17/1968",1968,"November","1960s",40,79,14
"875","196811170pit","Pittsburgh Steelers",24,"Cleveland Browns",45,69,-21,FALSE,"11/17/1968",1968,"November","1960s",47,90,9
"876","196811170clt","Baltimore Colts",27,"St. Louis Cardinals",0,27,27,TRUE,"11/17/1968",1968,"November","1960s",50,77,9
"877","196811170gnb","Green Bay Packers",29,"New Orleans Saints",7,36,22,TRUE,"11/17/1968",1968,"November","1960s",40,90,11
"878","196811170was","Washington Redskins",24,"Dallas Cowboys",44,68,-20,FALSE,"11/17/1968",1968,"November","1960s",52,79,8
"879","196811240ram","Los Angeles Rams",24,"New York Giants",21,45,3,TRUE,"11/24/1968",1968,"November","1960s",59,89,6
"880","196811240was","Washington Redskins",7,"Green Bay Packers",27,34,-20,FALSE,"11/24/1968",1968,"November","1960s",50,55,10
"881","196811240chi","Chicago Bears",3,"Dallas Cowboys",34,37,-31,FALSE,"11/24/1968",1968,"November","1960s",45,70,12
"882","196811240crd","St. Louis Cardinals",17,"Atlanta Falcons",12,29,5,TRUE,"11/24/1968",1968,"November","1960s",50,72,10
"883","196811240det","Detroit Lions",20,"New Orleans Saints",20,40,0,FALSE,"11/24/1968",1968,"November","1960s",50,63,15
"884","196811240clt","Baltimore Colts",21,"Minnesota Vikings",9,30,12,TRUE,"11/24/1968",1968,"November","1960s",50,63,9
"885","196811240pit","Pittsburgh Steelers",28,"San Francisco 49ers",45,73,-17,FALSE,"11/24/1968",1968,"November","1960s",53,60,12
"886","196811240cle","Cleveland Browns",47,"Philadelphia Eagles",13,60,34,TRUE,"11/24/1968",1968,"November","1960s",52,70,13
"887","196811280det","Detroit Lions",0,"Philadelphia Eagles",12,12,-12,FALSE,"11/28/1968",1968,"November","1960s",40,86,15
"888","196811280dal","Dallas Cowboys",29,"Washington Redskins",20,49,9,TRUE,"11/28/1968",1968,"November","1960s",46,71,15
"889","196812010clt","Baltimore Colts",44,"Atlanta Falcons",0,44,44,TRUE,"12/1/1968",1968,"December","1960s",40,56,7
"890","196812010min","Minnesota Vikings",3,"Los Angeles Rams",31,34,-28,FALSE,"12/1/1968",1968,"December","1960s",35,74,13
"891","196812010sfo","San Francisco 49ers",27,"Green Bay Packers",20,47,7,TRUE,"12/1/1968",1968,"December","1960s",52,80,16
"892","196812010pit","Pittsburgh Steelers",10,"St. Louis Cardinals",20,30,-10,FALSE,"12/1/1968",1968,"December","1960s",31,70,8
"893","196812010nor","New Orleans Saints",17,"Chicago Bears",23,40,-6,FALSE,"12/1/1968",1968,"December","1960s",60,89,15
"894","196812010cle","Cleveland Browns",45,"New York Giants",10,55,35,TRUE,"12/1/1968",1968,"December","1960s",32,68,11
"895","196812070gnb","Green Bay Packers",3,"Baltimore Colts",16,19,-13,FALSE,"12/7/1968",1968,"December","1960s",19,74,14
"896","196812080was","Washington Redskins",21,"Cleveland Browns",24,45,-3,FALSE,"12/8/1968",1968,"December","1960s",30,57,14
"897","196812080atl","Atlanta Falcons",7,"Detroit Lions",24,31,-17,FALSE,"12/8/1968",1968,"December","1960s",32,48,9
"898","196812080nyg","New York Giants",21,"St. Louis Cardinals",28,49,-7,FALSE,"12/8/1968",1968,"December","1960s",33,50,17
"899","196812080ram","Los Angeles Rams",16,"Chicago Bears",17,33,-1,FALSE,"12/8/1968",1968,"December","1960s",52,85,6
"900","196812080phi","Philadelphia Eagles",29,"New Orleans Saints",17,46,12,TRUE,"12/8/1968",1968,"December","1960s",31,49,16
"901","196812080dal","Dallas Cowboys",28,"Pittsburgh Steelers",7,35,21,TRUE,"12/8/1968",1968,"December","1960s",36,54,10
"902","196812080sfo","San Francisco 49ers",20,"Minnesota Vikings",30,50,-10,FALSE,"12/8/1968",1968,"December","1960s",51,87,13
"903","196812140crd","St. Louis Cardinals",27,"Cleveland Browns",16,43,11,TRUE,"12/14/1968",1968,"December","1960s",17,61,20
"904","196812150nyg","New York Giants",10,"Dallas Cowboys",28,38,-18,FALSE,"12/15/1968",1968,"December","1960s",30,83,20
"905","196812150was","Washington Redskins",14,"Detroit Lions",3,17,11,TRUE,"12/15/1968",1968,"December","1960s",29,54,21
"906","196812150ram","Los Angeles Rams",24,"Baltimore Colts",28,52,-4,FALSE,"12/15/1968",1968,"December","1960s",58,55,7
"907","196812150chi","Chicago Bears",27,"Green Bay Packers",28,55,-1,FALSE,"12/15/1968",1968,"December","1960s",22,71,19
"908","196812150phi","Philadelphia Eagles",17,"Minnesota Vikings",24,41,-7,FALSE,"12/15/1968",1968,"December","1960s",28,63,20
"909","196812150atl","Atlanta Falcons",12,"San Francisco 49ers",14,26,-2,FALSE,"12/15/1968",1968,"December","1960s",24,56,15
"910","196812150nor","New Orleans Saints",24,"Pittsburgh Steelers",14,38,10,TRUE,"12/15/1968",1968,"December","1960s",37,48,14
"911","196812210cle","Cleveland Browns",31,"Dallas Cowboys",20,51,11,TRUE,"12/21/1968",1968,"December","1960s",33,62,12
"912","196812220clt","Baltimore Colts",24,"Minnesota Vikings",14,38,10,TRUE,"12/22/1968",1968,"December","1960s",33,73,7
"913","196812290cle","Cleveland Browns",0,"Baltimore Colts",34,34,-34,FALSE,"12/29/1968",1968,"December","1960s",27,60,22
"914","196901120clt","Baltimore Colts",7,"New York Jets",16,23,-9,FALSE,"1/12/1969",1969,"January","1960s",66,80,12
"915","196909210atl","Atlanta Falcons",24,"San Francisco 49ers",12,36,12,TRUE,"9/21/1969",1969,"September","1960s",62,92,14
"916","196909210clt","Baltimore Colts",20,"Los Angeles Rams",27,47,-7,FALSE,"9/21/1969",1969,"September","1960s",63,64,10
"917","196909210gnb","Green Bay Packers",17,"Chicago Bears",0,17,17,TRUE,"9/21/1969",1969,"September","1960s",54,74,6
"918","196909210pit","Pittsburgh Steelers",16,"Detroit Lions",13,29,3,TRUE,"9/21/1969",1969,"September","1960s",56,73,8
"919","196909210phi","Philadelphia Eagles",20,"Cleveland Browns",27,47,-7,FALSE,"9/21/1969",1969,"September","1960s",61,53,14
"920","196909210dal","Dallas Cowboys",24,"St. Louis Cardinals",3,27,21,TRUE,"9/21/1969",1969,"September","1960s",77,75,7
"921","196909210nyg","New York Giants",24,"Minnesota Vikings",23,47,1,TRUE,"9/21/1969",1969,"September","1960s",58,59,13
"922","196909210nor","New Orleans Saints",20,"Washington Redskins",26,46,-6,FALSE,"9/21/1969",1969,"September","1960s",78,74,12
"923","196909280crd","St. Louis Cardinals",20,"Chicago Bears",17,37,3,TRUE,"9/28/1969",1969,"September","1960s",63,67,4
"924","196909280cle","Cleveland Browns",27,"Washington Redskins",23,50,4,TRUE,"9/28/1969",1969,"September","1960s",53,83,11
"925","196909280gnb","Green Bay Packers",14,"San Francisco 49ers",7,21,7,TRUE,"9/28/1969",1969,"September","1960s",54,59,11
"926","196909280phi","Philadelphia Eagles",41,"Pittsburgh Steelers",27,68,14,TRUE,"9/28/1969",1969,"September","1960s",64,70,11
"927","196909280det","Detroit Lions",24,"New York Giants",0,24,24,TRUE,"9/28/1969",1969,"September","1960s",55,65,12
"928","196909280min","Minnesota Vikings",52,"Baltimore Colts",14,66,38,TRUE,"9/28/1969",1969,"September","1960s",53,65,7
"929","196909280nor","New Orleans Saints",17,"Dallas Cowboys",21,38,-4,FALSE,"9/28/1969",1969,"September","1960s",74,71,7
"930","196909280ram","Los Angeles Rams",17,"Atlanta Falcons",7,24,10,TRUE,"9/28/1969",1969,"September","1960s",66,83,10
"931","196910050ram","Los Angeles Rams",36,"New Orleans Saints",17,53,19,TRUE,"10/5/1969",1969,"October","1960s",69,37,11
"932","196910050pit","Pittsburgh Steelers",14,"St. Louis Cardinals",27,41,-13,FALSE,"10/5/1969",1969,"October","1960s",55,71,10
"933","196910050sfo","San Francisco 49ers",17,"Washington Redskins",17,34,0,FALSE,"10/5/1969",1969,"October","1960s",61,35,11
"934","196910050phi","Philadelphia Eagles",7,"Dallas Cowboys",38,45,-31,FALSE,"10/5/1969",1969,"October","1960s",57,61,12
"935","196910050cle","Cleveland Browns",21,"Detroit Lions",28,49,-7,FALSE,"10/5/1969",1969,"October","1960s",57,72,10
"936","196910050min","Minnesota Vikings",19,"Green Bay Packers",7,26,12,TRUE,"10/5/1969",1969,"October","1960s",66,72,11
"937","196910050atl","Atlanta Falcons",14,"Baltimore Colts",21,35,-7,FALSE,"10/5/1969",1969,"October","1960s",68,73,12
"938","196910050nyg","New York Giants",28,"Chicago Bears",24,52,4,TRUE,"10/5/1969",1969,"October","1960s",55,58,14
"939","196910120nyg","New York Giants",10,"Pittsburgh Steelers",7,17,3,TRUE,"10/12/1969",1969,"October","1960s",67,81,9
"940","196910120was","Washington Redskins",33,"St. Louis Cardinals",17,50,16,TRUE,"10/12/1969",1969,"October","1960s",61,82,6
"941","196910120atl","Atlanta Falcons",17,"Dallas Cowboys",24,41,-7,FALSE,"10/12/1969",1969,"October","1960s",70,73,4
"942","196910120sfo","San Francisco 49ers",21,"Los Angeles Rams",27,48,-6,FALSE,"10/12/1969",1969,"October","1960s",61,37,8
"943","196910120det","Detroit Lions",17,"Green Bay Packers",28,45,-11,FALSE,"10/12/1969",1969,"October","1960s",56,78,12
"944","196910120nor","New Orleans Saints",17,"Cleveland Browns",27,44,-10,FALSE,"10/12/1969",1969,"October","1960s",80,74,15
"945","196910120chi","Chicago Bears",0,"Minnesota Vikings",31,31,-31,FALSE,"10/12/1969",1969,"October","1960s",56,73,12
"946","196910130clt","Baltimore Colts",24,"Philadelphia Eagles",20,44,4,TRUE,"10/13/1969",1969,"October","1960s",66,74,6
"947","196910180cle","Cleveland Browns",42,"Pittsburgh Steelers",31,73,11,TRUE,"10/18/1969",1969,"October","1960s",42,59,14
"948","196910190was","Washington Redskins",20,"New York Giants",14,34,6,TRUE,"10/19/1969",1969,"October","1960s",54,54,4
"949","196910190crd","St. Louis Cardinals",10,"Minnesota Vikings",27,37,-17,FALSE,"10/19/1969",1969,"October","1960s",55,74,9
"950","196910190det","Detroit Lions",13,"Chicago Bears",7,20,6,TRUE,"10/19/1969",1969,"October","1960s",48,67,9
"951","196910190sfo","San Francisco 49ers",7,"Atlanta Falcons",21,28,-14,FALSE,"10/19/1969",1969,"October","1960s",57,57,9
"952","196910190nor","New Orleans Saints",10,"Baltimore Colts",30,40,-20,FALSE,"10/19/1969",1969,"October","1960s",71,68,12
"953","196910190dal","Dallas Cowboys",49,"Philadelphia Eagles",14,63,35,TRUE,"10/19/1969",1969,"October","1960s",69,62,10
"954","196910190ram","Los Angeles Rams",34,"Green Bay Packers",21,55,13,TRUE,"10/19/1969",1969,"October","1960s",61,62,12
"955","196910260gnb","Green Bay Packers",28,"Atlanta Falcons",10,38,18,TRUE,"10/26/1969",1969,"October","1960s",44,70,14
"956","196910260clt","Baltimore Colts",21,"San Francisco 49ers",24,45,-3,FALSE,"10/26/1969",1969,"October","1960s",48,49,5
"957","196910260phi","Philadelphia Eagles",13,"New Orleans Saints",10,23,3,TRUE,"10/26/1969",1969,"October","1960s",47,58,7
"958","196910260chi","Chicago Bears",7,"Los Angeles Rams",9,16,-2,FALSE,"10/26/1969",1969,"October","1960s",51,62,10
"959","196910260pit","Pittsburgh Steelers",7,"Washington Redskins",14,21,-7,FALSE,"10/26/1969",1969,"October","1960s",46,63,6
"960","196910260cle","Cleveland Browns",21,"St. Louis Cardinals",21,42,0,FALSE,"10/26/1969",1969,"October","1960s",46,73,10
"961","196910260min","Minnesota Vikings",24,"Detroit Lions",10,34,14,TRUE,"10/26/1969",1969,"October","1960s",40,79,15
"962","196910270dal","Dallas Cowboys",25,"New York Giants",3,28,22,TRUE,"10/27/1969",1969,"October","1960s",56,74,16
"963","196911020min","Minnesota Vikings",31,"Chicago Bears",14,45,17,TRUE,"11/2/1969",1969,"November","1960s",40,88,12
"964","196911020cle","Cleveland Browns",42,"Dallas Cowboys",10,52,32,TRUE,"11/2/1969",1969,"November","1960s",52,87,12
"965","196911020crd","St. Louis Cardinals",42,"New Orleans Saints",51,93,-9,FALSE,"11/2/1969",1969,"November","1960s",45,82,10
"966","196911020pit","Pittsburgh Steelers",34,"Green Bay Packers",38,72,-4,FALSE,"11/2/1969",1969,"November","1960s",56,84,11
"967","196911020atl","Atlanta Falcons",6,"Los Angeles Rams",38,44,-32,FALSE,"11/2/1969",1969,"November","1960s",61,89,6
"968","196911020clt","Baltimore Colts",41,"Washington Redskins",17,58,24,TRUE,"11/2/1969",1969,"November","1960s",61,84,10
"969","196911020nyg","New York Giants",20,"Philadelphia Eagles",23,43,-3,FALSE,"11/2/1969",1969,"November","1960s",56,82,14
"970","196911020sfo","San Francisco 49ers",14,"Detroit Lions",26,40,-12,FALSE,"11/2/1969",1969,"November","1960s",61,67,11
"971","196911090was","Washington Redskins",28,"Philadelphia Eagles",28,56,0,FALSE,"11/9/1969",1969,"November","1960s",46,91,12
"972","196911090ram","Los Angeles Rams",41,"San Francisco 49ers",30,71,11,TRUE,"11/9/1969",1969,"November","1960s",61,63,9
"973","196911090dal","Dallas Cowboys",33,"New Orleans Saints",17,50,16,TRUE,"11/9/1969",1969,"November","1960s",63,66,6
"974","196911090chi","Chicago Bears",38,"Pittsburgh Steelers",7,45,31,TRUE,"11/9/1969",1969,"November","1960s",45,86,7
"975","196911090clt","Baltimore Colts",14,"Green Bay Packers",6,20,8,TRUE,"11/9/1969",1969,"November","1960s",51,77,12
"976","196911090crd","St. Louis Cardinals",42,"New York Giants",17,59,25,TRUE,"11/9/1969",1969,"November","1960s",48,72,4
"977","196911090det","Detroit Lions",27,"Atlanta Falcons",21,48,6,TRUE,"11/9/1969",1969,"November","1960s",44,87,8
"978","196911090min","Minnesota Vikings",51,"Cleveland Browns",3,54,48,TRUE,"11/9/1969",1969,"November","1960s",46,69,8
"979","196911160pit","Pittsburgh Steelers",3,"Cleveland Browns",24,27,-21,FALSE,"11/16/1969",1969,"November","1960s",28,71,12
"980","196911160nyg","New York Giants",24,"New Orleans Saints",25,49,-1,FALSE,"11/16/1969",1969,"November","1960s",34,48,16
"981","196911160phi","Philadelphia Eagles",17,"Los Angeles Rams",23,40,-6,FALSE,"11/16/1969",1969,"November","1960s",34,49,12
"982","196911160gnb","Green Bay Packers",7,"Minnesota Vikings",9,16,-2,FALSE,"11/16/1969",1969,"November","1960s",28,71,11
"983","196911160det","Detroit Lions",20,"St. Louis Cardinals",0,20,20,TRUE,"11/16/1969",1969,"November","1960s",33,64,14
"984","196911160was","Washington Redskins",28,"Dallas Cowboys",41,69,-13,FALSE,"11/16/1969",1969,"November","1960s",33,58,8
"985","196911160sfo","San Francisco 49ers",20,"Baltimore Colts",17,37,3,TRUE,"11/16/1969",1969,"November","1960s",57,76,14
"986","196911160atl","Atlanta Falcons",48,"Chicago Bears",31,79,17,TRUE,"11/16/1969",1969,"November","1960s",39,48,5
"987","196911230ram","Los Angeles Rams",24,"Dallas Cowboys",23,47,1,TRUE,"11/23/1969",1969,"November","1960s",59,59,7
"988","196911230crd","St. Louis Cardinals",30,"Philadelphia Eagles",34,64,-4,FALSE,"11/23/1969",1969,"November","1960s",55,58,13
"989","196911230cle","Cleveland Browns",28,"New York Giants",17,45,11,TRUE,"11/23/1969",1969,"November","1960s",44,64,10
"990","196911230chi","Chicago Bears",21,"Baltimore Colts",24,45,-3,FALSE,"11/23/1969",1969,"November","1960s",42,74,7
"991","196911230gnb","Green Bay Packers",10,"Detroit Lions",16,26,-6,FALSE,"11/23/1969",1969,"November","1960s",31,67,9
"992","196911230nor","New Orleans Saints",43,"San Francisco 49ers",38,81,5,TRUE,"11/23/1969",1969,"November","1960s",62,75,8
"993","196911230min","Minnesota Vikings",52,"Pittsburgh Steelers",14,66,38,TRUE,"11/23/1969",1969,"November","1960s",32,85,7
"994","196911230was","Washington Redskins",27,"Atlanta Falcons",20,47,7,TRUE,"11/23/1969",1969,"November","1960s",40,64,8
"995","196911270dal","Dallas Cowboys",24,"San Francisco 49ers",24,48,0,FALSE,"11/27/1969",1969,"November","1960s",52,79,15
"996","196911270det","Detroit Lions",0,"Minnesota Vikings",27,27,-27,FALSE,"11/27/1969",1969,"November","1960s",36,75,12
"997","196911300crd","St. Louis Cardinals",47,"Pittsburgh Steelers",10,57,37,TRUE,"11/30/1969",1969,"November","1960s",37,54,13
"998","196911300was","Washington Redskins",13,"Los Angeles Rams",24,37,-11,FALSE,"11/30/1969",1969,"November","1960s",35,60,11
"999","196911300clt","Baltimore Colts",13,"Atlanta Falcons",6,19,7,TRUE,"11/30/1969",1969,"November","1960s",39,50,11
"1000","196911300chi","Chicago Bears",24,"Cleveland Browns",28,52,-4,FALSE,"11/30/1969",1969,"November","1960s",34,61,11
"1001","196911300gnb","Green Bay Packers",20,"New York Giants",10,30,10,TRUE,"11/30/1969",1969,"November","1960s",32,60,17
"1002","196911300nor","New Orleans Saints",26,"Philadelphia Eagles",17,43,9,TRUE,"11/30/1969",1969,"November","1960s",50,52,9
"1003","196912060sfo","San Francisco 49ers",42,"Chicago Bears",21,63,21,TRUE,"12/6/1969",1969,"December","1960s",54,81,11
"1004","196912070pit","Pittsburgh Steelers",7,"Dallas Cowboys",10,17,-3,FALSE,"12/7/1969",1969,"December","1960s",34,62,12
"1005","196912070phi","Philadelphia Eagles",29,"Washington Redskins",34,63,-5,FALSE,"12/7/1969",1969,"December","1960s",32,57,10
"1006","196912070ram","Los Angeles Rams",13,"Minnesota Vikings",20,33,-7,FALSE,"12/7/1969",1969,"December","1960s",57,73,9
"1007","196912070clt","Baltimore Colts",17,"Detroit Lions",17,34,0,FALSE,"12/7/1969",1969,"December","1960s",34,57,9
"1008","196912070nyg","New York Giants",49,"St. Louis Cardinals",6,55,43,TRUE,"12/7/1969",1969,"December","1960s",34,46,10
"1009","196912070atl","Atlanta Falcons",45,"New Orleans Saints",17,62,28,TRUE,"12/7/1969",1969,"December","1960s",44,84,16
"1010","196912070cle","Cleveland Browns",20,"Green Bay Packers",7,27,13,TRUE,"12/7/1969",1969,"December","1960s",35,62,16
"1011","196912130dal","Dallas Cowboys",27,"Baltimore Colts",10,37,17,TRUE,"12/13/1969",1969,"December","1960s",56,71,12
"1012","196912140crd","St. Louis Cardinals",21,"Cleveland Browns",27,48,-6,FALSE,"12/14/1969",1969,"December","1960s",39,71,15
"1013","196912140pit","Pittsburgh Steelers",17,"New York Giants",21,38,-4,FALSE,"12/14/1969",1969,"December","1960s",35,75,12
"1014","196912140min","Minnesota Vikings",10,"San Francisco 49ers",7,17,3,TRUE,"12/14/1969",1969,"December","1960s",22,86,14
"1015","196912140was","Washington Redskins",17,"New Orleans Saints",14,31,3,TRUE,"12/14/1969",1969,"December","1960s",35,72,10
"1016","196912140phi","Philadelphia Eagles",3,"Atlanta Falcons",27,30,-24,FALSE,"12/14/1969",1969,"December","1960s",32,79,8
"1017","196912140chi","Chicago Bears",3,"Green Bay Packers",21,24,-18,FALSE,"12/14/1969",1969,"December","1960s",34,72,15
"1018","196912140det","Detroit Lions",28,"Los Angeles Rams",0,28,28,TRUE,"12/14/1969",1969,"December","1960s",33,84,13
"1019","196912210sfo","San Francisco 49ers",14,"Philadelphia Eagles",13,27,1,TRUE,"12/21/1969",1969,"December","1960s",62,82,21
"1020","196912210ram","Los Angeles Rams",7,"Baltimore Colts",13,20,-6,FALSE,"12/21/1969",1969,"December","1960s",61,88,9
"1021","196912210gnb","Green Bay Packers",45,"St. Louis Cardinals",28,73,17,TRUE,"12/21/1969",1969,"December","1960s",17,80,14
"1022","196912210nor","New Orleans Saints",27,"Pittsburgh Steelers",24,51,3,TRUE,"12/21/1969",1969,"December","1960s",64,78,14
"1023","196912210atl","Atlanta Falcons",10,"Minnesota Vikings",3,13,7,TRUE,"12/21/1969",1969,"December","1960s",36,63,10
"1024","196912210dal","Dallas Cowboys",20,"Washington Redskins",10,30,10,TRUE,"12/21/1969",1969,"December","1960s",54,79,15
"1025","196912210nyg","New York Giants",27,"Cleveland Browns",14,41,13,TRUE,"12/21/1969",1969,"December","1960s",30,51,13
"1026","196912210chi","Chicago Bears",3,"Detroit Lions",20,23,-17,FALSE,"12/21/1969",1969,"December","1960s",24,81,9
"1027","196912270min","Minnesota Vikings",23,"Los Angeles Rams",20,43,3,TRUE,"12/27/1969",1969,"December","1960s",10,83,7
"1028","196912280dal","Dallas Cowboys",14,"Cleveland Browns",38,52,-24,FALSE,"12/28/1969",1969,"December","1960s",51,95,14
"1029","197001040min","Minnesota Vikings",27,"Cleveland Browns",7,34,20,TRUE,"1/4/1970",1970,"January","1970s",8,75,9
"1030","197001110kan","Kansas City Chiefs",23,"Minnesota Vikings",7,30,16,TRUE,"1/11/1970",1970,"January","1970s",55,84,14
"1031","197009180ram","Los Angeles Rams",34,"St. Louis Cardinals",13,47,21,TRUE,"9/18/1970",1970,"September","1970s",63,84,10
"1032","197009190nyg","New York Giants",16,"Chicago Bears",24,40,-8,FALSE,"9/19/1970",1970,"September","1970s",71,70,13
"1033","197009200nor","New Orleans Saints",3,"Atlanta Falcons",14,17,-11,FALSE,"9/20/1970",1970,"September","1970s",82,81,8
"1034","197009200gnb","Green Bay Packers",0,"Detroit Lions",40,40,-40,FALSE,"9/20/1970",1970,"September","1970s",66,75,12
"1035","197009200buf","Buffalo Bills",10,"Denver Broncos",25,35,-15,FALSE,"9/20/1970",1970,"September","1970s",63,72,7
"1036","197009200sfo","San Francisco 49ers",26,"Washington Redskins",17,43,9,TRUE,"9/20/1970",1970,"September","1970s",59,74,21
"1037","197009200phi","Philadelphia Eagles",7,"Dallas Cowboys",17,24,-10,FALSE,"9/20/1970",1970,"September","1970s",67,73,7
"1038","197009200min","Minnesota Vikings",27,"Kansas City Chiefs",10,37,17,TRUE,"9/20/1970",1970,"September","1970s",70,78,12
"1039","197009200sdg","San Diego Chargers",14,"Baltimore Colts",16,30,-2,FALSE,"9/20/1970",1970,"September","1970s",66,70,8
"1040","197009200pit","Pittsburgh Steelers",7,"Houston Oilers",19,26,-12,FALSE,"9/20/1970",1970,"September","1970s",65,68,8
"1041","197009200cin","Cincinnati Bengals",31,"Oakland Raiders",21,52,10,TRUE,"9/20/1970",1970,"September","1970s",74,58,10
"1042","197009200nwe","Boston Patriots",27,"Miami Dolphins",14,41,13,TRUE,"9/20/1970",1970,"September","1970s",66,64,12
"1043","197009210cle","Cleveland Browns",31,"New York Jets",21,52,10,TRUE,"9/21/1970",1970,"September","1970s",74,67,13
"1044","197009270det","Detroit Lions",38,"Cincinnati Bengals",3,41,35,TRUE,"9/27/1970",1970,"September","1970s",54,69,12
"1045","197009270chi","Chicago Bears",20,"Philadelphia Eagles",16,36,4,TRUE,"9/27/1970",1970,"September","1970s",52,65,9
"1046","197009270den","Denver Broncos",16,"Pittsburgh Steelers",13,29,3,TRUE,"9/27/1970",1970,"September","1970s",49,54,7
"1047","197009270sdg","San Diego Chargers",27,"Oakland Raiders",27,54,0,FALSE,"9/27/1970",1970,"September","1970s",80,17,9
"1048","197009270sfo","San Francisco 49ers",34,"Cleveland Browns",31,65,3,TRUE,"9/27/1970",1970,"September","1970s",72,30,8
"1049","197009270dal","Dallas Cowboys",28,"New York Giants",10,38,18,TRUE,"9/27/1970",1970,"September","1970s",60,64,11
"1050","197009270crd","St. Louis Cardinals",27,"Washington Redskins",17,44,10,TRUE,"9/27/1970",1970,"September","1970s",54,73,10
"1051","197009270gnb","Green Bay Packers",27,"Atlanta Falcons",24,51,3,TRUE,"9/27/1970",1970,"September","1970s",47,62,12
"1052","197009270nwe","Boston Patriots",21,"New York Jets",31,52,-10,FALSE,"9/27/1970",1970,"September","1970s",69,86,16
"1053","197009270oti","Houston Oilers",10,"Miami Dolphins",20,30,-10,FALSE,"9/27/1970",1970,"September","1970s",72,NA,NA
"1054","197009270min","Minnesota Vikings",26,"New Orleans Saints",0,26,26,TRUE,"9/27/1970",1970,"September","1970s",50,64,9
"1055","197009270buf","Buffalo Bills",0,"Los Angeles Rams",19,19,-19,FALSE,"9/27/1970",1970,"September","1970s",56,74,11
"1056","197009280clt","Baltimore Colts",24,"Kansas City Chiefs",44,68,-20,FALSE,"9/28/1970",1970,"September","1970s",61,64,9
"1057","197010030cle","Cleveland Browns",15,"Pittsburgh Steelers",7,22,8,TRUE,"10/3/1970",1970,"October","1970s",54,66,16
"1058","197010030mia","Miami Dolphins",20,"Oakland Raiders",13,33,7,TRUE,"10/3/1970",1970,"October","1970s",82,79,7
"1059","197010040nwe","Boston Patriots",6,"Baltimore Colts",14,20,-8,FALSE,"10/4/1970",1970,"October","1970s",59,68,17
"1060","197010040phi","Philadelphia Eagles",21,"Washington Redskins",33,54,-12,FALSE,"10/4/1970",1970,"October","1970s",58,61,12
"1061","197010040ram","Los Angeles Rams",37,"San Diego Chargers",10,47,27,TRUE,"10/4/1970",1970,"October","1970s",68,79,11
"1062","197010040cin","Cincinnati Bengals",13,"Houston Oilers",20,33,-7,FALSE,"10/4/1970",1970,"October","1970s",51,46,7
"1063","197010040atl","Atlanta Falcons",21,"San Francisco 49ers",20,41,1,TRUE,"10/4/1970",1970,"October","1970s",65,34,8
"1064","197010040nor","New Orleans Saints",14,"New York Giants",10,24,4,TRUE,"10/4/1970",1970,"October","1970s",74,68,8
"1065","197010040crd","St. Louis Cardinals",20,"Dallas Cowboys",7,27,13,TRUE,"10/4/1970",1970,"October","1970s",53,53,8
"1066","197010040gnb","Green Bay Packers",13,"Minnesota Vikings",10,23,3,TRUE,"10/4/1970",1970,"October","1970s",48,52,11
"1067","197010040buf","Buffalo Bills",34,"New York Jets",31,65,3,TRUE,"10/4/1970",1970,"October","1970s",50,58,14
"1068","197010040den","Denver Broncos",26,"Kansas City Chiefs",13,39,13,TRUE,"10/4/1970",1970,"October","1970s",60,44,8
"1069","197010050det","Detroit Lions",28,"Chicago Bears",14,42,14,TRUE,"10/5/1970",1970,"October","1970s",55,54,13
"1070","197010100nyj","New York Jets",6,"Miami Dolphins",20,26,-14,FALSE,"10/10/1970",1970,"October","1970s",66,76,9
"1071","197010110ram","Los Angeles Rams",6,"San Francisco 49ers",20,26,-14,FALSE,"10/11/1970",1970,"October","1970s",66,77,8
"1072","197010110rai","Oakland Raiders",35,"Denver Broncos",23,58,12,TRUE,"10/11/1970",1970,"October","1970s",60,76,9
"1073","197010110was","Washington Redskins",31,"Detroit Lions",10,41,21,TRUE,"10/11/1970",1970,"October","1970s",67,86,6
"1074","197010110oti","Houston Oilers",20,"Baltimore Colts",24,44,-4,FALSE,"10/11/1970",1970,"October","1970s",72,NA,NA
"1075","197010110nyg","New York Giants",30,"Philadelphia Eagles",23,53,7,TRUE,"10/11/1970",1970,"October","1970s",64,79,9
"1076","197010110crd","St. Louis Cardinals",24,"New Orleans Saints",17,41,7,TRUE,"10/11/1970",1970,"October","1970s",50,76,7
"1077","197010110kan","Kansas City Chiefs",23,"Boston Patriots",10,33,13,TRUE,"10/11/1970",1970,"October","1970s",57,57,9
"1078","197010110dal","Dallas Cowboys",13,"Atlanta Falcons",0,13,13,TRUE,"10/11/1970",1970,"October","1970s",61,73,10
"1079","197010110cle","Cleveland Browns",30,"Cincinnati Bengals",27,57,3,TRUE,"10/11/1970",1970,"October","1970s",51,84,8
"1080","197010110pit","Pittsburgh Steelers",23,"Buffalo Bills",10,33,13,TRUE,"10/11/1970",1970,"October","1970s",59,85,7
"1081","197010110chi","Chicago Bears",0,"Minnesota Vikings",24,24,-24,FALSE,"10/11/1970",1970,"October","1970s",49,62,9
"1082","197010120sdg","San Diego Chargers",20,"Green Bay Packers",22,42,-2,FALSE,"10/12/1970",1970,"October","1970s",68,72,8
"1083","197010180phi","Philadelphia Eagles",20,"St. Louis Cardinals",35,55,-15,FALSE,"10/18/1970",1970,"October","1970s",53,54,14
"1084","197010180chi","Chicago Bears",7,"San Diego Chargers",20,27,-13,FALSE,"10/18/1970",1970,"October","1970s",50,55,10
"1085","197010180nwe","Boston Patriots",0,"New York Giants",16,16,-16,FALSE,"10/18/1970",1970,"October","1970s",46,52,22
"1086","197010180oti","Houston Oilers",3,"Pittsburgh Steelers",7,10,-4,FALSE,"10/18/1970",1970,"October","1970s",72,NA,NA
"1087","197010180nyj","New York Jets",22,"Baltimore Colts",29,51,-7,FALSE,"10/18/1970",1970,"October","1970s",51,49,15
"1088","197010180cle","Cleveland Browns",24,"Detroit Lions",41,65,-17,FALSE,"10/18/1970",1970,"October","1970s",46,64,14
"1089","197010180cin","Cincinnati Bengals",19,"Kansas City Chiefs",27,46,-8,FALSE,"10/18/1970",1970,"October","1970s",45,60,4
"1090","197010180buf","Buffalo Bills",14,"Miami Dolphins",33,47,-19,FALSE,"10/18/1970",1970,"October","1970s",49,76,16
"1091","197010180gnb","Green Bay Packers",21,"Los Angeles Rams",31,52,-10,FALSE,"10/18/1970",1970,"October","1970s",46,63,9
"1092","197010180min","Minnesota Vikings",54,"Dallas Cowboys",13,67,41,TRUE,"10/18/1970",1970,"October","1970s",52,69,10
"1093","197010180den","Denver Broncos",24,"Atlanta Falcons",10,34,14,TRUE,"10/18/1970",1970,"October","1970s",43,51,5
"1094","197010180sfo","San Francisco 49ers",20,"New Orleans Saints",20,40,0,FALSE,"10/18/1970",1970,"October","1970s",57,78,9
"1095","197010190rai","Oakland Raiders",34,"Washington Redskins",20,54,14,TRUE,"10/19/1970",1970,"October","1970s",58,80,6
"1096","197010250kan","Kansas City Chiefs",16,"Dallas Cowboys",27,43,-11,FALSE,"10/25/1970",1970,"October","1970s",64,78,12
"1097","197010250gnb","Green Bay Packers",30,"Philadelphia Eagles",17,47,13,TRUE,"10/25/1970",1970,"October","1970s",54,87,10
"1098","197010250nyg","New York Giants",35,"St. Louis Cardinals",17,52,18,TRUE,"10/25/1970",1970,"October","1970s",59,76,11
"1099","197010250nyj","New York Jets",6,"Buffalo Bills",10,16,-4,FALSE,"10/25/1970",1970,"October","1970s",59,76,11
"1100","197010250chi","Chicago Bears",10,"Detroit Lions",16,26,-6,FALSE,"10/25/1970",1970,"October","1970s",59,70,9
"1101","197010250clt","Baltimore Colts",27,"Boston Patriots",3,30,24,TRUE,"10/25/1970",1970,"October","1970s",61,71,6
"1102","197010250mia","Miami Dolphins",0,"Cleveland Browns",28,28,-28,FALSE,"10/25/1970",1970,"October","1970s",77,75,6
"1103","197010250rai","Oakland Raiders",31,"Pittsburgh Steelers",14,45,17,TRUE,"10/25/1970",1970,"October","1970s",55,71,8
"1104","197010250was","Washington Redskins",20,"Cincinnati Bengals",0,20,20,TRUE,"10/25/1970",1970,"October","1970s",52,93,4
"1105","197010250sdg","San Diego Chargers",31,"Houston Oilers",31,62,0,FALSE,"10/25/1970",1970,"October","1970s",63,67,10
"1106","197010250atl","Atlanta Falcons",32,"New Orleans Saints",14,46,18,TRUE,"10/25/1970",1970,"October","1970s",62,83,10
"1107","197010250sfo","San Francisco 49ers",19,"Denver Broncos",14,33,5,TRUE,"10/25/1970",1970,"October","1970s",56,68,13
"1108","197010260min","Minnesota Vikings",13,"Los Angeles Rams",3,16,10,TRUE,"10/26/1970",1970,"October","1970s",51,79,11
"1109","197011010det","Detroit Lions",17,"Minnesota Vikings",30,47,-13,FALSE,"11/1/1970",1970,"November","1970s",47,70,8
"1110","197011010atl","Atlanta Falcons",14,"Chicago Bears",23,37,-9,FALSE,"11/1/1970",1970,"November","1970s",62,75,7
"1111","197011010dal","Dallas Cowboys",21,"Philadelphia Eagles",17,38,4,TRUE,"11/1/1970",1970,"November","1970s",56,72,10
"1112","197011010crd","St. Louis Cardinals",44,"Houston Oilers",0,44,44,TRUE,"11/1/1970",1970,"November","1970s",44,73,5
"1113","197011010cle","Cleveland Browns",10,"San Diego Chargers",27,37,-17,FALSE,"11/1/1970",1970,"November","1970s",48,83,6
"1114","197011010clt","Baltimore Colts",35,"Miami Dolphins",0,35,35,TRUE,"11/1/1970",1970,"November","1970s",58,70,8
"1115","197011010nwe","Boston Patriots",10,"Buffalo Bills",45,55,-35,FALSE,"11/1/1970",1970,"November","1970s",48,87,8
"1116","197011010den","Denver Broncos",3,"Washington Redskins",19,22,-16,FALSE,"11/1/1970",1970,"November","1970s",36,82,7
"1117","197011010nyj","New York Jets",10,"New York Giants",22,32,-12,FALSE,"11/1/1970",1970,"November","1970s",53,80,11
"1118","197011010kan","Kansas City Chiefs",17,"Oakland Raiders",17,34,0,FALSE,"11/1/1970",1970,"November","1970s",40,66,4
"1119","197011010nor","New Orleans Saints",17,"Los Angeles Rams",30,47,-13,FALSE,"11/1/1970",1970,"November","1970s",57,72,2
"1120","197011010sfo","San Francisco 49ers",26,"Green Bay Packers",10,36,16,TRUE,"11/1/1970",1970,"November","1970s",58,74,8
"1121","197011020pit","Pittsburgh Steelers",21,"Cincinnati Bengals",10,31,11,TRUE,"11/2/1970",1970,"November","1970s",55,81,10
"1122","197011080nyg","New York Giants",23,"Dallas Cowboys",20,43,3,TRUE,"11/8/1970",1970,"November","1970s",52,64,12
"1123","197011080nor","New Orleans Saints",19,"Detroit Lions",17,36,2,TRUE,"11/8/1970",1970,"November","1970s",65,79,10
"1124","197011080buf","Buffalo Bills",14,"Cincinnati Bengals",43,57,-29,FALSE,"11/8/1970",1970,"November","1970s",39,70,7
"1125","197011080sdg","San Diego Chargers",24,"Denver Broncos",21,45,3,TRUE,"11/8/1970",1970,"November","1970s",61,69,9
"1126","197011080kan","Kansas City Chiefs",24,"Houston Oilers",9,33,15,TRUE,"11/8/1970",1970,"November","1970s",56,67,11
"1127","197011080phi","Philadelphia Eagles",24,"Miami Dolphins",17,41,7,TRUE,"11/8/1970",1970,"November","1970s",53,72,11
"1128","197011080pit","Pittsburgh Steelers",21,"New York Jets",17,38,4,TRUE,"11/8/1970",1970,"November","1970s",46,74,7
"1129","197011080crd","St. Louis Cardinals",31,"Boston Patriots",0,31,31,TRUE,"11/8/1970",1970,"November","1970s",49,82,10
"1130","197011080chi","Chicago Bears",16,"San Francisco 49ers",37,53,-21,FALSE,"11/8/1970",1970,"November","1970s",42,70,6
"1131","197011080was","Washington Redskins",10,"Minnesota Vikings",19,29,-9,FALSE,"11/8/1970",1970,"November","1970s",45,80,4
"1132","197011080ram","Los Angeles Rams",10,"Atlanta Falcons",10,20,0,FALSE,"11/8/1970",1970,"November","1970s",62,61,11
"1133","197011080rai","Oakland Raiders",23,"Cleveland Browns",20,43,3,TRUE,"11/8/1970",1970,"November","1970s",60,76,5
"1134","197011090gnb","Green Bay Packers",10,"Baltimore Colts",13,23,-3,FALSE,"11/9/1970",1970,"November","1970s",50,83,14
"1135","197011150cin","Cincinnati Bengals",14,"Cleveland Browns",10,24,4,TRUE,"11/15/1970",1970,"November","1970s",35,74,15
"1136","197011150oti","Houston Oilers",20,"San Francisco 49ers",30,50,-10,FALSE,"11/15/1970",1970,"November","1970s",72,NA,NA
"1137","197011150pit","Pittsburgh Steelers",14,"Kansas City Chiefs",31,45,-17,FALSE,"11/15/1970",1970,"November","1970s",42,89,14
"1138","197011150ram","Los Angeles Rams",20,"New York Jets",31,51,-11,FALSE,"11/15/1970",1970,"November","1970s",68,18,10
"1139","197011150min","Minnesota Vikings",24,"Detroit Lions",20,44,4,TRUE,"11/15/1970",1970,"November","1970s",25,61,9
"1140","197011150nyg","New York Giants",35,"Washington Redskins",33,68,2,TRUE,"11/15/1970",1970,"November","1970s",50,84,15
"1141","197011150phi","Philadelphia Eagles",13,"Atlanta Falcons",13,26,0,FALSE,"11/15/1970",1970,"November","1970s",53,97,14
"1142","197011150nwe","Boston Patriots",14,"San Diego Chargers",16,30,-2,FALSE,"11/15/1970",1970,"November","1970s",44,97,17
"1143","197011150mia","Miami Dolphins",21,"New Orleans Saints",10,31,11,TRUE,"11/15/1970",1970,"November","1970s",77,82,12
"1144","197011150clt","Baltimore Colts",17,"Buffalo Bills",17,34,0,FALSE,"11/15/1970",1970,"November","1970s",54,91,10
"1145","197011150gnb","Green Bay Packers",20,"Chicago Bears",19,39,1,TRUE,"11/15/1970",1970,"November","1970s",29,61,14
"1146","197011150den","Denver Broncos",19,"Oakland Raiders",24,43,-5,FALSE,"11/15/1970",1970,"November","1970s",28,66,12
"1147","197011160dal","Dallas Cowboys",0,"St. Louis Cardinals",38,38,-38,FALSE,"11/16/1970",1970,"November","1970s",42,57,8
"1148","197011220rai","Oakland Raiders",20,"San Diego Chargers",17,37,3,TRUE,"11/22/1970",1970,"November","1970s",56,75,8
"1149","197011220chi","Chicago Bears",31,"Buffalo Bills",13,44,18,TRUE,"11/22/1970",1970,"November","1970s",43,50,22
"1150","197011220cle","Cleveland Browns",28,"Houston Oilers",14,42,14,TRUE,"11/22/1970",1970,"November","1970s",44,54,22
"1151","197011220min","Minnesota Vikings",10,"Green Bay Packers",3,13,7,TRUE,"11/22/1970",1970,"November","1970s",24,64,23
"1152","197011220mia","Miami Dolphins",34,"Baltimore Colts",17,51,17,TRUE,"11/22/1970",1970,"November","1970s",72,78,7
"1153","197011220nyj","New York Jets",17,"Boston Patriots",3,20,14,TRUE,"11/22/1970",1970,"November","1970s",50,49,15
"1154","197011220was","Washington Redskins",21,"Dallas Cowboys",45,66,-24,FALSE,"11/22/1970",1970,"November","1970s",44,52,10
"1155","197011220atl","Atlanta Falcons",7,"Los Angeles Rams",17,24,-10,FALSE,"11/22/1970",1970,"November","1970s",50,55,7
"1156","197011220nor","New Orleans Saints",6,"Denver Broncos",31,37,-25,FALSE,"11/22/1970",1970,"November","1970s",59,82,7
"1157","197011220kan","Kansas City Chiefs",6,"St. Louis Cardinals",6,12,0,FALSE,"11/22/1970",1970,"November","1970s",42,62,13
"1158","197011220cin","Cincinnati Bengals",34,"Pittsburgh Steelers",7,41,27,TRUE,"11/22/1970",1970,"November","1970s",46,56,16
"1159","197011220det","Detroit Lions",28,"San Francisco 49ers",7,35,21,TRUE,"11/22/1970",1970,"November","1970s",42,63,18
"1160","197011230phi","Philadelphia Eagles",23,"New York Giants",20,43,3,TRUE,"11/23/1970",1970,"November","1970s",46,59,16
"1161","197011260dal","Dallas Cowboys",16,"Green Bay Packers",3,19,13,TRUE,"11/26/1970",1970,"November","1970s",65,69,20
"1162","197011260det","Detroit Lions",28,"Oakland Raiders",14,42,14,TRUE,"11/26/1970",1970,"November","1970s",33,62,16
"1163","197011290crd","St. Louis Cardinals",23,"Philadelphia Eagles",14,37,9,TRUE,"11/29/1970",1970,"November","1970s",53,88,13
"1164","197011290nyj","New York Jets",20,"Minnesota Vikings",10,30,10,TRUE,"11/29/1970",1970,"November","1970s",48,74,13
"1165","197011290kan","Kansas City Chiefs",26,"San Diego Chargers",14,40,12,TRUE,"11/29/1970",1970,"November","1970s",48,89,7
"1166","197011290clt","Baltimore Colts",21,"Chicago Bears",20,41,1,TRUE,"11/29/1970",1970,"November","1970s",51,70,6
"1167","197011290cin","Cincinnati Bengals",26,"New Orleans Saints",6,32,20,TRUE,"11/29/1970",1970,"November","1970s",52,76,12
"1168","197011290was","Washington Redskins",24,"New York Giants",27,51,-3,FALSE,"11/29/1970",1970,"November","1970s",48,75,6
"1169","197011290sfo","San Francisco 49ers",13,"Los Angeles Rams",30,43,-17,FALSE,"11/29/1970",1970,"November","1970s",52,88,12
"1170","197011290pit","Pittsburgh Steelers",28,"Cleveland Browns",9,37,19,TRUE,"11/29/1970",1970,"November","1970s",45,97,10
"1171","197011290oti","Houston Oilers",31,"Denver Broncos",21,52,10,TRUE,"11/29/1970",1970,"November","1970s",72,NA,NA
"1172","197011290buf","Buffalo Bills",10,"Boston Patriots",14,24,-4,FALSE,"11/29/1970",1970,"November","1970s",40,91,11
"1173","197011300atl","Atlanta Falcons",7,"Miami Dolphins",20,27,-13,FALSE,"11/30/1970",1970,"November","1970s",62,69,7
"1174","197012050min","Minnesota Vikings",16,"Chicago Bears",13,29,3,TRUE,"12/5/1970",1970,"December","1970s",18,61,18
"1175","197012060ram","Los Angeles Rams",34,"New Orleans Saints",16,50,18,TRUE,"12/6/1970",1970,"December","1970s",63,47,8
"1176","197012060sdg","San Diego Chargers",14,"Cincinnati Bengals",17,31,-3,FALSE,"12/6/1970",1970,"December","1970s",61,54,6
"1177","197012060clt","Baltimore Colts",29,"Philadelphia Eagles",10,39,19,TRUE,"12/6/1970",1970,"December","1970s",38,45,22
"1178","197012060nyj","New York Jets",13,"Oakland Raiders",14,27,-1,FALSE,"12/6/1970",1970,"December","1970s",37,52,22
"1179","197012060kan","Kansas City Chiefs",16,"Denver Broncos",0,16,16,TRUE,"12/6/1970",1970,"December","1970s",32,41,8
"1180","197012060sfo","San Francisco 49ers",24,"Atlanta Falcons",20,44,4,TRUE,"12/6/1970",1970,"December","1970s",55,91,7
"1181","197012060pit","Pittsburgh Steelers",12,"Green Bay Packers",20,32,-8,FALSE,"12/6/1970",1970,"December","1970s",22,74,22
"1182","197012060dal","Dallas Cowboys",34,"Washington Redskins",0,34,34,TRUE,"12/6/1970",1970,"December","1970s",52,47,13
"1183","197012060nyg","New York Giants",20,"Buffalo Bills",6,26,14,TRUE,"12/6/1970",1970,"December","1970s",37,52,22
"1184","197012060mia","Miami Dolphins",37,"Boston Patriots",20,57,17,TRUE,"12/6/1970",1970,"December","1970s",69,69,8
"1185","197012060det","Detroit Lions",16,"St. Louis Cardinals",3,19,13,TRUE,"12/6/1970",1970,"December","1970s",24,59,25
"1186","197012070oti","Houston Oilers",10,"Cleveland Browns",21,31,-11,FALSE,"12/7/1970",1970,"December","1970s",72,NA,NA
"1187","197012120rai","Oakland Raiders",20,"Kansas City Chiefs",6,26,14,TRUE,"12/12/1970",1970,"December","1970s",50,66,7
"1188","197012120cle","Cleveland Browns",2,"Dallas Cowboys",6,8,-4,FALSE,"12/12/1970",1970,"December","1970s",36,91,14
"1189","197012130atl","Atlanta Falcons",27,"Pittsburgh Steelers",16,43,11,TRUE,"12/13/1970",1970,"December","1970s",42,62,13
"1190","197012130den","Denver Broncos",17,"San Diego Chargers",17,34,0,FALSE,"12/13/1970",1970,"December","1970s",23,71,6
"1191","197012130was","Washington Redskins",24,"Philadelphia Eagles",6,30,18,TRUE,"12/13/1970",1970,"December","1970s",38,92,6
"1192","197012130oti","Houston Oilers",20,"Cincinnati Bengals",30,50,-10,FALSE,"12/13/1970",1970,"December","1970s",72,NA,NA
"1193","197012130chi","Chicago Bears",35,"Green Bay Packers",17,52,18,TRUE,"12/13/1970",1970,"December","1970s",32,80,11
"1194","197012130mia","Miami Dolphins",16,"New York Jets",10,26,6,TRUE,"12/13/1970",1970,"December","1970s",75,84,6
"1195","197012130crd","St. Louis Cardinals",17,"New York Giants",34,51,-17,FALSE,"12/13/1970",1970,"December","1970s",33,76,15
"1196","197012130nwe","Boston Patriots",14,"Minnesota Vikings",35,49,-21,FALSE,"12/13/1970",1970,"December","1970s",25,92,17
"1197","197012130nor","New Orleans Saints",27,"San Francisco 49ers",38,65,-11,FALSE,"12/13/1970",1970,"December","1970s",46,74,12
"1198","197012130buf","Buffalo Bills",14,"Baltimore Colts",20,34,-6,FALSE,"12/13/1970",1970,"December","1970s",28,90,11
"1199","197012140ram","Los Angeles Rams",23,"Detroit Lions",28,51,-5,FALSE,"12/14/1970",1970,"December","1970s",56,66,9
"1200","197012190clt","Baltimore Colts",35,"New York Jets",20,55,15,TRUE,"12/19/1970",1970,"December","1970s",43,75,5
"1201","197012200cin","Cincinnati Bengals",45,"Boston Patriots",7,52,38,TRUE,"12/20/1970",1970,"December","1970s",36,62,10
"1202","197012200phi","Philadelphia Eagles",30,"Pittsburgh Steelers",20,50,10,TRUE,"12/20/1970",1970,"December","1970s",44,62,14
"1203","197012200dal","Dallas Cowboys",52,"Houston Oilers",10,62,42,TRUE,"12/20/1970",1970,"December","1970s",44,72,8
"1204","197012200det","Detroit Lions",20,"Green Bay Packers",0,20,20,TRUE,"12/20/1970",1970,"December","1970s",30,70,16
"1205","197012200rai","Oakland Raiders",7,"San Francisco 49ers",38,45,-31,FALSE,"12/20/1970",1970,"December","1970s",45,72,12
"1206","197012200den","Denver Broncos",13,"Cleveland Browns",27,40,-14,FALSE,"12/20/1970",1970,"December","1970s",22,72,6
"1207","197012200sdg","San Diego Chargers",31,"Kansas City Chiefs",13,44,18,TRUE,"12/20/1970",1970,"December","1970s",54,69,10
"1208","197012200was","Washington Redskins",28,"St. Louis Cardinals",27,55,1,TRUE,"12/20/1970",1970,"December","1970s",47,56,10
"1209","197012200mia","Miami Dolphins",45,"Buffalo Bills",7,52,38,TRUE,"12/20/1970",1970,"December","1970s",74,62,7
"1210","197012200nyg","New York Giants",3,"Los Angeles Rams",31,34,-28,FALSE,"12/20/1970",1970,"December","1970s",46,49,20
"1211","197012200nor","New Orleans Saints",3,"Chicago Bears",24,27,-21,FALSE,"12/20/1970",1970,"December","1970s",65,85,7
"1212","197012200atl","Atlanta Falcons",7,"Minnesota Vikings",37,44,-30,FALSE,"12/20/1970",1970,"December","1970s",59,95,5
"1213","197012260clt","Baltimore Colts",17,"Cincinnati Bengals",0,17,17,TRUE,"12/26/1970",1970,"December","1970s",30,73,15
"1214","197012260dal","Dallas Cowboys",5,"Detroit Lions",0,5,5,TRUE,"12/26/1970",1970,"December","1970s",35,46,8
"1215","197012270rai","Oakland Raiders",21,"Miami Dolphins",14,35,7,TRUE,"12/27/1970",1970,"December","1970s",45,92,8
"1216","197012270min","Minnesota Vikings",14,"San Francisco 49ers",17,31,-3,FALSE,"12/27/1970",1970,"December","1970s",10,61,13
"1217","197101030clt","Baltimore Colts",27,"Oakland Raiders",17,44,10,TRUE,"1/3/1971",1971,"January","1970s",34,68,6
"1218","197101030sfo","San Francisco 49ers",10,"Dallas Cowboys",17,27,-7,FALSE,"1/3/1971",1971,"January","1970s",46,29,22
"1219","197101170clt","Baltimore Colts",16,"Dallas Cowboys",13,29,3,TRUE,"1/17/1971",1971,"January","1970s",59,60,11
"1220","197109190atl","Atlanta Falcons",20,"San Francisco 49ers",17,37,3,TRUE,"9/19/1971",1971,"September","1970s",71,81,5
"1221","197109190den","Denver Broncos",10,"Miami Dolphins",10,20,0,FALSE,"9/19/1971",1971,"September","1970s",34,69,8
"1222","197109190cin","Cincinnati Bengals",37,"Philadelphia Eagles",14,51,23,TRUE,"9/19/1971",1971,"September","1970s",68,82,6
"1223","197109190clt","Baltimore Colts",22,"New York Jets",0,22,22,TRUE,"9/19/1971",1971,"September","1970s",72,78,8
"1224","197109190buf","Buffalo Bills",37,"Dallas Cowboys",49,86,-12,FALSE,"9/19/1971",1971,"September","1970s",55,89,9
"1225","197109190crd","St. Louis Cardinals",17,"Washington Redskins",24,41,-7,FALSE,"9/19/1971",1971,"September","1970s",58,100,9
"1226","197109190sdg","San Diego Chargers",21,"Kansas City Chiefs",14,35,7,TRUE,"9/19/1971",1971,"September","1970s",73,74,12
"1227","197109190nor","New Orleans Saints",24,"Los Angeles Rams",20,44,4,TRUE,"9/19/1971",1971,"September","1970s",78,82,5
"1228","197109190cle","Cleveland Browns",31,"Houston Oilers",0,31,31,TRUE,"9/19/1971",1971,"September","1970s",63,84,8
"1229","197109190gnb","Green Bay Packers",40,"New York Giants",42,82,-2,FALSE,"9/19/1971",1971,"September","1970s",52,79,9
"1230","197109190chi","Chicago Bears",17,"Pittsburgh Steelers",15,32,2,TRUE,"9/19/1971",1971,"September","1970s",63,76,12
"1231","197109190nwe","New England Patriots",20,"Oakland Raiders",6,26,14,TRUE,"9/19/1971",1971,"September","1970s",63,76,13
"1232","197109200det","Detroit Lions",13,"Minnesota Vikings",16,29,-3,FALSE,"9/20/1971",1971,"September","1970s",62,85,10
"1233","197109260gnb","Green Bay Packers",34,"Denver Broncos",13,47,21,TRUE,"9/26/1971",1971,"September","1970s",56,93,12
"1234","197109260oti","Houston Oilers",16,"Kansas City Chiefs",20,36,-4,FALSE,"9/26/1971",1971,"September","1970s",72,NA,NA
"1235","197109260nwe","New England Patriots",7,"Detroit Lions",34,41,-27,FALSE,"9/26/1971",1971,"September","1970s",58,54,8
"1236","197109260nor","New Orleans Saints",20,"San Francisco 49ers",38,58,-18,FALSE,"9/26/1971",1971,"September","1970s",80,80,7
"1237","197109260pit","Pittsburgh Steelers",21,"Cincinnati Bengals",10,31,11,TRUE,"9/26/1971",1971,"September","1970s",59,80,7
"1238","197109260min","Minnesota Vikings",17,"Chicago Bears",20,37,-3,FALSE,"9/26/1971",1971,"September","1970s",56,84,13
"1239","197109260buf","Buffalo Bills",14,"Miami Dolphins",29,43,-15,FALSE,"9/26/1971",1971,"September","1970s",54,81,11
"1240","197109260ram","Los Angeles Rams",20,"Atlanta Falcons",20,40,0,FALSE,"9/26/1971",1971,"September","1970s",64,72,10
"1241","197109260phi","Philadelphia Eagles",7,"Dallas Cowboys",42,49,-35,FALSE,"9/26/1971",1971,"September","1970s",59,74,8
"1242","197109260nyg","New York Giants",3,"Washington Redskins",30,33,-27,FALSE,"9/26/1971",1971,"September","1970s",62,59,8
"1243","197109260clt","Baltimore Colts",13,"Cleveland Browns",14,27,-1,FALSE,"9/26/1971",1971,"September","1970s",56,82,4
"1244","197109260sdg","San Diego Chargers",0,"Oakland Raiders",34,34,-34,FALSE,"9/26/1971",1971,"September","1970s",68,57,10
"1245","197109270crd","St. Louis Cardinals",17,"New York Jets",10,27,7,TRUE,"9/27/1971",1971,"September","1970s",79,73,13
"1246","197110030nwe","New England Patriots",3,"Baltimore Colts",23,26,-20,FALSE,"10/3/1971",1971,"October","1970s",63,70,15
"1247","197110030crd","St. Louis Cardinals",20,"New York Giants",21,41,-1,FALSE,"10/3/1971",1971,"October","1970s",73,74,10
"1248","197110030dal","Dallas Cowboys",16,"Washington Redskins",20,36,-4,FALSE,"10/3/1971",1971,"October","1970s",70,94,10
"1249","197110030gnb","Green Bay Packers",20,"Cincinnati Bengals",17,37,3,TRUE,"10/3/1971",1971,"October","1970s",70,76,12
"1250","197110030ram","Los Angeles Rams",17,"Chicago Bears",3,20,14,TRUE,"10/3/1971",1971,"October","1970s",65,57,10
"1251","197110030oti","Houston Oilers",13,"New Orleans Saints",13,26,0,FALSE,"10/3/1971",1971,"October","1970s",72,NA,NA
"1252","197110030min","Minnesota Vikings",19,"Buffalo Bills",0,19,19,TRUE,"10/3/1971",1971,"October","1970s",53,67,13
"1253","197110030phi","Philadelphia Eagles",3,"San Francisco 49ers",31,34,-28,FALSE,"10/3/1971",1971,"October","1970s",71,85,13
"1254","197110030pit","Pittsburgh Steelers",21,"San Diego Chargers",17,38,4,TRUE,"10/3/1971",1971,"October","1970s",68,82,7
"1255","197110030mia","Miami Dolphins",10,"New York Jets",14,24,-4,FALSE,"10/3/1971",1971,"October","1970s",82,74,11
"1256","197110030det","Detroit Lions",41,"Atlanta Falcons",38,79,3,TRUE,"10/3/1971",1971,"October","1970s",69,80,7
"1257","197110030den","Denver Broncos",3,"Kansas City Chiefs",16,19,-13,FALSE,"10/3/1971",1971,"October","1970s",47,44,10
"1258","197110040cle","Cleveland Browns",20,"Oakland Raiders",34,54,-14,FALSE,"10/4/1971",1971,"October","1970s",70,70,12
"1259","197110100cle","Cleveland Browns",27,"Pittsburgh Steelers",17,44,10,TRUE,"10/10/1971",1971,"October","1970s",48,82,9
"1260","197110100nwe","New England Patriots",20,"New York Jets",0,20,20,TRUE,"10/10/1971",1971,"October","1970s",60,88,13
"1261","197110100was","Washington Redskins",22,"Houston Oilers",13,35,9,TRUE,"10/10/1971",1971,"October","1970s",57,96,9
"1262","197110100atl","Atlanta Falcons",9,"St. Louis Cardinals",26,35,-17,FALSE,"10/10/1971",1971,"October","1970s",61,66,14
"1263","197110100det","Detroit Lions",31,"Green Bay Packers",28,59,3,TRUE,"10/10/1971",1971,"October","1970s",50,71,9
"1264","197110100sfo","San Francisco 49ers",13,"Los Angeles Rams",20,33,-7,FALSE,"10/10/1971",1971,"October","1970s",53,91,16
"1265","197110100chi","Chicago Bears",35,"New Orleans Saints",14,49,21,TRUE,"10/10/1971",1971,"October","1970s",51,73,11
"1266","197110100cin","Cincinnati Bengals",13,"Miami Dolphins",23,36,-10,FALSE,"10/10/1971",1971,"October","1970s",47,76,10
"1267","197110100buf","Buffalo Bills",0,"Baltimore Colts",43,43,-43,FALSE,"10/10/1971",1971,"October","1970s",55,81,7
"1268","197110100phi","Philadelphia Eagles",0,"Minnesota Vikings",13,13,-13,FALSE,"10/10/1971",1971,"October","1970s",63,86,9
"1269","197110100den","Denver Broncos",16,"Oakland Raiders",27,43,-11,FALSE,"10/10/1971",1971,"October","1970s",58,39,9
"1270","197110100kan","Kansas City Chiefs",31,"San Diego Chargers",10,41,21,TRUE,"10/10/1971",1971,"October","1970s",52,53,10
"1271","197110110dal","Dallas Cowboys",20,"New York Giants",13,33,7,TRUE,"10/11/1971",1971,"October","1970s",64,59,7
"1272","197110170oti","Houston Oilers",7,"Detroit Lions",31,38,-24,FALSE,"10/17/1971",1971,"October","1970s",72,NA,NA
"1273","197110170gnb","Green Bay Packers",13,"Minnesota Vikings",24,37,-11,FALSE,"10/17/1971",1971,"October","1970s",55,85,10
"1274","197110170den","Denver Broncos",20,"San Diego Chargers",16,36,4,TRUE,"10/17/1971",1971,"October","1970s",50,90,9
"1275","197110170nyg","New York Giants",7,"Baltimore Colts",31,38,-24,FALSE,"10/17/1971",1971,"October","1970s",63,74,13
"1276","197110170mia","Miami Dolphins",41,"New England Patriots",3,44,38,TRUE,"10/17/1971",1971,"October","1970s",81,78,12
"1277","197110170nor","New Orleans Saints",24,"Dallas Cowboys",14,38,10,TRUE,"10/17/1971",1971,"October","1970s",75,82,5
"1278","197110170was","Washington Redskins",20,"St. Louis Cardinals",0,20,20,TRUE,"10/17/1971",1971,"October","1970s",62,90,8
"1279","197110170rai","Oakland Raiders",34,"Philadelphia Eagles",10,44,24,TRUE,"10/17/1971",1971,"October","1970s",54,57,8
"1280","197110170sfo","San Francisco 49ers",13,"Chicago Bears",0,13,13,TRUE,"10/17/1971",1971,"October","1970s",53,56,8
"1281","197110170cin","Cincinnati Bengals",24,"Cleveland Browns",27,51,-3,FALSE,"10/17/1971",1971,"October","1970s",62,83,5
"1282","197110170atl","Atlanta Falcons",16,"Los Angeles Rams",24,40,-8,FALSE,"10/17/1971",1971,"October","1970s",68,82,10
"1283","197110170nyj","New York Jets",28,"Buffalo Bills",17,45,11,TRUE,"10/17/1971",1971,"October","1970s",63,74,13
"1284","197110180kan","Kansas City Chiefs",38,"Pittsburgh Steelers",16,54,22,TRUE,"10/18/1971",1971,"October","1970s",73,75,14
"1285","197110230sdg","San Diego Chargers",20,"Buffalo Bills",3,23,17,TRUE,"10/23/1971",1971,"October","1970s",64,78,7
"1286","197110240det","Detroit Lions",23,"Chicago Bears",28,51,-5,FALSE,"10/24/1971",1971,"October","1970s",60,87,14
"1287","197110240nyj","New York Jets",14,"Miami Dolphins",30,44,-16,FALSE,"10/24/1971",1971,"October","1970s",60,92,17
"1288","197110240pit","Pittsburgh Steelers",23,"Houston Oilers",16,39,7,TRUE,"10/24/1971",1971,"October","1970s",60,82,12
"1289","197110240crd","St. Louis Cardinals",14,"San Francisco 49ers",26,40,-12,FALSE,"10/24/1971",1971,"October","1970s",61,95,8
"1290","197110240phi","Philadelphia Eagles",23,"New York Giants",7,30,16,TRUE,"10/24/1971",1971,"October","1970s",63,86,20
"1291","197110240rai","Oakland Raiders",31,"Cincinnati Bengals",27,58,4,TRUE,"10/24/1971",1971,"October","1970s",53,67,9
"1292","197110240dal","Dallas Cowboys",44,"New England Patriots",21,65,23,TRUE,"10/24/1971",1971,"October","1970s",62,80,6
"1293","197110240kan","Kansas City Chiefs",27,"Washington Redskins",20,47,7,TRUE,"10/24/1971",1971,"October","1970s",62,84,6
"1294","197110240ram","Los Angeles Rams",30,"Green Bay Packers",13,43,17,TRUE,"10/24/1971",1971,"October","1970s",61,73,12
"1295","197110240cle","Cleveland Browns",0,"Denver Broncos",27,27,-27,FALSE,"10/24/1971",1971,"October","1970s",60,85,9
"1296","197110240atl","Atlanta Falcons",28,"New Orleans Saints",6,34,22,TRUE,"10/24/1971",1971,"October","1970s",66,83,7
"1297","197110250min","Minnesota Vikings",10,"Baltimore Colts",3,13,7,TRUE,"10/25/1971",1971,"October","1970s",53,87,11
"1298","197110310buf","Buffalo Bills",23,"St. Louis Cardinals",28,51,-5,FALSE,"10/31/1971",1971,"October","1970s",61,81,14
"1299","197110310nyg","New York Giants",10,"Minnesota Vikings",17,27,-7,FALSE,"10/31/1971",1971,"October","1970s",60,86,12
"1300","197110310clt","Baltimore Colts",34,"Pittsburgh Steelers",21,55,13,TRUE,"10/31/1971",1971,"October","1970s",67,92,5
"1301","197110310sfo","San Francisco 49ers",27,"New England Patriots",10,37,17,TRUE,"10/31/1971",1971,"October","1970s",52,76,8
"1302","197110310was","Washington Redskins",24,"New Orleans Saints",14,38,10,TRUE,"10/31/1971",1971,"October","1970s",68,91,5
"1303","197110310phi","Philadelphia Eagles",17,"Denver Broncos",16,33,1,TRUE,"10/31/1971",1971,"October","1970s",64,88,8
"1304","197110310rai","Oakland Raiders",20,"Kansas City Chiefs",20,40,0,FALSE,"10/31/1971",1971,"October","1970s",52,72,10
"1305","197110310chi","Chicago Bears",23,"Dallas Cowboys",19,42,4,TRUE,"10/31/1971",1971,"October","1970s",55,56,19
"1306","197110310sdg","San Diego Chargers",49,"New York Jets",21,70,28,TRUE,"10/31/1971",1971,"October","1970s",57,54,10
"1307","197110310ram","Los Angeles Rams",14,"Miami Dolphins",20,34,-6,FALSE,"10/31/1971",1971,"October","1970s",54,57,10
"1308","197110310oti","Houston Oilers",10,"Cincinnati Bengals",6,16,4,TRUE,"10/31/1971",1971,"October","1970s",72,NA,NA
"1309","197110310cle","Cleveland Browns",14,"Atlanta Falcons",31,45,-17,FALSE,"10/31/1971",1971,"October","1970s",63,72,11
"1310","197111010gnb","Green Bay Packers",14,"Detroit Lions",14,28,0,FALSE,"11/1/1971",1971,"November","1970s",41,75,11
"1311","197111070den","Denver Broncos",20,"Detroit Lions",24,44,-4,FALSE,"11/7/1971",1971,"November","1970s",32,57,8
"1312","197111070nyj","New York Jets",13,"Kansas City Chiefs",10,23,3,TRUE,"11/7/1971",1971,"November","1970s",52,69,19
"1313","197111070mia","Miami Dolphins",34,"Buffalo Bills",0,34,34,TRUE,"11/7/1971",1971,"November","1970s",78,74,11
"1314","197111070chi","Chicago Bears",14,"Green Bay Packers",17,31,-3,FALSE,"11/7/1971",1971,"November","1970s",27,44,16
"1315","197111070nor","New Orleans Saints",21,"Oakland Raiders",21,42,0,FALSE,"11/7/1971",1971,"November","1970s",61,72,13
"1316","197111070crd","St. Louis Cardinals",13,"Dallas Cowboys",16,29,-3,FALSE,"11/7/1971",1971,"November","1970s",29,41,12
"1317","197111070min","Minnesota Vikings",9,"San Francisco 49ers",13,22,-4,FALSE,"11/7/1971",1971,"November","1970s",20,66,13
"1318","197111070cin","Cincinnati Bengals",6,"Atlanta Falcons",9,15,-3,FALSE,"11/7/1971",1971,"November","1970s",26,70,10
"1319","197111070nyg","New York Giants",35,"San Diego Chargers",17,52,18,TRUE,"11/7/1971",1971,"November","1970s",52,69,19
"1320","197111070nwe","New England Patriots",28,"Houston Oilers",20,48,8,TRUE,"11/7/1971",1971,"November","1970s",52,78,15
"1321","197111070pit","Pittsburgh Steelers",26,"Cleveland Browns",9,35,17,TRUE,"11/7/1971",1971,"November","1970s",31,60,17
"1322","197111070was","Washington Redskins",7,"Philadelphia Eagles",7,14,0,FALSE,"11/7/1971",1971,"November","1970s",47,56,17
"1323","197111080clt","Baltimore Colts",24,"Los Angeles Rams",17,41,7,TRUE,"11/8/1971",1971,"November","1970s",36,46,15
"1324","197111140det","Detroit Lions",13,"Los Angeles Rams",21,34,-8,FALSE,"11/14/1971",1971,"November","1970s",43,77,9
"1325","197111140nwe","New England Patriots",38,"Buffalo Bills",33,71,5,TRUE,"11/14/1971",1971,"November","1970s",33,54,9
"1326","197111140nyj","New York Jets",13,"Baltimore Colts",14,27,-1,FALSE,"11/14/1971",1971,"November","1970s",37,61,12
"1327","197111140atl","Atlanta Falcons",17,"New York Giants",21,38,-4,FALSE,"11/14/1971",1971,"November","1970s",58,68,8
"1328","197111140rai","Oakland Raiders",41,"Houston Oilers",21,62,20,TRUE,"11/14/1971",1971,"November","1970s",50,66,12
"1329","197111140kan","Kansas City Chiefs",13,"Cleveland Browns",7,20,6,TRUE,"11/14/1971",1971,"November","1970s",66,59,12
"1330","197111140min","Minnesota Vikings",3,"Green Bay Packers",0,3,3,TRUE,"11/14/1971",1971,"November","1970s",45,77,19
"1331","197111140sfo","San Francisco 49ers",20,"New Orleans Saints",26,46,-6,FALSE,"11/14/1971",1971,"November","1970s",49,66,13
"1332","197111140den","Denver Broncos",10,"Cincinnati Bengals",24,34,-14,FALSE,"11/14/1971",1971,"November","1970s",39,43,9
"1333","197111140dal","Dallas Cowboys",20,"Philadelphia Eagles",7,27,13,TRUE,"11/14/1971",1971,"November","1970s",73,66,17
"1334","197111140chi","Chicago Bears",16,"Washington Redskins",15,31,1,TRUE,"11/14/1971",1971,"November","1970s",56,65,17
"1335","197111140mia","Miami Dolphins",24,"Pittsburgh Steelers",21,45,3,TRUE,"11/14/1971",1971,"November","1970s",72,65,15
"1336","197111150sdg","San Diego Chargers",20,"St. Louis Cardinals",17,37,3,TRUE,"11/15/1971",1971,"November","1970s",57,66,9
"1337","197111210was","Washington Redskins",0,"Dallas Cowboys",13,13,-13,FALSE,"11/21/1971",1971,"November","1970s",41,65,14
"1338","197111210rai","Oakland Raiders",34,"San Diego Chargers",33,67,1,TRUE,"11/21/1971",1971,"November","1970s",50,65,7
"1339","197111210ram","Los Angeles Rams",17,"San Francisco 49ers",6,23,11,TRUE,"11/21/1971",1971,"November","1970s",57,65,7
"1340","197111210cle","Cleveland Browns",27,"New England Patriots",7,34,20,TRUE,"11/21/1971",1971,"November","1970s",37,66,21
"1341","197111210kan","Kansas City Chiefs",28,"Denver Broncos",10,38,18,TRUE,"11/21/1971",1971,"November","1970s",44,57,14
"1342","197111210nor","New Orleans Saints",10,"Minnesota Vikings",23,33,-13,FALSE,"11/21/1971",1971,"November","1970s",57,66,10
"1343","197111210crd","St. Louis Cardinals",20,"Philadelphia Eagles",37,57,-17,FALSE,"11/21/1971",1971,"November","1970s",42,57,16
"1344","197111210pit","Pittsburgh Steelers",17,"New York Giants",13,30,4,TRUE,"11/21/1971",1971,"November","1970s",35,79,19
"1345","197111210chi","Chicago Bears",3,"Detroit Lions",28,31,-25,FALSE,"11/21/1971",1971,"November","1970s",35,50,22
"1346","197111210mia","Miami Dolphins",17,"Baltimore Colts",14,31,3,TRUE,"11/21/1971",1971,"November","1970s",71,69,9
"1347","197111210buf","Buffalo Bills",7,"New York Jets",20,27,-13,FALSE,"11/21/1971",1971,"November","1970s",34,93,14
"1348","197111210cin","Cincinnati Bengals",28,"Houston Oilers",13,41,15,TRUE,"11/21/1971",1971,"November","1970s",37,63,18
"1349","197111220atl","Atlanta Falcons",28,"Green Bay Packers",21,49,7,TRUE,"11/22/1971",1971,"November","1970s",36,46,12
"1350","197111250det","Detroit Lions",32,"Kansas City Chiefs",21,53,11,TRUE,"11/25/1971",1971,"November","1970s",29,83,9
"1351","197111250dal","Dallas Cowboys",28,"Los Angeles Rams",21,49,7,TRUE,"11/25/1971",1971,"November","1970s",46,82,9
"1352","197111280gnb","Green Bay Packers",21,"New Orleans Saints",29,50,-8,FALSE,"11/28/1971",1971,"November","1970s",30,80,9
"1353","197111280cin","Cincinnati Bengals",31,"San Diego Chargers",0,31,31,TRUE,"11/28/1971",1971,"November","1970s",36,80,10
"1354","197111280pit","Pittsburgh Steelers",10,"Denver Broncos",22,32,-12,FALSE,"11/28/1971",1971,"November","1970s",37,78,12
"1355","197111280rai","Oakland Raiders",14,"Baltimore Colts",37,51,-23,FALSE,"11/28/1971",1971,"November","1970s",54,93,12
"1356","197111280nyj","New York Jets",21,"San Francisco 49ers",24,45,-3,FALSE,"11/28/1971",1971,"November","1970s",44,78,13
"1357","197111280nyg","New York Giants",7,"St. Louis Cardinals",24,31,-17,FALSE,"11/28/1971",1971,"November","1970s",44,78,13
"1358","197111280phi","Philadelphia Eagles",13,"Washington Redskins",20,33,-7,FALSE,"11/28/1971",1971,"November","1970s",43,70,12
"1359","197111280oti","Houston Oilers",24,"Cleveland Browns",37,61,-13,FALSE,"11/28/1971",1971,"November","1970s",72,NA,NA
"1360","197111280min","Minnesota Vikings",24,"Atlanta Falcons",7,31,17,TRUE,"11/28/1971",1971,"November","1970s",26,86,8
"1361","197111280buf","Buffalo Bills",27,"New England Patriots",20,47,7,TRUE,"11/28/1971",1971,"November","1970s",38,90,12
"1362","197111290mia","Miami Dolphins",34,"Chicago Bears",3,37,31,TRUE,"11/29/1971",1971,"November","1970s",74,74,11
"1363","197112040dal","Dallas Cowboys",52,"New York Jets",10,62,42,TRUE,"12/4/1971",1971,"December","1970s",42,86,7
"1364","197112050was","Washington Redskins",23,"New York Giants",7,30,16,TRUE,"12/5/1971",1971,"December","1970s",28,86,7
"1365","197112050atl","Atlanta Falcons",24,"Oakland Raiders",13,37,11,TRUE,"12/5/1971",1971,"December","1970s",37,85,19
"1366","197112050sdg","San Diego Chargers",30,"Minnesota Vikings",14,44,16,TRUE,"12/5/1971",1971,"December","1970s",55,45,8
"1367","197112050crd","St. Louis Cardinals",16,"Green Bay Packers",16,32,0,FALSE,"12/5/1971",1971,"December","1970s",40,96,6
"1368","197112050ram","Los Angeles Rams",45,"New Orleans Saints",28,73,17,TRUE,"12/5/1971",1971,"December","1970s",56,31,9
"1369","197112050den","Denver Broncos",6,"Chicago Bears",3,9,3,TRUE,"12/5/1971",1971,"December","1970s",29,51,10
"1370","197112050nwe","New England Patriots",34,"Miami Dolphins",13,47,21,TRUE,"12/5/1971",1971,"December","1970s",26,51,12
"1371","197112050oti","Houston Oilers",29,"Pittsburgh Steelers",3,32,26,TRUE,"12/5/1971",1971,"December","1970s",72,NA,NA
"1372","197112050cle","Cleveland Browns",31,"Cincinnati Bengals",27,58,4,TRUE,"12/5/1971",1971,"December","1970s",36,54,11
"1373","197112050clt","Baltimore Colts",24,"Buffalo Bills",0,24,24,TRUE,"12/5/1971",1971,"December","1970s",33,62,9
"1374","197112050det","Detroit Lions",20,"Philadelphia Eagles",23,43,-3,FALSE,"12/5/1971",1971,"December","1970s",35,78,11
"1375","197112060sfo","San Francisco 49ers",17,"Kansas City Chiefs",26,43,-9,FALSE,"12/6/1971",1971,"December","1970s",53,87,16
"1376","197112110clt","Baltimore Colts",14,"Miami Dolphins",3,17,11,TRUE,"12/11/1971",1971,"December","1970s",59,76,12
"1377","197112110min","Minnesota Vikings",29,"Detroit Lions",10,39,19,TRUE,"12/11/1971",1971,"December","1970s",18,73,12
"1378","197112120nor","New Orleans Saints",17,"Cleveland Browns",21,38,-4,FALSE,"12/12/1971",1971,"December","1970s",70,85,7
"1379","197112120phi","Philadelphia Eagles",19,"St. Louis Cardinals",7,26,12,TRUE,"12/12/1971",1971,"December","1970s",43,72,5
"1380","197112120nyg","New York Giants",14,"Dallas Cowboys",42,56,-28,FALSE,"12/12/1971",1971,"December","1970s",45,54,7
"1381","197112120cin","Cincinnati Bengals",13,"Pittsburgh Steelers",21,34,-8,FALSE,"12/12/1971",1971,"December","1970s",40,67,10
"1382","197112120nyj","New York Jets",13,"New England Patriots",6,19,7,TRUE,"12/12/1971",1971,"December","1970s",45,54,7
"1383","197112120sdg","San Diego Chargers",45,"Denver Broncos",17,62,28,TRUE,"12/12/1971",1971,"December","1970s",51,52,8
"1384","197112120sfo","San Francisco 49ers",24,"Atlanta Falcons",3,27,21,TRUE,"12/12/1971",1971,"December","1970s",47,81,13
"1385","197112120gnb","Green Bay Packers",31,"Chicago Bears",10,41,21,TRUE,"12/12/1971",1971,"December","1970s",28,69,12
"1386","197112120kan","Kansas City Chiefs",16,"Oakland Raiders",14,30,2,TRUE,"12/12/1971",1971,"December","1970s",38,78,11
"1387","197112120buf","Buffalo Bills",14,"Houston Oilers",20,34,-6,FALSE,"12/12/1971",1971,"December","1970s",37,67,11
"1388","197112130ram","Los Angeles Rams",24,"Washington Redskins",38,62,-14,FALSE,"12/13/1971",1971,"December","1970s",51,68,15
"1389","197112180dal","Dallas Cowboys",31,"St. Louis Cardinals",12,43,19,TRUE,"12/18/1971",1971,"December","1970s",45,61,9
"1390","197112190pit","Pittsburgh Steelers",14,"Los Angeles Rams",23,37,-9,FALSE,"12/19/1971",1971,"December","1970s",27,52,12
"1391","197112190nyj","New York Jets",35,"Cincinnati Bengals",21,56,14,TRUE,"12/19/1971",1971,"December","1970s",25,51,17
"1392","197112190kan","Kansas City Chiefs",22,"Buffalo Bills",9,31,13,TRUE,"12/19/1971",1971,"December","1970s",44,67,12
"1393","197112190mia","Miami Dolphins",27,"Green Bay Packers",6,33,21,TRUE,"12/19/1971",1971,"December","1970s",73,64,20
"1394","197112190rai","Oakland Raiders",21,"Denver Broncos",13,34,8,TRUE,"12/19/1971",1971,"December","1970s",44,82,4
"1395","197112190was","Washington Redskins",13,"Cleveland Browns",20,33,-7,FALSE,"12/19/1971",1971,"December","1970s",27,66,10
"1396","197112190oti","Houston Oilers",49,"San Diego Chargers",33,82,16,TRUE,"12/19/1971",1971,"December","1970s",72,NA,NA
"1397","197112190clt","Baltimore Colts",17,"New England Patriots",21,38,-4,FALSE,"12/19/1971",1971,"December","1970s",30,49,10
"1398","197112190chi","Chicago Bears",10,"Minnesota Vikings",27,37,-17,FALSE,"12/19/1971",1971,"December","1970s",32,66,18
"1399","197112190sfo","San Francisco 49ers",31,"Detroit Lions",27,58,4,TRUE,"12/19/1971",1971,"December","1970s",43,80,3
"1400","197112190nor","New Orleans Saints",20,"Atlanta Falcons",24,44,-4,FALSE,"12/19/1971",1971,"December","1970s",56,71,7
"1401","197112190nyg","New York Giants",28,"Philadelphia Eagles",41,69,-13,FALSE,"12/19/1971",1971,"December","1970s",25,51,17
"1402","197112250kan","Kansas City Chiefs",24,"Miami Dolphins",27,51,-3,FALSE,"12/25/1971",1971,"December","1970s",47,84,10
"1403","197112250min","Minnesota Vikings",12,"Dallas Cowboys",20,32,-8,FALSE,"12/25/1971",1971,"December","1970s",22,79,9
"1404","197112260cle","Cleveland Browns",3,"Baltimore Colts",20,23,-17,FALSE,"12/26/1971",1971,"December","1970s",47,81,12
"1405","197112260sfo","San Francisco 49ers",24,"Washington Redskins",20,44,4,TRUE,"12/26/1971",1971,"December","1970s",44,82,14
"1406","197201020dal","Dallas Cowboys",14,"San Francisco 49ers",3,17,11,TRUE,"1/2/1972",1972,"January","1970s",47,86,9
"1407","197201020mia","Miami Dolphins",21,"Baltimore Colts",0,21,21,TRUE,"1/2/1972",1972,"January","1970s",73,82,10
"1408","197201160dal","Dallas Cowboys",24,"Miami Dolphins",3,27,21,TRUE,"1/16/1972",1972,"January","1970s",34,40,18
"1409","197209170chi","Chicago Bears",21,"Atlanta Falcons",37,58,-16,FALSE,"9/17/1972",1972,"September","1970s",76,80,12
"1410","197209170sfo","San Francisco 49ers",34,"San Diego Chargers",3,37,31,TRUE,"9/17/1972",1972,"September","1970s",59,74,10
"1411","197209170kan","Kansas City Chiefs",10,"Miami Dolphins",20,30,-10,FALSE,"9/17/1972",1972,"September","1970s",81,65,15
"1412","197209170nwe","New England Patriots",7,"Cincinnati Bengals",31,38,-24,FALSE,"9/17/1972",1972,"September","1970s",74,66,19
"1413","197209170buf","Buffalo Bills",24,"New York Jets",41,65,-17,FALSE,"9/17/1972",1972,"September","1970s",73,71,25
"1414","197209170det","Detroit Lions",30,"New York Giants",16,46,14,TRUE,"9/17/1972",1972,"September","1970s",76,72,15
"1415","197209170dal","Dallas Cowboys",28,"Philadelphia Eagles",6,34,22,TRUE,"9/17/1972",1972,"September","1970s",80,80,11
"1416","197209170cle","Cleveland Browns",10,"Green Bay Packers",26,36,-16,FALSE,"9/17/1972",1972,"September","1970s",74,72,17
"1417","197209170pit","Pittsburgh Steelers",34,"Oakland Raiders",28,62,6,TRUE,"9/17/1972",1972,"September","1970s",72,70,13
"1418","197209170clt","Baltimore Colts",3,"St. Louis Cardinals",10,13,-7,FALSE,"9/17/1972",1972,"September","1970s",76,70,10
"1419","197209170den","Denver Broncos",30,"Houston Oilers",17,47,13,TRUE,"9/17/1972",1972,"September","1970s",69,27,10
"1420","197209170ram","Los Angeles Rams",34,"New Orleans Saints",14,48,20,TRUE,"9/17/1972",1972,"September","1970s",64,79,10
"1421","197209180min","Minnesota Vikings",21,"Washington Redskins",24,45,-3,FALSE,"9/18/1972",1972,"September","1970s",66,67,11
"1422","197209240chi","Chicago Bears",13,"Los Angeles Rams",13,26,0,FALSE,"9/24/1972",1972,"September","1970s",65,90,10
"1423","197209240was","Washington Redskins",24,"St. Louis Cardinals",10,34,14,TRUE,"9/24/1972",1972,"September","1970s",64,82,10
"1424","197209240mia","Miami Dolphins",34,"Houston Oilers",13,47,21,TRUE,"9/24/1972",1972,"September","1970s",77,87,11
"1425","197209240clt","Baltimore Colts",34,"New York Jets",44,78,-10,FALSE,"9/24/1972",1972,"September","1970s",63,74,8
"1426","197209240gnb","Green Bay Packers",14,"Oakland Raiders",20,34,-6,FALSE,"9/24/1972",1972,"September","1970s",61,83,10
"1427","197209240phi","Philadelphia Eagles",17,"Cleveland Browns",27,44,-10,FALSE,"9/24/1972",1972,"September","1970s",59,76,8
"1428","197209240nyg","New York Giants",14,"Dallas Cowboys",23,37,-9,FALSE,"9/24/1972",1972,"September","1970s",60,70,8
"1429","197209240cin","Cincinnati Bengals",15,"Pittsburgh Steelers",10,25,5,TRUE,"9/24/1972",1972,"September","1970s",69,92,9
"1430","197209240det","Detroit Lions",10,"Minnesota Vikings",34,44,-24,FALSE,"9/24/1972",1972,"September","1970s",63,86,8
"1431","197209240sdg","San Diego Chargers",37,"Denver Broncos",14,51,23,TRUE,"9/24/1972",1972,"September","1970s",68,74,13
"1432","197209240nwe","New England Patriots",21,"Atlanta Falcons",20,41,1,TRUE,"9/24/1972",1972,"September","1970s",59,72,12
"1433","197209240buf","Buffalo Bills",27,"San Francisco 49ers",20,47,7,TRUE,"9/24/1972",1972,"September","1970s",60,90,12
"1434","197209250nor","New Orleans Saints",17,"Kansas City Chiefs",20,37,-3,FALSE,"9/25/1972",1972,"September","1970s",79,81,12
"1435","197210010buf","Buffalo Bills",0,"Baltimore Colts",17,17,-17,FALSE,"10/1/1972",1972,"October","1970s",46,77,12
"1436","197210010oti","Houston Oilers",26,"New York Jets",20,46,6,TRUE,"10/1/1972",1972,"October","1970s",72,NA,NA
"1437","197210010cle","Cleveland Browns",27,"Cincinnati Bengals",6,33,21,TRUE,"10/1/1972",1972,"October","1970s",48,72,12
"1438","197210010atl","Atlanta Falcons",31,"Los Angeles Rams",3,34,28,TRUE,"10/1/1972",1972,"October","1970s",55,62,11
"1439","197210010den","Denver Broncos",24,"Kansas City Chiefs",45,69,-21,FALSE,"10/1/1972",1972,"October","1970s",62,24,7
"1440","197210010rai","Oakland Raiders",17,"San Diego Chargers",17,34,0,FALSE,"10/1/1972",1972,"October","1970s",61,83,10
"1441","197210010gnb","Green Bay Packers",16,"Dallas Cowboys",13,29,3,TRUE,"10/1/1972",1972,"October","1970s",54,68,15
"1442","197210010crd","St. Louis Cardinals",19,"Pittsburgh Steelers",25,44,-6,FALSE,"10/1/1972",1972,"October","1970s",58,58,10
"1443","197210010nwe","New England Patriots",24,"Washington Redskins",23,47,1,TRUE,"10/1/1972",1972,"October","1970s",54,62,14
"1444","197210010min","Minnesota Vikings",14,"Miami Dolphins",16,30,-2,FALSE,"10/1/1972",1972,"October","1970s",56,68,5
"1445","197210010chi","Chicago Bears",24,"Detroit Lions",38,62,-14,FALSE,"10/1/1972",1972,"October","1970s",54,61,12
"1446","197210010nor","New Orleans Saints",2,"San Francisco 49ers",37,39,-35,FALSE,"10/1/1972",1972,"October","1970s",64,59,14
"1447","197210020phi","Philadelphia Eagles",12,"New York Giants",27,39,-15,FALSE,"10/2/1972",1972,"October","1970s",55,54,7
"1448","197210080dal","Dallas Cowboys",17,"Pittsburgh Steelers",13,30,4,TRUE,"10/8/1972",1972,"October","1970s",68,70,8
"1449","197210080cle","Cleveland Browns",7,"Kansas City Chiefs",31,38,-24,FALSE,"10/8/1972",1972,"October","1970s",50,74,14
"1450","197210080ram","Los Angeles Rams",31,"San Francisco 49ers",7,38,24,TRUE,"10/8/1972",1972,"October","1970s",68,75,9
"1451","197210080nyg","New York Giants",45,"New Orleans Saints",21,66,24,TRUE,"10/8/1972",1972,"October","1970s",57,66,19
"1452","197210080was","Washington Redskins",14,"Philadelphia Eagles",0,14,14,TRUE,"10/8/1972",1972,"October","1970s",59,53,14
"1453","197210080atl","Atlanta Falcons",23,"Detroit Lions",26,49,-3,FALSE,"10/8/1972",1972,"October","1970s",60,57,11
"1454","197210080clt","Baltimore Colts",20,"San Diego Chargers",23,43,-3,FALSE,"10/8/1972",1972,"October","1970s",60,52,15
"1455","197210080min","Minnesota Vikings",17,"St. Louis Cardinals",19,36,-2,FALSE,"10/8/1972",1972,"October","1970s",54,54,14
"1456","197210080nyj","New York Jets",17,"Miami Dolphins",27,44,-10,FALSE,"10/8/1972",1972,"October","1970s",57,66,19
"1457","197210080gnb","Green Bay Packers",20,"Chicago Bears",17,37,3,TRUE,"10/8/1972",1972,"October","1970s",52,54,17
"1458","197210080cin","Cincinnati Bengals",21,"Denver Broncos",10,31,11,TRUE,"10/8/1972",1972,"October","1970s",53,70,12
"1459","197210080buf","Buffalo Bills",38,"New England Patriots",14,52,24,TRUE,"10/8/1972",1972,"October","1970s",48,74,18
"1460","197210090oti","Houston Oilers",0,"Oakland Raiders",34,34,-34,FALSE,"10/9/1972",1972,"October","1970s",72,NA,NA
"1461","197210150cle","Cleveland Browns",0,"Chicago Bears",17,17,-17,FALSE,"10/15/1972",1972,"October","1970s",47,55,13
"1462","197210150nor","New Orleans Saints",14,"Atlanta Falcons",21,35,-7,FALSE,"10/15/1972",1972,"October","1970s",74,81,7
"1463","197210150mia","Miami Dolphins",24,"San Diego Chargers",10,34,14,TRUE,"10/15/1972",1972,"October","1970s",78,72,10
"1464","197210150clt","Baltimore Colts",0,"Dallas Cowboys",21,21,-21,FALSE,"10/15/1972",1972,"October","1970s",56,53,13
"1465","197210150crd","St. Louis Cardinals",3,"Washington Redskins",33,36,-30,FALSE,"10/15/1972",1972,"October","1970s",50,59,11
"1466","197210150rai","Oakland Raiders",28,"Buffalo Bills",16,44,12,TRUE,"10/15/1972",1972,"October","1970s",62,84,13
"1467","197210150sfo","San Francisco 49ers",17,"New York Giants",23,40,-6,FALSE,"10/15/1972",1972,"October","1970s",59,89,11
"1468","197210150nwe","New England Patriots",13,"New York Jets",41,54,-28,FALSE,"10/15/1972",1972,"October","1970s",51,53,21
"1469","197210150pit","Pittsburgh Steelers",24,"Houston Oilers",7,31,17,TRUE,"10/15/1972",1972,"October","1970s",47,62,14
"1470","197210150den","Denver Broncos",20,"Minnesota Vikings",23,43,-3,FALSE,"10/15/1972",1972,"October","1970s",51,47,8
"1471","197210150phi","Philadelphia Eagles",3,"Los Angeles Rams",34,37,-31,FALSE,"10/15/1972",1972,"October","1970s",54,53,17
"1472","197210150kan","Kansas City Chiefs",16,"Cincinnati Bengals",23,39,-7,FALSE,"10/15/1972",1972,"October","1970s",47,56,11
"1473","197210160det","Detroit Lions",23,"Green Bay Packers",24,47,-1,FALSE,"10/16/1972",1972,"October","1970s",47,77,15
"1474","197210220pit","Pittsburgh Steelers",33,"New England Patriots",3,36,30,TRUE,"10/22/1972",1972,"October","1970s",52,59,9
"1475","197210220rai","Oakland Raiders",23,"Denver Broncos",30,53,-7,FALSE,"10/22/1972",1972,"October","1970s",60,87,5
"1476","197210220ram","Los Angeles Rams",15,"Cincinnati Bengals",12,27,3,TRUE,"10/22/1972",1972,"October","1970s",63,84,8
"1477","197210220det","Detroit Lions",34,"San Diego Chargers",20,54,14,TRUE,"10/22/1972",1972,"October","1970s",47,96,8
"1478","197210220kan","Kansas City Chiefs",20,"Philadelphia Eagles",21,41,-1,FALSE,"10/22/1972",1972,"October","1970s",55,92,13
"1479","197210220sfo","San Francisco 49ers",20,"New Orleans Saints",20,40,0,FALSE,"10/22/1972",1972,"October","1970s",58,89,8
"1480","197210220nyg","New York Giants",27,"St. Louis Cardinals",21,48,6,TRUE,"10/22/1972",1972,"October","1970s",49,60,8
"1481","197210220was","Washington Redskins",24,"Dallas Cowboys",20,44,4,TRUE,"10/22/1972",1972,"October","1970s",52,64,10
"1482","197210220oti","Houston Oilers",17,"Cleveland Browns",23,40,-6,FALSE,"10/22/1972",1972,"October","1970s",72,NA,NA
"1483","197210220nyj","New York Jets",24,"Baltimore Colts",20,44,4,TRUE,"10/22/1972",1972,"October","1970s",49,60,8
"1484","197210220mia","Miami Dolphins",24,"Buffalo Bills",23,47,1,TRUE,"10/22/1972",1972,"October","1970s",77,74,18
"1485","197210220gnb","Green Bay Packers",9,"Atlanta Falcons",10,19,-1,FALSE,"10/22/1972",1972,"October","1970s",49,96,8
"1486","197210230chi","Chicago Bears",13,"Minnesota Vikings",10,23,3,TRUE,"10/23/1972",1972,"October","1970s",52,92,13
"1487","197210290nyj","New York Jets",34,"New England Patriots",10,44,24,TRUE,"10/29/1972",1972,"October","1970s",61,91,11
"1488","197210290den","Denver Broncos",20,"Cleveland Browns",27,47,-7,FALSE,"10/29/1972",1972,"October","1970s",40,66,8
"1489","197210290nyg","New York Giants",16,"Washington Redskins",23,39,-7,FALSE,"10/29/1972",1972,"October","1970s",61,91,11
"1490","197210290buf","Buffalo Bills",21,"Pittsburgh Steelers",38,59,-17,FALSE,"10/29/1972",1972,"October","1970s",47,100,10
"1491","197210290nor","New Orleans Saints",21,"Philadelphia Eagles",3,24,18,TRUE,"10/29/1972",1972,"October","1970s",60,92,4
"1492","197210290gnb","Green Bay Packers",13,"Minnesota Vikings",27,40,-14,FALSE,"10/29/1972",1972,"October","1970s",37,68,11
"1493","197210290atl","Atlanta Falcons",14,"San Francisco 49ers",49,63,-35,FALSE,"10/29/1972",1972,"October","1970s",58,84,11
"1494","197210290cin","Cincinnati Bengals",30,"Houston Oilers",7,37,23,TRUE,"10/29/1972",1972,"October","1970s",55,90,11
"1495","197210290crd","St. Louis Cardinals",10,"Chicago Bears",27,37,-17,FALSE,"10/29/1972",1972,"October","1970s",50,97,5
"1496","197210290rai","Oakland Raiders",45,"Los Angeles Rams",17,62,28,TRUE,"10/29/1972",1972,"October","1970s",55,60,13
"1497","197210290clt","Baltimore Colts",0,"Miami Dolphins",23,23,-23,FALSE,"10/29/1972",1972,"October","1970s",59,91,12
"1498","197210290sdg","San Diego Chargers",14,"Kansas City Chiefs",26,40,-12,FALSE,"10/29/1972",1972,"October","1970s",62,75,8
"1499","197210300dal","Dallas Cowboys",28,"Detroit Lions",24,52,4,TRUE,"10/30/1972",1972,"October","1970s",68,97,11
"1500","197211050nyj","New York Jets",17,"Washington Redskins",35,52,-18,FALSE,"11/5/1972",1972,"November","1970s",45,86,13
"1501","197211050det","Detroit Lions",14,"Chicago Bears",0,14,14,TRUE,"11/5/1972",1972,"November","1970s",42,83,8
"1502","197211050kan","Kansas City Chiefs",27,"Oakland Raiders",14,41,13,TRUE,"11/5/1972",1972,"November","1970s",53,60,12
"1503","197211050nyg","New York Giants",29,"Denver Broncos",17,46,12,TRUE,"11/5/1972",1972,"November","1970s",45,86,13
"1504","197211050buf","Buffalo Bills",16,"Miami Dolphins",30,46,-14,FALSE,"11/5/1972",1972,"November","1970s",41,86,12
"1505","197211050pit","Pittsburgh Steelers",40,"Cincinnati Bengals",17,57,23,TRUE,"11/5/1972",1972,"November","1970s",44,77,10
"1506","197211050min","Minnesota Vikings",37,"New Orleans Saints",6,43,31,TRUE,"11/5/1972",1972,"November","1970s",43,82,13
"1507","197211050gnb","Green Bay Packers",34,"San Francisco 49ers",24,58,10,TRUE,"11/5/1972",1972,"November","1970s",42,77,13
"1508","197211050phi","Philadelphia Eagles",6,"St. Louis Cardinals",6,12,0,FALSE,"11/5/1972",1972,"November","1970s",51,82,12
"1509","197211050cle","Cleveland Browns",20,"Houston Oilers",0,20,20,TRUE,"11/5/1972",1972,"November","1970s",42,85,7
"1510","197211050ram","Los Angeles Rams",20,"Atlanta Falcons",7,27,13,TRUE,"11/5/1972",1972,"November","1970s",61,83,8
"1511","197211050sdg","San Diego Chargers",28,"Dallas Cowboys",34,62,-6,FALSE,"11/5/1972",1972,"November","1970s",64,75,9
"1512","197211060nwe","New England Patriots",17,"Baltimore Colts",24,41,-7,FALSE,"11/6/1972",1972,"November","1970s",44,74,12
"1513","197211120min","Minnesota Vikings",16,"Detroit Lions",14,30,2,TRUE,"11/12/1972",1972,"November","1970s",34,70,8
"1514","197211120pit","Pittsburgh Steelers",16,"Kansas City Chiefs",7,23,9,TRUE,"11/12/1972",1972,"November","1970s",41,75,9
"1515","197211120oti","Houston Oilers",17,"Philadelphia Eagles",18,35,-1,FALSE,"11/12/1972",1972,"November","1970s",72,NA,NA
"1516","197211120nyj","New York Jets",41,"Buffalo Bills",3,44,38,TRUE,"11/12/1972",1972,"November","1970s",48,87,9
"1517","197211120atl","Atlanta Falcons",36,"New Orleans Saints",20,56,16,TRUE,"11/12/1972",1972,"November","1970s",55,66,8
"1518","197211120mia","Miami Dolphins",52,"New England Patriots",0,52,52,TRUE,"11/12/1972",1972,"November","1970s",78,81,9
"1519","197211120dal","Dallas Cowboys",33,"St. Louis Cardinals",24,57,9,TRUE,"11/12/1972",1972,"November","1970s",58,78,14
"1520","197211120sfo","San Francisco 49ers",24,"Baltimore Colts",21,45,3,TRUE,"11/12/1972",1972,"November","1970s",52,82,11
"1521","197211120chi","Chicago Bears",17,"Green Bay Packers",23,40,-6,FALSE,"11/12/1972",1972,"November","1970s",43,80,3
"1522","197211120ram","Los Angeles Rams",10,"Denver Broncos",16,26,-6,FALSE,"11/12/1972",1972,"November","1970s",56,58,14
"1523","197211120cin","Cincinnati Bengals",14,"Oakland Raiders",20,34,-6,FALSE,"11/12/1972",1972,"November","1970s",44,80,6
"1524","197211120was","Washington Redskins",27,"New York Giants",13,40,14,TRUE,"11/12/1972",1972,"November","1970s",48,73,9
"1525","197211130sdg","San Diego Chargers",17,"Cleveland Browns",21,38,-4,FALSE,"11/13/1972",1972,"November","1970s",58,64,6
"1526","197211190oti","Houston Oilers",10,"Green Bay Packers",23,33,-13,FALSE,"11/19/1972",1972,"November","1970s",72,NA,NA
"1527","197211190phi","Philadelphia Eagles",7,"Dallas Cowboys",28,35,-21,FALSE,"11/19/1972",1972,"November","1970s",38,75,9
"1528","197211190ram","Los Angeles Rams",41,"Minnesota Vikings",45,86,-4,FALSE,"11/19/1972",1972,"November","1970s",57,76,8
"1529","197211190crd","St. Louis Cardinals",7,"New York Giants",13,20,-6,FALSE,"11/19/1972",1972,"November","1970s",34,96,12
"1530","197211190chi","Chicago Bears",21,"San Francisco 49ers",34,55,-13,FALSE,"11/19/1972",1972,"November","1970s",35,71,11
"1531","197211190cin","Cincinnati Bengals",19,"Baltimore Colts",20,39,-1,FALSE,"11/19/1972",1972,"November","1970s",38,83,12
"1532","197211190nwe","New England Patriots",24,"Buffalo Bills",27,51,-3,FALSE,"11/19/1972",1972,"November","1970s",39,65,7
"1533","197211190den","Denver Broncos",20,"Oakland Raiders",37,57,-17,FALSE,"11/19/1972",1972,"November","1970s",30,66,9
"1534","197211190cle","Cleveland Browns",26,"Pittsburgh Steelers",24,50,2,TRUE,"11/19/1972",1972,"November","1970s",37,81,8
"1535","197211190det","Detroit Lions",27,"New Orleans Saints",14,41,13,TRUE,"11/19/1972",1972,"November","1970s",36,83,8
"1536","197211190mia","Miami Dolphins",28,"New York Jets",24,52,4,TRUE,"11/19/1972",1972,"November","1970s",75,71,11
"1537","197211190kan","Kansas City Chiefs",17,"San Diego Chargers",27,44,-10,FALSE,"11/19/1972",1972,"November","1970s",32,81,11
"1538","197211200was","Washington Redskins",24,"Atlanta Falcons",13,37,11,TRUE,"11/20/1972",1972,"November","1970s",40,90,11
"1539","197211230dal","Dallas Cowboys",10,"San Francisco 49ers",31,41,-21,FALSE,"11/23/1972",1972,"November","1970s",41,76,5
"1540","197211230det","Detroit Lions",37,"New York Jets",20,57,17,TRUE,"11/23/1972",1972,"November","1970s",30,73,12
"1541","197211260pit","Pittsburgh Steelers",23,"Minnesota Vikings",10,33,13,TRUE,"11/26/1972",1972,"November","1970s",38,85,18
"1542","197211260cle","Cleveland Browns",27,"Buffalo Bills",10,37,17,TRUE,"11/26/1972",1972,"November","1970s",35,88,14
"1543","197211260nor","New Orleans Saints",19,"Los Angeles Rams",16,35,3,TRUE,"11/26/1972",1972,"November","1970s",49,67,15
"1544","197211260atl","Atlanta Falcons",23,"Denver Broncos",20,43,3,TRUE,"11/26/1972",1972,"November","1970s",42,74,16
"1545","197211260sdg","San Diego Chargers",34,"Houston Oilers",20,54,14,TRUE,"11/26/1972",1972,"November","1970s",61,50,7
"1546","197211260nyg","New York Giants",62,"Philadelphia Eagles",10,72,52,TRUE,"11/26/1972",1972,"November","1970s",50,77,15
"1547","197211260clt","Baltimore Colts",31,"New England Patriots",0,31,31,TRUE,"11/26/1972",1972,"November","1970s",47,86,14
"1548","197211260rai","Oakland Raiders",26,"Kansas City Chiefs",3,29,23,TRUE,"11/26/1972",1972,"November","1970s",50,88,8
"1549","197211260was","Washington Redskins",21,"Green Bay Packers",16,37,5,TRUE,"11/26/1972",1972,"November","1970s",44,87,10
"1550","197211260chi","Chicago Bears",3,"Cincinnati Bengals",13,16,-10,FALSE,"11/26/1972",1972,"November","1970s",33,94,10
"1551","197211270mia","Miami Dolphins",31,"St. Louis Cardinals",10,41,21,TRUE,"11/27/1972",1972,"November","1970s",66,71,10
"1552","197212030min","Minnesota Vikings",23,"Chicago Bears",10,33,13,TRUE,"12/3/1972",1972,"December","1970s",2,50,12
"1553","197212030phi","Philadelphia Eagles",7,"Washington Redskins",23,30,-16,FALSE,"12/3/1972",1972,"December","1970s",46,78,12
"1554","197212030gnb","Green Bay Packers",33,"Detroit Lions",7,40,26,TRUE,"12/3/1972",1972,"December","1970s",12,79,12
"1555","197212030nyj","New York Jets",18,"New Orleans Saints",17,35,1,TRUE,"12/3/1972",1972,"December","1970s",48,62,15
"1556","197212030kan","Kansas City Chiefs",24,"Denver Broncos",21,45,3,TRUE,"12/3/1972",1972,"December","1970s",30,68,19
"1557","197212030cin","Cincinnati Bengals",13,"New York Giants",10,23,3,TRUE,"12/3/1972",1972,"December","1970s",49,59,15
"1558","197212030pit","Pittsburgh Steelers",30,"Cleveland Browns",0,30,30,TRUE,"12/3/1972",1972,"December","1970s",44,60,14
"1559","197212030atl","Atlanta Falcons",20,"Houston Oilers",10,30,10,TRUE,"12/3/1972",1972,"December","1970s",46,68,6
"1560","197212030clt","Baltimore Colts",35,"Buffalo Bills",7,42,28,TRUE,"12/3/1972",1972,"December","1970s",47,63,11
"1561","197212030crd","St. Louis Cardinals",6,"Dallas Cowboys",27,33,-21,FALSE,"12/3/1972",1972,"December","1970s",39,84,12
"1562","197212030sdg","San Diego Chargers",19,"Oakland Raiders",21,40,-2,FALSE,"12/3/1972",1972,"December","1970s",60,70,8
"1563","197212030nwe","New England Patriots",21,"Miami Dolphins",37,58,-16,FALSE,"12/3/1972",1972,"December","1970s",44,70,19
"1564","197212040sfo","San Francisco 49ers",16,"Los Angeles Rams",26,42,-10,FALSE,"12/4/1972",1972,"December","1970s",48,83,12
"1565","197212090cin","Cincinnati Bengals",24,"Cleveland Browns",27,51,-3,FALSE,"12/9/1972",1972,"December","1970s",38,94,7
"1566","197212090dal","Dallas Cowboys",34,"Washington Redskins",24,58,10,TRUE,"12/9/1972",1972,"December","1970s",38,95,9
"1567","197212100nyg","New York Giants",13,"Miami Dolphins",23,36,-10,FALSE,"12/10/1972",1972,"December","1970s",47,88,9
"1568","197212100buf","Buffalo Bills",21,"Detroit Lions",21,42,0,FALSE,"12/10/1972",1972,"December","1970s",32,98,11
"1569","197212100phi","Philadelphia Eagles",12,"Chicago Bears",21,33,-9,FALSE,"12/10/1972",1972,"December","1970s",47,98,7
"1570","197212100kan","Kansas City Chiefs",24,"Baltimore Colts",10,34,14,TRUE,"12/10/1972",1972,"December","1970s",8,56,11
"1571","197212100den","Denver Broncos",38,"San Diego Chargers",13,51,25,TRUE,"12/10/1972",1972,"December","1970s",-5,52,7
"1572","197212100oti","Houston Oilers",3,"Pittsburgh Steelers",9,12,-6,FALSE,"12/10/1972",1972,"December","1970s",72,NA,NA
"1573","197212100nor","New Orleans Saints",10,"New England Patriots",17,27,-7,FALSE,"12/10/1972",1972,"December","1970s",74,84,9
"1574","197212100crd","St. Louis Cardinals",24,"Los Angeles Rams",14,38,10,TRUE,"12/10/1972",1972,"December","1970s",16,86,14
"1575","197212100min","Minnesota Vikings",7,"Green Bay Packers",23,30,-16,FALSE,"12/10/1972",1972,"December","1970s",-2,51,11
"1576","197212100sfo","San Francisco 49ers",20,"Atlanta Falcons",0,20,20,TRUE,"12/10/1972",1972,"December","1970s",34,47,10
"1577","197212110rai","Oakland Raiders",24,"New York Jets",16,40,8,TRUE,"12/11/1972",1972,"December","1970s",34,52,9
"1578","197212160mia","Miami Dolphins",16,"Baltimore Colts",0,16,16,TRUE,"12/16/1972",1972,"December","1970s",69,84,14
"1579","197212160sfo","San Francisco 49ers",20,"Minnesota Vikings",17,37,3,TRUE,"12/16/1972",1972,"December","1970s",40,80,6
"1580","197212170rai","Oakland Raiders",28,"Chicago Bears",21,49,7,TRUE,"12/17/1972",1972,"December","1970s",44,98,11
"1581","197212170atl","Atlanta Falcons",14,"Kansas City Chiefs",17,31,-3,FALSE,"12/17/1972",1972,"December","1970s",27,35,14
"1582","197212170nor","New Orleans Saints",20,"Green Bay Packers",30,50,-10,FALSE,"12/17/1972",1972,"December","1970s",39,46,14
"1583","197212170ram","Los Angeles Rams",17,"Detroit Lions",34,51,-17,FALSE,"12/17/1972",1972,"December","1970s",62,23,8
"1584","197212170nyj","New York Jets",10,"Cleveland Browns",26,36,-16,FALSE,"12/17/1972",1972,"December","1970s",23,47,28
"1585","197212170den","Denver Broncos",45,"New England Patriots",21,66,24,TRUE,"12/17/1972",1972,"December","1970s",32,51,10
"1586","197212170oti","Houston Oilers",17,"Cincinnati Bengals",61,78,-44,FALSE,"12/17/1972",1972,"December","1970s",72,NA,NA
"1587","197212170dal","Dallas Cowboys",3,"New York Giants",23,26,-20,FALSE,"12/17/1972",1972,"December","1970s",36,52,11
"1588","197212170crd","St. Louis Cardinals",24,"Philadelphia Eagles",23,47,1,TRUE,"12/17/1972",1972,"December","1970s",17,72,10
"1589","197212170was","Washington Redskins",17,"Buffalo Bills",24,41,-7,FALSE,"12/17/1972",1972,"December","1970s",22,52,24
"1590","197212170sdg","San Diego Chargers",2,"Pittsburgh Steelers",24,26,-22,FALSE,"12/17/1972",1972,"December","1970s",60,37,6
"1591","197212230sfo","San Francisco 49ers",28,"Dallas Cowboys",30,58,-2,FALSE,"12/23/1972",1972,"December","1970s",51,91,7
"1592","197212230pit","Pittsburgh Steelers",13,"Oakland Raiders",7,20,6,TRUE,"12/23/1972",1972,"December","1970s",42,88,6
"1593","197212240mia","Miami Dolphins",20,"Cleveland Browns",14,34,6,TRUE,"12/24/1972",1972,"December","1970s",62,78,7
"1594","197212240was","Washington Redskins",16,"Green Bay Packers",3,19,13,TRUE,"12/24/1972",1972,"December","1970s",38,98,6
"1595","197212310pit","Pittsburgh Steelers",17,"Miami Dolphins",21,38,-4,FALSE,"12/31/1972",1972,"December","1970s",58,65,16
"1596","197212310was","Washington Redskins",26,"Dallas Cowboys",3,29,23,TRUE,"12/31/1972",1972,"December","1970s",49,99,8
"1597","197301140mia","Miami Dolphins",14,"Washington Redskins",7,21,7,TRUE,"1/14/1973",1973,"January","1970s",64,53,7
"1598","197309160nor","New Orleans Saints",7,"Atlanta Falcons",62,69,-55,FALSE,"9/16/1973",1973,"September","1970s",79,74,6
"1599","197309160nwe","New England Patriots",13,"Buffalo Bills",31,44,-18,FALSE,"9/16/1973",1973,"September","1970s",64,71,13
"1600","197309160phi","Philadelphia Eagles",23,"St. Louis Cardinals",34,57,-11,FALSE,"9/16/1973",1973,"September","1970s",70,72,9
"1601","197309160min","Minnesota Vikings",24,"Oakland Raiders",16,40,8,TRUE,"9/16/1973",1973,"September","1970s",50,74,8
"1602","197309160pit","Pittsburgh Steelers",24,"Detroit Lions",10,34,14,TRUE,"9/16/1973",1973,"September","1970s",64,64,11
"1603","197309160was","Washington Redskins",38,"San Diego Chargers",0,38,38,TRUE,"9/16/1973",1973,"September","1970s",73,59,6
"1604","197309160chi","Chicago Bears",17,"Dallas Cowboys",20,37,-3,FALSE,"9/16/1973",1973,"September","1970s",55,82,9
"1605","197309160kan","Kansas City Chiefs",13,"Los Angeles Rams",23,36,-10,FALSE,"9/16/1973",1973,"September","1970s",59,85,11
"1606","197309160nyg","New York Giants",34,"Houston Oilers",14,48,20,TRUE,"9/16/1973",1973,"September","1970s",68,72,10
"1607","197309160den","Denver Broncos",28,"Cincinnati Bengals",10,38,18,TRUE,"9/16/1973",1973,"September","1970s",44,83,13
"1608","197309160cle","Cleveland Browns",24,"Baltimore Colts",14,38,10,TRUE,"9/16/1973",1973,"September","1970s",64,65,9
"1609","197309160mia","Miami Dolphins",21,"San Francisco 49ers",13,34,8,TRUE,"9/16/1973",1973,"September","1970s",82,80,8
"1610","197309170gnb","Green Bay Packers",23,"New York Jets",7,30,16,TRUE,"9/17/1973",1973,"September","1970s",54,77,16
"1611","197309230pit","Pittsburgh Steelers",33,"Cleveland Browns",6,39,27,TRUE,"9/23/1973",1973,"September","1970s",68,69,14
"1612","197309230clt","Baltimore Colts",10,"New York Jets",34,44,-24,FALSE,"9/23/1973",1973,"September","1970s",71,76,10
"1613","197309230chi","Chicago Bears",13,"Minnesota Vikings",22,35,-9,FALSE,"9/23/1973",1973,"September","1970s",61,72,10
"1614","197309230rai","Oakland Raiders",12,"Miami Dolphins",7,19,5,TRUE,"9/23/1973",1973,"September","1970s",62,86,13
"1615","197309230nyg","New York Giants",23,"Philadelphia Eagles",23,46,0,FALSE,"9/23/1973",1973,"September","1970s",72,74,12
"1616","197309230sdg","San Diego Chargers",34,"Buffalo Bills",7,41,27,TRUE,"9/23/1973",1973,"September","1970s",67,70,10
"1617","197309230ram","Los Angeles Rams",31,"Atlanta Falcons",0,31,31,TRUE,"9/23/1973",1973,"September","1970s",65,80,9
"1618","197309230gnb","Green Bay Packers",13,"Detroit Lions",13,26,0,FALSE,"9/23/1973",1973,"September","1970s",50,83,9
"1619","197309230cin","Cincinnati Bengals",24,"Houston Oilers",10,34,14,TRUE,"9/23/1973",1973,"September","1970s",71,79,10
"1620","197309230crd","St. Louis Cardinals",34,"Washington Redskins",27,61,7,TRUE,"9/23/1973",1973,"September","1970s",72,86,6
"1621","197309230den","Denver Broncos",34,"San Francisco 49ers",36,70,-2,FALSE,"9/23/1973",1973,"September","1970s",66,42,16
"1622","197309230nwe","New England Patriots",7,"Kansas City Chiefs",10,17,-3,FALSE,"9/23/1973",1973,"September","1970s",68,83,15
"1623","197309240dal","Dallas Cowboys",40,"New Orleans Saints",3,43,37,TRUE,"9/24/1973",1973,"September","1970s",76,88,17
"1624","197309300sdg","San Diego Chargers",13,"Cincinnati Bengals",20,33,-7,FALSE,"9/30/1973",1973,"September","1970s",67,70,9
"1625","197309300min","Minnesota Vikings",11,"Green Bay Packers",3,14,8,TRUE,"9/30/1973",1973,"September","1970s",56,74,10
"1626","197309300dal","Dallas Cowboys",45,"St. Louis Cardinals",10,55,35,TRUE,"9/30/1973",1973,"September","1970s",71,74,5
"1627","197309300cle","Cleveland Browns",12,"New York Giants",10,22,2,TRUE,"9/30/1973",1973,"September","1970s",62,68,9
"1628","197309300clt","Baltimore Colts",14,"New Orleans Saints",10,24,4,TRUE,"9/30/1973",1973,"September","1970s",64,72,10
"1629","197309300mia","Miami Dolphins",44,"New England Patriots",23,67,21,TRUE,"9/30/1973",1973,"September","1970s",81,63,10
"1630","197309300kan","Kansas City Chiefs",16,"Oakland Raiders",3,19,13,TRUE,"9/30/1973",1973,"September","1970s",59,90,4
"1631","197309300phi","Philadelphia Eagles",7,"Washington Redskins",28,35,-21,FALSE,"9/30/1973",1973,"September","1970s",63,66,11
"1632","197309300sfo","San Francisco 49ers",20,"Los Angeles Rams",40,60,-20,FALSE,"9/30/1973",1973,"September","1970s",57,81,15
"1633","197309300oti","Houston Oilers",7,"Pittsburgh Steelers",36,43,-29,FALSE,"9/30/1973",1973,"September","1970s",72,NA,NA
"1634","197309300buf","Buffalo Bills",9,"New York Jets",7,16,2,TRUE,"9/30/1973",1973,"September","1970s",53,62,8
"1635","197309300den","Denver Broncos",14,"Chicago Bears",33,47,-19,FALSE,"9/30/1973",1973,"September","1970s",55,54,8
"1636","197310010det","Detroit Lions",31,"Atlanta Falcons",6,37,25,TRUE,"10/1/1973",1973,"October","1970s",59,83,11
"1637","197310070buf","Buffalo Bills",27,"Philadelphia Eagles",26,53,1,TRUE,"10/7/1973",1973,"October","1970s",56,66,8
"1638","197310070atl","Atlanta Falcons",9,"San Francisco 49ers",13,22,-4,FALSE,"10/7/1973",1973,"October","1970s",68,65,10
"1639","197310070oti","Houston Oilers",26,"Los Angeles Rams",31,57,-5,FALSE,"10/7/1973",1973,"October","1970s",72,NA,NA
"1640","197310070pit","Pittsburgh Steelers",38,"San Diego Chargers",21,59,17,TRUE,"10/7/1973",1973,"October","1970s",60,63,6
"1641","197310070nwe","New England Patriots",24,"Baltimore Colts",16,40,8,TRUE,"10/7/1973",1973,"October","1970s",57,36,10
"1642","197310070crd","St. Louis Cardinals",10,"Oakland Raiders",17,27,-7,FALSE,"10/7/1973",1973,"October","1970s",70,80,10
"1643","197310070nyg","New York Giants",14,"Green Bay Packers",16,30,-2,FALSE,"10/7/1973",1973,"October","1970s",58,55,5
"1644","197310070mia","Miami Dolphins",31,"New York Jets",3,34,28,TRUE,"10/7/1973",1973,"October","1970s",80,83,6
"1645","197310070kan","Kansas City Chiefs",16,"Denver Broncos",14,30,2,TRUE,"10/7/1973",1973,"October","1970s",67,88,11
"1646","197310070det","Detroit Lions",9,"Minnesota Vikings",23,32,-14,FALSE,"10/7/1973",1973,"October","1970s",61,73,8
"1647","197310070cle","Cleveland Browns",17,"Cincinnati Bengals",10,27,7,TRUE,"10/7/1973",1973,"October","1970s",60,68,4
"1648","197310070nor","New Orleans Saints",21,"Chicago Bears",16,37,5,TRUE,"10/7/1973",1973,"October","1970s",76,80,6
"1649","197310080was","Washington Redskins",14,"Dallas Cowboys",7,21,7,TRUE,"10/8/1973",1973,"October","1970s",67,64,5
"1650","197310140sdg","San Diego Chargers",17,"Oakland Raiders",27,44,-10,FALSE,"10/14/1973",1973,"October","1970s",66,71,8
"1651","197310140nyg","New York Giants",3,"Washington Redskins",21,24,-18,FALSE,"10/14/1973",1973,"October","1970s",66,46,17
"1652","197310140crd","St. Louis Cardinals",24,"Philadelphia Eagles",27,51,-3,FALSE,"10/14/1973",1973,"October","1970s",63,76,8
"1653","197310140ram","Los Angeles Rams",37,"Dallas Cowboys",31,68,6,TRUE,"10/14/1973",1973,"October","1970s",66,68,8
"1654","197310140atl","Atlanta Falcons",46,"Chicago Bears",6,52,40,TRUE,"10/14/1973",1973,"October","1970s",67,81,9
"1655","197310140oti","Houston Oilers",20,"Denver Broncos",48,68,-28,FALSE,"10/14/1973",1973,"October","1970s",72,NA,NA
"1656","197310140buf","Buffalo Bills",31,"Baltimore Colts",13,44,18,TRUE,"10/14/1973",1973,"October","1970s",58,58,23
"1657","197310140nor","New Orleans Saints",20,"Detroit Lions",13,33,7,TRUE,"10/14/1973",1973,"October","1970s",80,80,9
"1658","197310140gnb","Green Bay Packers",10,"Kansas City Chiefs",10,20,0,FALSE,"10/14/1973",1973,"October","1970s",58,58,14
"1659","197310140cin","Cincinnati Bengals",19,"Pittsburgh Steelers",7,26,12,TRUE,"10/14/1973",1973,"October","1970s",59,77,8
"1660","197310140sfo","San Francisco 49ers",13,"Minnesota Vikings",17,30,-4,FALSE,"10/14/1973",1973,"October","1970s",64,67,8
"1661","197310140nwe","New England Patriots",7,"New York Jets",9,16,-2,FALSE,"10/14/1973",1973,"October","1970s",64,50,23
"1662","197310150cle","Cleveland Browns",9,"Miami Dolphins",17,26,-8,FALSE,"10/15/1973",1973,"October","1970s",60,68,14
"1663","197310210sdg","San Diego Chargers",0,"Atlanta Falcons",41,41,-41,FALSE,"10/21/1973",1973,"October","1970s",64,73,10
"1664","197310210cin","Cincinnati Bengals",14,"Kansas City Chiefs",6,20,8,TRUE,"10/21/1973",1973,"October","1970s",52,69,8
"1665","197310210ram","Los Angeles Rams",24,"Green Bay Packers",7,31,17,TRUE,"10/21/1973",1973,"October","1970s",62,89,8
"1666","197310210mia","Miami Dolphins",27,"Buffalo Bills",6,33,21,TRUE,"10/21/1973",1973,"October","1970s",80,77,14
"1667","197310210det","Detroit Lions",27,"Baltimore Colts",29,56,-2,FALSE,"10/21/1973",1973,"October","1970s",47,73,7
"1668","197310210dal","Dallas Cowboys",45,"New York Giants",28,73,17,TRUE,"10/21/1973",1973,"October","1970s",63,70,6
"1669","197310210chi","Chicago Bears",10,"New England Patriots",13,23,-3,FALSE,"10/21/1973",1973,"October","1970s",51,76,7
"1670","197310210was","Washington Redskins",31,"St. Louis Cardinals",13,44,18,TRUE,"10/21/1973",1973,"October","1970s",58,57,8
"1671","197310210pit","Pittsburgh Steelers",26,"New York Jets",14,40,12,TRUE,"10/21/1973",1973,"October","1970s",50,69,9
"1672","197310210sfo","San Francisco 49ers",40,"New Orleans Saints",0,40,40,TRUE,"10/21/1973",1973,"October","1970s",64,76,10
"1673","197310210min","Minnesota Vikings",28,"Philadelphia Eagles",21,49,7,TRUE,"10/21/1973",1973,"October","1970s",54,64,13
"1674","197310210cle","Cleveland Browns",42,"Houston Oilers",13,55,29,TRUE,"10/21/1973",1973,"October","1970s",51,77,6
"1675","197310220den","Denver Broncos",23,"Oakland Raiders",23,46,0,FALSE,"10/22/1973",1973,"October","1970s",58,30,9
"1676","197310280sfo","San Francisco 49ers",3,"Atlanta Falcons",17,20,-14,FALSE,"10/28/1973",1973,"October","1970s",61,69,8
"1677","197310280phi","Philadelphia Eagles",30,"Dallas Cowboys",16,46,14,TRUE,"10/28/1973",1973,"October","1970s",53,68,15
"1678","197310280crd","St. Louis Cardinals",35,"New York Giants",27,62,8,TRUE,"10/28/1973",1973,"October","1970s",44,93,11
"1679","197310280det","Detroit Lions",34,"Green Bay Packers",0,34,34,TRUE,"10/28/1973",1973,"October","1970s",52,94,15
"1680","197310280nyj","New York Jets",28,"Denver Broncos",40,68,-12,FALSE,"10/28/1973",1973,"October","1970s",49,66,16
"1681","197310280cle","Cleveland Browns",16,"San Diego Chargers",16,32,0,FALSE,"10/28/1973",1973,"October","1970s",54,86,11
"1682","197310280nwe","New England Patriots",14,"Miami Dolphins",30,44,-16,FALSE,"10/28/1973",1973,"October","1970s",44,58,14
"1683","197310280pit","Pittsburgh Steelers",20,"Cincinnati Bengals",13,33,7,TRUE,"10/28/1973",1973,"October","1970s",52,76,12
"1684","197310280clt","Baltimore Colts",21,"Oakland Raiders",34,55,-13,FALSE,"10/28/1973",1973,"October","1970s",53,78,12
"1685","197310280min","Minnesota Vikings",10,"Los Angeles Rams",9,19,1,TRUE,"10/28/1973",1973,"October","1970s",41,76,18
"1686","197310280nor","New Orleans Saints",19,"Washington Redskins",3,22,16,TRUE,"10/28/1973",1973,"October","1970s",68,74,9
"1687","197310280chi","Chicago Bears",35,"Houston Oilers",14,49,21,TRUE,"10/28/1973",1973,"October","1970s",45,87,12
"1688","197310290buf","Buffalo Bills",23,"Kansas City Chiefs",14,37,9,TRUE,"10/29/1973",1973,"October","1970s",45,92,17
"1689","197311040gnb","Green Bay Packers",17,"Chicago Bears",31,48,-14,FALSE,"11/4/1973",1973,"November","1970s",31,68,9
"1690","197311040dal","Dallas Cowboys",38,"Cincinnati Bengals",10,48,28,TRUE,"11/4/1973",1973,"November","1970s",63,92,6
"1691","197311040phi","Philadelphia Eagles",24,"New England Patriots",23,47,1,TRUE,"11/4/1973",1973,"November","1970s",47,52,13
"1692","197311040clt","Baltimore Colts",27,"Houston Oilers",31,58,-4,FALSE,"11/4/1973",1973,"November","1970s",46,52,10
"1693","197311040det","Detroit Lions",30,"San Francisco 49ers",20,50,10,TRUE,"11/4/1973",1973,"November","1970s",38,68,12
"1694","197311040rai","Oakland Raiders",42,"New York Giants",0,42,42,TRUE,"11/4/1973",1973,"November","1970s",49,73,11
"1695","197311040min","Minnesota Vikings",26,"Cleveland Browns",3,29,23,TRUE,"11/4/1973",1973,"November","1970s",27,60,11
"1696","197311040nyj","New York Jets",14,"Miami Dolphins",24,38,-10,FALSE,"11/4/1973",1973,"November","1970s",47,43,17
"1697","197311040nor","New Orleans Saints",13,"Buffalo Bills",0,13,13,TRUE,"11/4/1973",1973,"November","1970s",73,83,8
"1698","197311040sdg","San Diego Chargers",0,"Kansas City Chiefs",19,19,-19,FALSE,"11/4/1973",1973,"November","1970s",61,62,6
"1699","197311040crd","St. Louis Cardinals",17,"Denver Broncos",17,34,0,FALSE,"11/4/1973",1973,"November","1970s",44,78,12
"1700","197311040atl","Atlanta Falcons",15,"Los Angeles Rams",13,28,2,TRUE,"11/4/1973",1973,"November","1970s",65,74,7
"1701","197311050pit","Pittsburgh Steelers",21,"Washington Redskins",16,37,5,TRUE,"11/5/1973",1973,"November","1970s",40,62,13
"1702","197311110min","Minnesota Vikings",28,"Detroit Lions",7,35,21,TRUE,"11/11/1973",1973,"November","1970s",39,53,10
"1703","197311110nyj","New York Jets",33,"New England Patriots",13,46,20,TRUE,"11/11/1973",1973,"November","1970s",36,52,12
"1704","197311110rai","Oakland Raiders",9,"Pittsburgh Steelers",17,26,-8,FALSE,"11/11/1973",1973,"November","1970s",62,83,16
"1705","197311110ram","Los Angeles Rams",29,"New Orleans Saints",7,36,22,TRUE,"11/11/1973",1973,"November","1970s",63,81,7
"1706","197311110was","Washington Redskins",33,"San Francisco 49ers",9,42,24,TRUE,"11/11/1973",1973,"November","1970s",38,50,8
"1707","197311110nyg","New York Giants",10,"Dallas Cowboys",23,33,-13,FALSE,"11/11/1973",1973,"November","1970s",36,52,12
"1708","197311110buf","Buffalo Bills",13,"Cincinnati Bengals",16,29,-3,FALSE,"11/11/1973",1973,"November","1970s",34,69,12
"1709","197311110mia","Miami Dolphins",44,"Baltimore Colts",0,44,44,TRUE,"11/11/1973",1973,"November","1970s",74,58,17
"1710","197311110den","Denver Broncos",30,"San Diego Chargers",19,49,11,TRUE,"11/11/1973",1973,"November","1970s",52,40,7
"1711","197311110gnb","Green Bay Packers",25,"St. Louis Cardinals",21,46,4,TRUE,"11/11/1973",1973,"November","1970s",34,63,12
"1712","197311110phi","Philadelphia Eagles",27,"Atlanta Falcons",44,71,-17,FALSE,"11/11/1973",1973,"November","1970s",33,56,10
"1713","197311110oti","Houston Oilers",13,"Cleveland Browns",23,36,-10,FALSE,"11/11/1973",1973,"November","1970s",72,NA,NA
"1714","197311120kan","Kansas City Chiefs",19,"Chicago Bears",7,26,12,TRUE,"11/12/1973",1973,"November","1970s",51,64,17
"1715","197311180rai","Oakland Raiders",3,"Cleveland Browns",7,10,-4,FALSE,"11/18/1973",1973,"November","1970s",53,76,18
"1716","197311180nwe","New England Patriots",33,"Green Bay Packers",24,57,9,TRUE,"11/18/1973",1973,"November","1970s",43,44,18
"1717","197311180buf","Buffalo Bills",0,"Miami Dolphins",17,17,-17,FALSE,"11/18/1973",1973,"November","1970s",37,70,10
"1718","197311180sdg","San Diego Chargers",17,"New Orleans Saints",14,31,3,TRUE,"11/18/1973",1973,"November","1970s",61,83,12
"1719","197311180cin","Cincinnati Bengals",20,"New York Jets",14,34,6,TRUE,"11/18/1973",1973,"November","1970s",43,76,12
"1720","197311180nyg","New York Giants",24,"St. Louis Cardinals",13,37,11,TRUE,"11/18/1973",1973,"November","1970s",41,48,15
"1721","197311180dal","Dallas Cowboys",31,"Philadelphia Eagles",10,41,21,TRUE,"11/18/1973",1973,"November","1970s",70,82,14
"1722","197311180was","Washington Redskins",22,"Baltimore Colts",14,36,8,TRUE,"11/18/1973",1973,"November","1970s",41,55,7
"1723","197311180pit","Pittsburgh Steelers",13,"Denver Broncos",23,36,-10,FALSE,"11/18/1973",1973,"November","1970s",34,68,8
"1724","197311180ram","Los Angeles Rams",31,"San Francisco 49ers",13,44,18,TRUE,"11/18/1973",1973,"November","1970s",60,84,16
"1725","197311180kan","Kansas City Chiefs",38,"Houston Oilers",14,52,24,TRUE,"11/18/1973",1973,"November","1970s",49,71,13
"1726","197311180chi","Chicago Bears",7,"Detroit Lions",30,37,-23,FALSE,"11/18/1973",1973,"November","1970s",50,71,14
"1727","197311190atl","Atlanta Falcons",20,"Minnesota Vikings",14,34,6,TRUE,"11/19/1973",1973,"November","1970s",57,61,5
"1728","197311220det","Detroit Lions",0,"Washington Redskins",20,20,-20,FALSE,"11/22/1973",1973,"November","1970s",45,81,16
"1729","197311220dal","Dallas Cowboys",7,"Miami Dolphins",14,21,-7,FALSE,"11/22/1973",1973,"November","1970s",60,81,10
"1730","197311250clt","Baltimore Colts",17,"Buffalo Bills",24,41,-7,FALSE,"11/25/1973",1973,"November","1970s",61,78,14
"1731","197311250cin","Cincinnati Bengals",42,"St. Louis Cardinals",24,66,18,TRUE,"11/25/1973",1973,"November","1970s",55,92,14
"1732","197311250nor","New Orleans Saints",13,"Los Angeles Rams",24,37,-11,FALSE,"11/25/1973",1973,"November","1970s",77,80,12
"1733","197311250oti","Houston Oilers",0,"New England Patriots",32,32,-32,FALSE,"11/25/1973",1973,"November","1970s",72,NA,NA
"1734","197311250min","Minnesota Vikings",31,"Chicago Bears",13,44,18,TRUE,"11/25/1973",1973,"November","1970s",36,85,8
"1735","197311250phi","Philadelphia Eagles",20,"New York Giants",16,36,4,TRUE,"11/25/1973",1973,"November","1970s",58,89,12
"1736","197311250cle","Cleveland Browns",21,"Pittsburgh Steelers",16,37,5,TRUE,"11/25/1973",1973,"November","1970s",50,91,15
"1737","197311250nyj","New York Jets",20,"Atlanta Falcons",28,48,-8,FALSE,"11/25/1973",1973,"November","1970s",57,82,11
"1738","197311250den","Denver Broncos",14,"Kansas City Chiefs",10,24,4,TRUE,"11/25/1973",1973,"November","1970s",31,60,8
"1739","197311250rai","Oakland Raiders",31,"San Diego Chargers",3,34,28,TRUE,"11/25/1973",1973,"November","1970s",49,77,12
"1740","197311260sfo","San Francisco 49ers",20,"Green Bay Packers",6,26,14,TRUE,"11/26/1973",1973,"November","1970s",50,74,13
"1741","197312020was","Washington Redskins",27,"New York Giants",24,51,3,TRUE,"12/2/1973",1973,"December","1970s",41,52,8
"1742","197312020gnb","Green Bay Packers",30,"New Orleans Saints",10,40,20,TRUE,"12/2/1973",1973,"December","1970s",36,83,12
"1743","197312020crd","St. Louis Cardinals",16,"Detroit Lions",20,36,-4,FALSE,"12/2/1973",1973,"December","1970s",50,85,12
"1744","197312020nwe","New England Patriots",30,"San Diego Chargers",14,44,16,TRUE,"12/2/1973",1973,"December","1970s",32,47,12
"1745","197312020chi","Chicago Bears",0,"Los Angeles Rams",26,26,-26,FALSE,"12/2/1973",1973,"December","1970s",45,71,16
"1746","197312020den","Denver Broncos",10,"Dallas Cowboys",22,32,-12,FALSE,"12/2/1973",1973,"December","1970s",51,36,17
"1747","197312020cin","Cincinnati Bengals",27,"Minnesota Vikings",0,27,27,TRUE,"12/2/1973",1973,"December","1970s",42,68,10
"1748","197312020atl","Atlanta Falcons",6,"Buffalo Bills",17,23,-11,FALSE,"12/2/1973",1973,"December","1970s",52,62,10
"1749","197312020sfo","San Francisco 49ers",38,"Philadelphia Eagles",28,66,10,TRUE,"12/2/1973",1973,"December","1970s",47,78,6
"1750","197312020oti","Houston Oilers",6,"Oakland Raiders",17,23,-11,FALSE,"12/2/1973",1973,"December","1970s",72,NA,NA
"1751","197312020nyj","New York Jets",20,"Baltimore Colts",17,37,3,TRUE,"12/2/1973",1973,"December","1970s",34,49,13
"1752","197312020kan","Kansas City Chiefs",20,"Cleveland Browns",20,40,0,FALSE,"12/2/1973",1973,"December","1970s",56,68,22
"1753","197312030mia","Miami Dolphins",30,"Pittsburgh Steelers",26,56,4,TRUE,"12/3/1973",1973,"December","1970s",75,56,14
"1754","197312080gnb","Green Bay Packers",7,"Minnesota Vikings",31,38,-24,FALSE,"12/8/1973",1973,"December","1970s",26,84,16
"1755","197312080rai","Oakland Raiders",37,"Kansas City Chiefs",7,44,30,TRUE,"12/8/1973",1973,"December","1970s",50,92,8
"1756","197312090sdg","San Diego Chargers",28,"Denver Broncos",42,70,-14,FALSE,"12/9/1973",1973,"December","1970s",63,34,5
"1757","197312090dal","Dallas Cowboys",27,"Washington Redskins",7,34,20,TRUE,"12/9/1973",1973,"December","1970s",48,58,11
"1758","197312090atl","Atlanta Falcons",10,"St. Louis Cardinals",32,42,-22,FALSE,"12/9/1973",1973,"December","1970s",42,65,12
"1759","197312090buf","Buffalo Bills",37,"New England Patriots",13,50,24,TRUE,"12/9/1973",1973,"December","1970s",30,88,8
"1760","197312090phi","Philadelphia Eagles",24,"New York Jets",23,47,1,TRUE,"12/9/1973",1973,"December","1970s",44,89,21
"1761","197312090pit","Pittsburgh Steelers",33,"Houston Oilers",7,40,26,TRUE,"12/9/1973",1973,"December","1970s",34,76,10
"1762","197312090nor","New Orleans Saints",16,"San Francisco 49ers",10,26,6,TRUE,"12/9/1973",1973,"December","1970s",41,67,9
"1763","197312090cin","Cincinnati Bengals",34,"Cleveland Browns",17,51,17,TRUE,"12/9/1973",1973,"December","1970s",31,84,9
"1764","197312090clt","Baltimore Colts",16,"Miami Dolphins",3,19,13,TRUE,"12/9/1973",1973,"December","1970s",42,86,16
"1765","197312090det","Detroit Lions",40,"Chicago Bears",7,47,33,TRUE,"12/9/1973",1973,"December","1970s",32,86,8
"1766","197312100ram","Los Angeles Rams",40,"New York Giants",6,46,34,TRUE,"12/10/1973",1973,"December","1970s",66,28,7
"1767","197312150mia","Miami Dolphins",34,"Detroit Lions",7,41,27,TRUE,"12/15/1973",1973,"December","1970s",69,65,7
"1768","197312150sfo","San Francisco 49ers",14,"Pittsburgh Steelers",37,51,-23,FALSE,"12/15/1973",1973,"December","1970s",47,89,5
"1769","197312160ram","Los Angeles Rams",30,"Cleveland Browns",17,47,13,TRUE,"12/16/1973",1973,"December","1970s",60,55,6
"1770","197312160rai","Oakland Raiders",21,"Denver Broncos",17,38,4,TRUE,"12/16/1973",1973,"December","1970s",47,93,7
"1771","197312160crd","St. Louis Cardinals",3,"Dallas Cowboys",30,33,-27,FALSE,"12/16/1973",1973,"December","1970s",23,97,15
"1772","197312160clt","Baltimore Colts",18,"New England Patriots",13,31,5,TRUE,"12/16/1973",1973,"December","1970s",31,75,10
"1773","197312160kan","Kansas City Chiefs",33,"San Diego Chargers",6,39,27,TRUE,"12/16/1973",1973,"December","1970s",20,73,11
"1774","197312160nyg","New York Giants",7,"Minnesota Vikings",31,38,-24,FALSE,"12/16/1973",1973,"December","1970s",30,66,13
"1775","197312160was","Washington Redskins",38,"Philadelphia Eagles",20,58,18,TRUE,"12/16/1973",1973,"December","1970s",36,69,11
"1776","197312160atl","Atlanta Falcons",14,"New Orleans Saints",10,24,4,TRUE,"12/16/1973",1973,"December","1970s",39,81,17
"1777","197312160nyj","New York Jets",14,"Buffalo Bills",34,48,-20,FALSE,"12/16/1973",1973,"December","1970s",31,66,15
"1778","197312160chi","Chicago Bears",0,"Green Bay Packers",21,21,-21,FALSE,"12/16/1973",1973,"December","1970s",24,79,13
"1779","197312160oti","Houston Oilers",24,"Cincinnati Bengals",27,51,-3,FALSE,"12/16/1973",1973,"December","1970s",72,NA,NA
"1780","197312220min","Minnesota Vikings",27,"Washington Redskins",20,47,7,TRUE,"12/22/1973",1973,"December","1970s",19,71,11
"1781","197312220rai","Oakland Raiders",33,"Pittsburgh Steelers",14,47,19,TRUE,"12/22/1973",1973,"December","1970s",50,92,10
"1782","197312230mia","Miami Dolphins",34,"Cincinnati Bengals",16,50,18,TRUE,"12/23/1973",1973,"December","1970s",55,60,8
"1783","197312230dal","Dallas Cowboys",27,"Los Angeles Rams",16,43,11,TRUE,"12/23/1973",1973,"December","1970s",56,81,15
"1784","197312300dal","Dallas Cowboys",10,"Minnesota Vikings",27,37,-17,FALSE,"12/30/1973",1973,"December","1970s",48,60,13
"1785","197312300mia","Miami Dolphins",27,"Oakland Raiders",10,37,17,TRUE,"12/30/1973",1973,"December","1970s",74,74,8
"1786","197401130mia","Miami Dolphins",24,"Minnesota Vikings",7,31,17,TRUE,"1/13/1974",1974,"January","1970s",47,81,7
"1787","197409150atl","Atlanta Falcons",0,"Dallas Cowboys",24,24,-24,FALSE,"9/15/1974",1974,"September","1970s",71,78,8
"1788","197409150crd","St. Louis Cardinals",7,"Philadelphia Eagles",3,10,4,TRUE,"9/15/1974",1974,"September","1970s",59,77,7
"1789","197409150nor","New Orleans Saints",13,"San Francisco 49ers",17,30,-4,FALSE,"9/15/1974",1974,"September","1970s",81,83,6
"1790","197409150cin","Cincinnati Bengals",33,"Cleveland Browns",7,40,26,TRUE,"9/15/1974",1974,"September","1970s",57,68,8
"1791","197409150oti","Houston Oilers",21,"San Diego Chargers",14,35,7,TRUE,"9/15/1974",1974,"September","1970s",72,NA,NA
"1792","197409150gnb","Green Bay Packers",17,"Minnesota Vikings",32,49,-15,FALSE,"9/15/1974",1974,"September","1970s",60,56,16
"1793","197409150den","Denver Broncos",10,"Los Angeles Rams",17,27,-7,FALSE,"9/15/1974",1974,"September","1970s",57,54,7
"1794","197409150nyg","New York Giants",10,"Washington Redskins",13,23,-3,FALSE,"9/15/1974",1974,"September","1970s",63,61,10
"1795","197409150pit","Pittsburgh Steelers",30,"Baltimore Colts",0,30,30,TRUE,"9/15/1974",1974,"September","1970s",59,69,9
"1796","197409150kan","Kansas City Chiefs",24,"New York Jets",16,40,8,TRUE,"9/15/1974",1974,"September","1970s",60,72,8
"1797","197409150nwe","New England Patriots",34,"Miami Dolphins",24,58,10,TRUE,"9/15/1974",1974,"September","1970s",61,66,10
"1798","197409150chi","Chicago Bears",17,"Detroit Lions",9,26,8,TRUE,"9/15/1974",1974,"September","1970s",62,58,14
"1799","197409160buf","Buffalo Bills",21,"Oakland Raiders",20,41,1,TRUE,"9/16/1974",1974,"September","1970s",59,57,13
"1800","197409220nyg","New York Giants",20,"New England Patriots",28,48,-8,FALSE,"9/22/1974",1974,"September","1970s",64,62,13
"1801","197409220ram","Los Angeles Rams",24,"New Orleans Saints",0,24,24,TRUE,"9/22/1974",1974,"September","1970s",70,76,9
"1802","197409220chi","Chicago Bears",21,"New York Jets",23,44,-2,FALSE,"9/22/1974",1974,"September","1970s",44,60,13
"1803","197409220rai","Oakland Raiders",27,"Kansas City Chiefs",7,34,20,TRUE,"9/22/1974",1974,"September","1970s",60,81,9
"1804","197409220cin","Cincinnati Bengals",17,"San Diego Chargers",20,37,-3,FALSE,"9/22/1974",1974,"September","1970s",53,74,9
"1805","197409220was","Washington Redskins",10,"St. Louis Cardinals",17,27,-7,FALSE,"9/22/1974",1974,"September","1970s",63,61,10
"1806","197409220clt","Baltimore Colts",13,"Green Bay Packers",20,33,-7,FALSE,"9/22/1974",1974,"September","1970s",61,71,9
"1807","197409220den","Denver Broncos",35,"Pittsburgh Steelers",35,70,0,FALSE,"9/22/1974",1974,"September","1970s",57,48,7
"1808","197409220atl","Atlanta Falcons",10,"San Francisco 49ers",16,26,-6,FALSE,"9/22/1974",1974,"September","1970s",68,75,10
"1809","197409220cle","Cleveland Browns",20,"Houston Oilers",7,27,13,TRUE,"9/22/1974",1974,"September","1970s",49,81,12
"1810","197409220buf","Buffalo Bills",16,"Miami Dolphins",24,40,-8,FALSE,"9/22/1974",1974,"September","1970s",49,66,12
"1811","197409220det","Detroit Lions",6,"Minnesota Vikings",7,13,-1,FALSE,"9/22/1974",1974,"September","1970s",48,49,15
"1812","197409230phi","Philadelphia Eagles",13,"Dallas Cowboys",10,23,3,TRUE,"9/23/1974",1974,"September","1970s",56,52,14
"1813","197409290sdg","San Diego Chargers",21,"Miami Dolphins",28,49,-7,FALSE,"9/29/1974",1974,"September","1970s",68,75,10
"1814","197409290sfo","San Francisco 49ers",3,"Cincinnati Bengals",21,24,-18,FALSE,"9/29/1974",1974,"September","1970s",60,74,8
"1815","197409290phi","Philadelphia Eagles",30,"Baltimore Colts",10,40,20,TRUE,"9/29/1974",1974,"September","1970s",75,82,15
"1816","197409290dal","Dallas Cowboys",6,"New York Giants",14,20,-8,FALSE,"9/29/1974",1974,"September","1970s",64,51,7
"1817","197409290crd","St. Louis Cardinals",29,"Cleveland Browns",7,36,22,TRUE,"9/29/1974",1974,"September","1970s",56,75,17
"1818","197409290gnb","Green Bay Packers",21,"Detroit Lions",19,40,2,TRUE,"9/29/1974",1974,"September","1970s",52,73,20
"1819","197409290oti","Houston Oilers",7,"Kansas City Chiefs",17,24,-10,FALSE,"9/29/1974",1974,"September","1970s",72,NA,NA
"1820","197409290nor","New Orleans Saints",14,"Atlanta Falcons",13,27,1,TRUE,"9/29/1974",1974,"September","1970s",79,74,8
"1821","197409290pit","Pittsburgh Steelers",0,"Oakland Raiders",17,17,-17,FALSE,"9/29/1974",1974,"September","1970s",63,79,15
"1822","197409290min","Minnesota Vikings",11,"Chicago Bears",7,18,4,TRUE,"9/29/1974",1974,"September","1970s",47,68,11
"1823","197409290buf","Buffalo Bills",16,"New York Jets",12,28,4,TRUE,"9/29/1974",1974,"September","1970s",64,81,19
"1824","197409290nwe","New England Patriots",20,"Los Angeles Rams",14,34,6,TRUE,"9/29/1974",1974,"September","1970s",69,89,14
"1825","197409300was","Washington Redskins",30,"Denver Broncos",3,33,27,TRUE,"9/30/1974",1974,"September","1970s",64,46,16
"1826","197410060kan","Kansas City Chiefs",14,"Denver Broncos",17,31,-3,FALSE,"10/6/1974",1974,"October","1970s",59,77,15
"1827","197410060chi","Chicago Bears",24,"New Orleans Saints",10,34,14,TRUE,"10/6/1974",1974,"October","1970s",62,72,17
"1828","197410060cle","Cleveland Browns",24,"Oakland Raiders",40,64,-16,FALSE,"10/6/1974",1974,"October","1970s",63,50,15
"1829","197410060sdg","San Diego Chargers",7,"Philadelphia Eagles",13,20,-6,FALSE,"10/6/1974",1974,"October","1970s",67,67,8
"1830","197410060sfo","San Francisco 49ers",9,"St. Louis Cardinals",34,43,-25,FALSE,"10/6/1974",1974,"October","1970s",59,69,11
"1831","197410060gnb","Green Bay Packers",7,"Buffalo Bills",27,34,-20,FALSE,"10/6/1974",1974,"October","1970s",48,79,15
"1832","197410060ram","Los Angeles Rams",16,"Detroit Lions",13,29,3,TRUE,"10/6/1974",1974,"October","1970s",65,77,10
"1833","197410060dal","Dallas Cowboys",21,"Minnesota Vikings",23,44,-2,FALSE,"10/6/1974",1974,"October","1970s",75,67,12
"1834","197410060cin","Cincinnati Bengals",28,"Washington Redskins",17,45,11,TRUE,"10/6/1974",1974,"October","1970s",58,53,10
"1835","197410060oti","Houston Oilers",7,"Pittsburgh Steelers",13,20,-6,FALSE,"10/6/1974",1974,"October","1970s",72,NA,NA
"1836","197410060nyg","New York Giants",7,"Atlanta Falcons",14,21,-7,FALSE,"10/6/1974",1974,"October","1970s",63,66,7
"1837","197410060nwe","New England Patriots",42,"Baltimore Colts",3,45,39,TRUE,"10/6/1974",1974,"October","1970s",64,50,14
"1838","197410070mia","Miami Dolphins",21,"New York Jets",17,38,4,TRUE,"10/7/1974",1974,"October","1970s",76,87,9
"1839","197410130atl","Atlanta Falcons",13,"Chicago Bears",10,23,3,TRUE,"10/13/1974",1974,"October","1970s",68,58,5
"1840","197410130kan","Kansas City Chiefs",24,"Pittsburgh Steelers",34,58,-10,FALSE,"10/13/1974",1974,"October","1970s",55,94,10
"1841","197410130sdg","San Diego Chargers",10,"Oakland Raiders",14,24,-4,FALSE,"10/13/1974",1974,"October","1970s",67,74,9
"1842","197410130phi","Philadelphia Eagles",35,"New York Giants",7,42,28,TRUE,"10/13/1974",1974,"October","1970s",62,80,10
"1843","197410130nyj","New York Jets",0,"New England Patriots",24,24,-24,FALSE,"10/13/1974",1974,"October","1970s",61,67,9
"1844","197410130was","Washington Redskins",20,"Miami Dolphins",17,37,3,TRUE,"10/13/1974",1974,"October","1970s",66,71,8
"1845","197410130gnb","Green Bay Packers",17,"Los Angeles Rams",6,23,11,TRUE,"10/13/1974",1974,"October","1970s",49,78,16
"1846","197410130clt","Baltimore Colts",14,"Buffalo Bills",27,41,-13,FALSE,"10/13/1974",1974,"October","1970s",65,76,8
"1847","197410130cle","Cleveland Browns",24,"Cincinnati Bengals",34,58,-10,FALSE,"10/13/1974",1974,"October","1970s",55,90,10
"1848","197410130den","Denver Broncos",33,"New Orleans Saints",17,50,16,TRUE,"10/13/1974",1974,"October","1970s",46,66,11
"1849","197410130min","Minnesota Vikings",51,"Houston Oilers",10,61,41,TRUE,"10/13/1974",1974,"October","1970s",46,72,9
"1850","197410130crd","St. Louis Cardinals",31,"Dallas Cowboys",28,59,3,TRUE,"10/13/1974",1974,"October","1970s",64,93,8
"1851","197410140det","Detroit Lions",17,"San Francisco 49ers",13,30,4,TRUE,"10/14/1974",1974,"October","1970s",59,87,17
"1852","197410200ram","Los Angeles Rams",37,"San Francisco 49ers",14,51,23,TRUE,"10/20/1974",1974,"October","1970s",63,88,8
"1853","197410200oti","Houston Oilers",27,"St. Louis Cardinals",31,58,-4,FALSE,"10/20/1974",1974,"October","1970s",72,NA,NA
"1854","197410200dal","Dallas Cowboys",31,"Philadelphia Eagles",24,55,7,TRUE,"10/20/1974",1974,"October","1970s",62,62,6
"1855","197410200rai","Oakland Raiders",30,"Cincinnati Bengals",27,57,3,TRUE,"10/20/1974",1974,"October","1970s",62,76,8
"1856","197410200was","Washington Redskins",24,"New York Giants",3,27,21,TRUE,"10/20/1974",1974,"October","1970s",42,50,12
"1857","197410200den","Denver Broncos",27,"San Diego Chargers",7,34,20,TRUE,"10/20/1974",1974,"October","1970s",56,50,8
"1858","197410200min","Minnesota Vikings",16,"Detroit Lions",20,36,-4,FALSE,"10/20/1974",1974,"October","1970s",38,59,10
"1859","197410200mia","Miami Dolphins",9,"Kansas City Chiefs",3,12,6,TRUE,"10/20/1974",1974,"October","1970s",75,66,15
"1860","197410200atl","Atlanta Falcons",3,"New Orleans Saints",13,16,-10,FALSE,"10/20/1974",1974,"October","1970s",52,46,9
"1861","197410200pit","Pittsburgh Steelers",20,"Cleveland Browns",16,36,4,TRUE,"10/20/1974",1974,"October","1970s",36,64,13
"1862","197410200nyj","New York Jets",20,"Baltimore Colts",35,55,-15,FALSE,"10/20/1974",1974,"October","1970s",39,45,15
"1863","197410200buf","Buffalo Bills",30,"New England Patriots",28,58,2,TRUE,"10/20/1974",1974,"October","1970s",31,64,12
"1864","197410210chi","Chicago Bears",10,"Green Bay Packers",9,19,1,TRUE,"10/21/1974",1974,"October","1970s",39,60,13
"1865","197410270nyj","New York Jets",13,"Los Angeles Rams",20,33,-7,FALSE,"10/27/1974",1974,"October","1970s",55,46,12
"1866","197410270sdg","San Diego Chargers",14,"Kansas City Chiefs",24,38,-10,FALSE,"10/27/1974",1974,"October","1970s",65,68,9
"1867","197410270cle","Cleveland Browns",23,"Denver Broncos",21,44,2,TRUE,"10/27/1974",1974,"October","1970s",48,56,8
"1868","197410270nyg","New York Giants",7,"Dallas Cowboys",21,28,-14,FALSE,"10/27/1974",1974,"October","1970s",57,43,10
"1869","197410270min","Minnesota Vikings",14,"New England Patriots",17,31,-3,FALSE,"10/27/1974",1974,"October","1970s",54,57,10
"1870","197410270buf","Buffalo Bills",16,"Chicago Bears",6,22,10,TRUE,"10/27/1974",1974,"October","1970s",49,54,13
"1871","197410270sfo","San Francisco 49ers",24,"Oakland Raiders",35,59,-11,FALSE,"10/27/1974",1974,"October","1970s",59,79,8
"1872","197410270cin","Cincinnati Bengals",21,"Houston Oilers",34,55,-13,FALSE,"10/27/1974",1974,"October","1970s",49,55,3
"1873","197410270nor","New Orleans Saints",14,"Philadelphia Eagles",10,24,4,TRUE,"10/27/1974",1974,"October","1970s",64,77,4
"1874","197410270det","Detroit Lions",19,"Green Bay Packers",17,36,2,TRUE,"10/27/1974",1974,"October","1970s",48,44,10
"1875","197410270mia","Miami Dolphins",17,"Baltimore Colts",7,24,10,TRUE,"10/27/1974",1974,"October","1970s",76,63,12
"1876","197410270crd","St. Louis Cardinals",23,"Washington Redskins",20,43,3,TRUE,"10/27/1974",1974,"October","1970s",60,53,6
"1877","197410280pit","Pittsburgh Steelers",24,"Atlanta Falcons",17,41,7,TRUE,"10/28/1974",1974,"October","1970s",51,46,3
"1878","197411030dal","Dallas Cowboys",17,"St. Louis Cardinals",14,31,3,TRUE,"11/3/1974",1974,"November","1970s",74,80,17
"1879","197411030nwe","New England Patriots",28,"Buffalo Bills",29,57,-1,FALSE,"11/3/1974",1974,"November","1970s",46,64,7
"1880","197411030det","Detroit Lions",19,"New Orleans Saints",14,33,5,TRUE,"11/3/1974",1974,"November","1970s",56,95,10
"1881","197411030clt","Baltimore Colts",14,"Cincinnati Bengals",24,38,-10,FALSE,"11/3/1974",1974,"November","1970s",64,86,7
"1882","197411030mia","Miami Dolphins",42,"Atlanta Falcons",7,49,35,TRUE,"11/3/1974",1974,"November","1970s",77,67,14
"1883","197411030den","Denver Broncos",17,"Oakland Raiders",28,45,-11,FALSE,"11/3/1974",1974,"November","1970s",34,92,11
"1884","197411030gnb","Green Bay Packers",6,"Washington Redskins",17,23,-11,FALSE,"11/3/1974",1974,"November","1970s",40,72,12
"1885","197411030kan","Kansas City Chiefs",27,"New York Giants",33,60,-6,FALSE,"11/3/1974",1974,"November","1970s",47,96,15
"1886","197411030nyj","New York Jets",22,"Houston Oilers",27,49,-5,FALSE,"11/3/1974",1974,"November","1970s",56,88,11
"1887","197411030sdg","San Diego Chargers",36,"Cleveland Browns",35,71,1,TRUE,"11/3/1974",1974,"November","1970s",61,65,7
"1888","197411030chi","Chicago Bears",0,"Minnesota Vikings",17,17,-17,FALSE,"11/3/1974",1974,"November","1970s",52,83,13
"1889","197411030pit","Pittsburgh Steelers",27,"Philadelphia Eagles",0,27,27,TRUE,"11/3/1974",1974,"November","1970s",62,82,9
"1890","197411040sfo","San Francisco 49ers",13,"Los Angeles Rams",15,28,-2,FALSE,"11/4/1974",1974,"November","1970s",52,79,10
"1891","197411100gnb","Green Bay Packers",20,"Chicago Bears",3,23,17,TRUE,"11/10/1974",1974,"November","1970s",46,89,9
"1892","197411100clt","Baltimore Colts",6,"Denver Broncos",17,23,-11,FALSE,"11/10/1974",1974,"November","1970s",50,56,6
"1893","197411100nwe","New England Patriots",14,"Cleveland Browns",21,35,-7,FALSE,"11/10/1974",1974,"November","1970s",46,61,12
"1894","197411100phi","Philadelphia Eagles",20,"Washington Redskins",27,47,-7,FALSE,"11/10/1974",1974,"November","1970s",51,44,8
"1895","197411100cin","Cincinnati Bengals",17,"Pittsburgh Steelers",10,27,7,TRUE,"11/10/1974",1974,"November","1970s",48,61,6
"1896","197411100ram","Los Angeles Rams",21,"Atlanta Falcons",0,21,21,TRUE,"11/10/1974",1974,"November","1970s",65,42,7
"1897","197411100nyg","New York Giants",20,"New York Jets",26,46,-6,FALSE,"11/10/1974",1974,"November","1970s",50,45,10
"1898","197411100dal","Dallas Cowboys",20,"San Francisco 49ers",14,34,6,TRUE,"11/10/1974",1974,"November","1970s",60,88,9
"1899","197411100kan","Kansas City Chiefs",7,"San Diego Chargers",14,21,-7,FALSE,"11/10/1974",1974,"November","1970s",48,98,8
"1900","197411100nor","New Orleans Saints",0,"Miami Dolphins",21,21,-21,FALSE,"11/10/1974",1974,"November","1970s",67,71,9
"1901","197411100buf","Buffalo Bills",9,"Houston Oilers",21,30,-12,FALSE,"11/10/1974",1974,"November","1970s",42,85,9
"1902","197411100rai","Oakland Raiders",35,"Detroit Lions",13,48,22,TRUE,"11/10/1974",1974,"November","1970s",61,82,6
"1903","197411110crd","St. Louis Cardinals",24,"Minnesota Vikings",28,52,-4,FALSE,"11/11/1974",1974,"November","1970s",50,90,12
"1904","197411170chi","Chicago Bears",0,"San Francisco 49ers",34,34,-34,FALSE,"11/17/1974",1974,"November","1970s",39,88,12
"1905","197411170min","Minnesota Vikings",7,"Green Bay Packers",19,26,-12,FALSE,"11/17/1974",1974,"November","1970s",33,76,8
"1906","197411170rai","Oakland Raiders",17,"San Diego Chargers",10,27,7,TRUE,"11/17/1974",1974,"November","1970s",58,71,9
"1907","197411170nor","New Orleans Saints",20,"Los Angeles Rams",7,27,13,TRUE,"11/17/1974",1974,"November","1970s",65,87,8
"1908","197411170nwe","New England Patriots",16,"New York Jets",21,37,-5,FALSE,"11/17/1974",1974,"November","1970s",43,48,12
"1909","197411170atl","Atlanta Falcons",7,"Baltimore Colts",17,24,-10,FALSE,"11/17/1974",1974,"November","1970s",54,50,6
"1910","197411170phi","Philadelphia Eagles",3,"St. Louis Cardinals",13,16,-10,FALSE,"11/17/1974",1974,"November","1970s",41,63,10
"1911","197411170cle","Cleveland Browns",16,"Pittsburgh Steelers",26,42,-10,FALSE,"11/17/1974",1974,"November","1970s",42,65,11
"1912","197411170oti","Houston Oilers",20,"Cincinnati Bengals",3,23,17,TRUE,"11/17/1974",1974,"November","1970s",72,NA,NA
"1913","197411170mia","Miami Dolphins",35,"Buffalo Bills",28,63,7,TRUE,"11/17/1974",1974,"November","1970s",78,72,13
"1914","197411170was","Washington Redskins",28,"Dallas Cowboys",21,49,7,TRUE,"11/17/1974",1974,"November","1970s",45,59,8
"1915","197411170det","Detroit Lions",20,"New York Giants",19,39,1,TRUE,"11/17/1974",1974,"November","1970s",41,79,16
"1916","197411180den","Denver Broncos",34,"Kansas City Chiefs",42,76,-8,FALSE,"11/18/1974",1974,"November","1970s",45,42,11
"1917","197411240rai","Oakland Raiders",17,"Denver Broncos",20,37,-3,FALSE,"11/24/1974",1974,"November","1970s",56,62,8
"1918","197411240cin","Cincinnati Bengals",33,"Kansas City Chiefs",6,39,27,TRUE,"11/24/1974",1974,"November","1970s",53,70,16
"1919","197411240nyj","New York Jets",17,"Miami Dolphins",14,31,3,TRUE,"11/24/1974",1974,"November","1970s",45,64,11
"1920","197411240sfo","San Francisco 49ers",27,"Atlanta Falcons",0,27,27,TRUE,"11/24/1974",1974,"November","1970s",50,74,6
"1921","197411240ram","Los Angeles Rams",20,"Minnesota Vikings",17,37,3,TRUE,"11/24/1974",1974,"November","1970s",65,19,8
"1922","197411240nyg","New York Giants",21,"St. Louis Cardinals",23,44,-2,FALSE,"11/24/1974",1974,"November","1970s",45,71,9
"1923","197411240was","Washington Redskins",26,"Philadelphia Eagles",7,33,19,TRUE,"11/24/1974",1974,"November","1970s",50,57,11
"1924","197411240det","Detroit Lions",34,"Chicago Bears",17,51,17,TRUE,"11/24/1974",1974,"November","1970s",52,82,21
"1925","197411240gnb","Green Bay Packers",34,"San Diego Chargers",0,34,34,TRUE,"11/24/1974",1974,"November","1970s",35,77,15
"1926","197411240oti","Houston Oilers",0,"Dallas Cowboys",10,10,-10,FALSE,"11/24/1974",1974,"November","1970s",72,NA,NA
"1927","197411240clt","Baltimore Colts",17,"New England Patriots",27,44,-10,FALSE,"11/24/1974",1974,"November","1970s",45,72,8
"1928","197411240cle","Cleveland Browns",10,"Buffalo Bills",15,25,-5,FALSE,"11/24/1974",1974,"November","1970s",52,79,18
"1929","197411250nor","New Orleans Saints",7,"Pittsburgh Steelers",28,35,-21,FALSE,"11/25/1974",1974,"November","1970s",56,72,14
"1930","197411280det","Detroit Lions",27,"Denver Broncos",31,58,-4,FALSE,"11/28/1974",1974,"November","1970s",32,76,15
"1931","197411280dal","Dallas Cowboys",24,"Washington Redskins",23,47,1,TRUE,"11/28/1974",1974,"November","1970s",50,59,11
"1932","197412010min","Minnesota Vikings",29,"New Orleans Saints",9,38,20,TRUE,"12/1/1974",1974,"December","1970s",25,76,11
"1933","197412010atl","Atlanta Falcons",7,"Los Angeles Rams",30,37,-23,FALSE,"12/1/1974",1974,"December","1970s",36,82,16
"1934","197412010rai","Oakland Raiders",41,"New England Patriots",26,67,15,TRUE,"12/1/1974",1974,"December","1970s",54,73,6
"1935","197412010chi","Chicago Bears",16,"New York Giants",13,29,3,TRUE,"12/1/1974",1974,"December","1970s",34,84,24
"1936","197412010cle","Cleveland Browns",7,"San Francisco 49ers",0,7,7,TRUE,"12/1/1974",1974,"December","1970s",33,78,19
"1937","197412010buf","Buffalo Bills",6,"Baltimore Colts",0,6,6,TRUE,"12/1/1974",1974,"December","1970s",25,77,23
"1938","197412010phi","Philadelphia Eagles",36,"Green Bay Packers",14,50,22,TRUE,"12/1/1974",1974,"December","1970s",40,75,22
"1939","197412010pit","Pittsburgh Steelers",10,"Houston Oilers",13,23,-3,FALSE,"12/1/1974",1974,"December","1970s",33,73,16
"1940","197412010crd","St. Louis Cardinals",13,"Kansas City Chiefs",17,30,-4,FALSE,"12/1/1974",1974,"December","1970s",31,100,16
"1941","197412010nyj","New York Jets",27,"San Diego Chargers",14,41,13,TRUE,"12/1/1974",1974,"December","1970s",37,70,19
"1942","197412020mia","Miami Dolphins",24,"Cincinnati Bengals",3,27,21,TRUE,"12/2/1974",1974,"December","1970s",59,65,12
"1943","197412070min","Minnesota Vikings",23,"Atlanta Falcons",10,33,13,TRUE,"12/7/1974",1974,"December","1970s",28,85,10
"1944","197412070dal","Dallas Cowboys",41,"Cleveland Browns",17,58,24,TRUE,"12/7/1974",1974,"December","1970s",51,66,18
"1945","197412080nor","New Orleans Saints",14,"St. Louis Cardinals",0,14,14,TRUE,"12/8/1974",1974,"December","1970s",53,73,9
"1946","197412080clt","Baltimore Colts",16,"Miami Dolphins",17,33,-1,FALSE,"12/8/1974",1974,"December","1970s",54,88,12
"1947","197412080nyg","New York Giants",7,"Philadelphia Eagles",20,27,-13,FALSE,"12/8/1974",1974,"December","1970s",50,89,13
"1948","197412080kan","Kansas City Chiefs",6,"Oakland Raiders",7,13,-1,FALSE,"12/8/1974",1974,"December","1970s",23,62,18
"1949","197412080den","Denver Broncos",37,"Houston Oilers",14,51,23,TRUE,"12/8/1974",1974,"December","1970s",24,70,11
"1950","197412080nyj","New York Jets",20,"Buffalo Bills",10,30,10,TRUE,"12/8/1974",1974,"December","1970s",56,83,17
"1951","197412080nwe","New England Patriots",17,"Pittsburgh Steelers",21,38,-4,FALSE,"12/8/1974",1974,"December","1970s",50,85,12
"1952","197412080cin","Cincinnati Bengals",19,"Detroit Lions",23,42,-4,FALSE,"12/8/1974",1974,"December","1970s",40,86,12
"1953","197412080sdg","San Diego Chargers",28,"Chicago Bears",21,49,7,TRUE,"12/8/1974",1974,"December","1970s",60,47,6
"1954","197412080sfo","San Francisco 49ers",7,"Green Bay Packers",6,13,1,TRUE,"12/8/1974",1974,"December","1970s",50,88,11
"1955","197412090ram","Los Angeles Rams",17,"Washington Redskins",23,40,-6,FALSE,"12/9/1974",1974,"December","1970s",59,34,8
"1956","197412140kan","Kansas City Chiefs",15,"Minnesota Vikings",35,50,-20,FALSE,"12/14/1974",1974,"December","1970s",35,86,13
"1957","197412140pit","Pittsburgh Steelers",27,"Cincinnati Bengals",3,30,24,TRUE,"12/14/1974",1974,"December","1970s",35,83,9
"1958","197412140rai","Oakland Raiders",27,"Dallas Cowboys",23,50,4,TRUE,"12/14/1974",1974,"December","1970s",53,75,7
"1959","197412150oti","Houston Oilers",28,"Cleveland Browns",24,52,4,TRUE,"12/15/1974",1974,"December","1970s",72,NA,NA
"1960","197412150phi","Philadelphia Eagles",28,"Detroit Lions",17,45,11,TRUE,"12/15/1974",1974,"December","1970s",35,75,10
"1961","197412150was","Washington Redskins",42,"Chicago Bears",0,42,42,TRUE,"12/15/1974",1974,"December","1970s",39,72,6
"1962","197412150sdg","San Diego Chargers",17,"Denver Broncos",0,17,17,TRUE,"12/15/1974",1974,"December","1970s",58,48,7
"1963","197412150clt","Baltimore Colts",38,"New York Jets",45,83,-7,FALSE,"12/15/1974",1974,"December","1970s",36,78,8
"1964","197412150crd","St. Louis Cardinals",26,"New York Giants",14,40,12,TRUE,"12/15/1974",1974,"December","1970s",41,86,14
"1965","197412150sfo","San Francisco 49ers",35,"New Orleans Saints",21,56,14,TRUE,"12/15/1974",1974,"December","1970s",53,94,9
"1966","197412150mia","Miami Dolphins",34,"New England Patriots",27,61,7,TRUE,"12/15/1974",1974,"December","1970s",76,75,13
"1967","197412150ram","Los Angeles Rams",19,"Buffalo Bills",14,33,5,TRUE,"12/15/1974",1974,"December","1970s",60,50,8
"1968","197412150atl","Atlanta Falcons",10,"Green Bay Packers",3,13,7,TRUE,"12/15/1974",1974,"December","1970s",42,78,18
"1969","197412210min","Minnesota Vikings",30,"St. Louis Cardinals",14,44,16,TRUE,"12/21/1974",1974,"December","1970s",19,81,8
"1970","197412210rai","Oakland Raiders",28,"Miami Dolphins",26,54,2,TRUE,"12/21/1974",1974,"December","1970s",49,78,8
"1971","197412220pit","Pittsburgh Steelers",32,"Buffalo Bills",14,46,18,TRUE,"12/22/1974",1974,"December","1970s",33,75,12
"1972","197412220ram","Los Angeles Rams",19,"Washington Redskins",10,29,9,TRUE,"12/22/1974",1974,"December","1970s",57,69,10
"1973","197412290rai","Oakland Raiders",13,"Pittsburgh Steelers",24,37,-11,FALSE,"12/29/1974",1974,"December","1970s",50,33,10
"1974","197412290min","Minnesota Vikings",14,"Los Angeles Rams",10,24,4,TRUE,"12/29/1974",1974,"December","1970s",28,82,10
"1975","197501120min","Minnesota Vikings",6,"Pittsburgh Steelers",16,22,-10,FALSE,"1/12/1975",1975,"January","1970s",51,72,17
"1976","197509210crd","St. Louis Cardinals",23,"Atlanta Falcons",20,43,3,TRUE,"9/21/1975",1975,"September","1970s",54,85,10
"1977","197509210chi","Chicago Bears",7,"Baltimore Colts",35,42,-28,FALSE,"9/21/1975",1975,"September","1970s",55,71,14
"1978","197509210nwe","New England Patriots",0,"Houston Oilers",7,7,-7,FALSE,"9/21/1975",1975,"September","1970s",71,83,10
"1979","197509210min","Minnesota Vikings",27,"San Francisco 49ers",17,44,10,TRUE,"9/21/1975",1975,"September","1970s",50,78,12
"1980","197509210phi","Philadelphia Eagles",14,"New York Giants",23,37,-9,FALSE,"9/21/1975",1975,"September","1970s",70,80,8
"1981","197509210buf","Buffalo Bills",42,"New York Jets",14,56,28,TRUE,"9/21/1975",1975,"September","1970s",56,82,13
"1982","197509210was","Washington Redskins",41,"New Orleans Saints",3,44,38,TRUE,"9/21/1975",1975,"September","1970s",72,73,9
"1983","197509210cin","Cincinnati Bengals",24,"Cleveland Browns",17,41,7,TRUE,"9/21/1975",1975,"September","1970s",57,74,11
"1984","197509210sdg","San Diego Chargers",0,"Pittsburgh Steelers",37,37,-37,FALSE,"9/21/1975",1975,"September","1970s",69,77,11
"1985","197509210gnb","Green Bay Packers",16,"Detroit Lions",30,46,-14,FALSE,"9/21/1975",1975,"September","1970s",54,82,16
"1986","197509210dal","Dallas Cowboys",18,"Los Angeles Rams",7,25,11,TRUE,"9/21/1975",1975,"September","1970s",68,54,12
"1987","197509210den","Denver Broncos",37,"Kansas City Chiefs",33,70,4,TRUE,"9/21/1975",1975,"September","1970s",51,32,9
"1988","197509220mia","Miami Dolphins",21,"Oakland Raiders",31,52,-10,FALSE,"9/22/1975",1975,"September","1970s",82,78,12
"1989","197509280sfo","San Francisco 49ers",14,"Los Angeles Rams",23,37,-9,FALSE,"9/28/1975",1975,"September","1970s",57,74,14
"1990","197509280nwe","New England Patriots",14,"Miami Dolphins",22,36,-8,FALSE,"9/28/1975",1975,"September","1970s",66,65,15
"1991","197509280atl","Atlanta Falcons",14,"Detroit Lions",17,31,-3,FALSE,"9/28/1975",1975,"September","1970s",62,69,9
"1992","197509280clt","Baltimore Colts",20,"Oakland Raiders",31,51,-11,FALSE,"9/28/1975",1975,"September","1970s",62,66,9
"1993","197509280chi","Chicago Bears",15,"Philadelphia Eagles",13,28,2,TRUE,"9/28/1975",1975,"September","1970s",56,62,6
"1994","197509280nor","New Orleans Saints",0,"Cincinnati Bengals",21,21,-21,FALSE,"9/28/1975",1975,"September","1970s",72,NA,NA
"1995","197509280cle","Cleveland Browns",10,"Minnesota Vikings",42,52,-32,FALSE,"9/28/1975",1975,"September","1970s",51,82,7
"1996","197509280dal","Dallas Cowboys",37,"St. Louis Cardinals",31,68,6,TRUE,"9/28/1975",1975,"September","1970s",73,53,13
"1997","197509280kan","Kansas City Chiefs",24,"New York Jets",30,54,-6,FALSE,"9/28/1975",1975,"September","1970s",60,81,10
"1998","197509280pit","Pittsburgh Steelers",21,"Buffalo Bills",30,51,-9,FALSE,"9/28/1975",1975,"September","1970s",54,63,6
"1999","197509280oti","Houston Oilers",33,"San Diego Chargers",17,50,16,TRUE,"9/28/1975",1975,"September","1970s",72,NA,NA
"2000","197509280was","Washington Redskins",49,"New York Giants",13,62,36,TRUE,"9/28/1975",1975,"September","1970s",65,58,11
"2001","197509290den","Denver Broncos",23,"Green Bay Packers",13,36,10,TRUE,"9/29/1975",1975,"September","1970s",57,24,11
"2002","197510050crd","St. Louis Cardinals",26,"New York Giants",14,40,12,TRUE,"10/5/1975",1975,"October","1970s",60,64,9
"2003","197510050phi","Philadelphia Eagles",26,"Washington Redskins",10,36,16,TRUE,"10/5/1975",1975,"October","1970s",61,70,6
"2004","197510050buf","Buffalo Bills",38,"Denver Broncos",14,52,24,TRUE,"10/5/1975",1975,"October","1970s",58,63,11
"2005","197510050kan","Kansas City Chiefs",3,"San Francisco 49ers",20,23,-17,FALSE,"10/5/1975",1975,"October","1970s",59,58,13
"2006","197510050gnb","Green Bay Packers",7,"Miami Dolphins",31,38,-24,FALSE,"10/5/1975",1975,"October","1970s",56,60,17
"2007","197510050sdg","San Diego Chargers",0,"Oakland Raiders",6,6,-6,FALSE,"10/5/1975",1975,"October","1970s",66,84,8
"2008","197510050cle","Cleveland Browns",6,"Pittsburgh Steelers",42,48,-36,FALSE,"10/5/1975",1975,"October","1970s",62,50,11
"2009","197510050oti","Houston Oilers",19,"Cincinnati Bengals",21,40,-2,FALSE,"10/5/1975",1975,"October","1970s",72,NA,NA
"2010","197510050ram","Los Angeles Rams",24,"Baltimore Colts",13,37,11,TRUE,"10/5/1975",1975,"October","1970s",66,91,7
"2011","197510050atl","Atlanta Falcons",14,"New Orleans Saints",7,21,7,TRUE,"10/5/1975",1975,"October","1970s",55,89,12
"2012","197510050nyj","New York Jets",36,"New England Patriots",7,43,29,TRUE,"10/5/1975",1975,"October","1970s",61,62,9
"2013","197510050min","Minnesota Vikings",28,"Chicago Bears",3,31,25,TRUE,"10/5/1975",1975,"October","1970s",67,38,17
"2014","197510060det","Detroit Lions",10,"Dallas Cowboys",36,46,-26,FALSE,"10/6/1975",1975,"October","1970s",72,NA,NA
"2015","197510120sdg","San Diego Chargers",10,"Los Angeles Rams",13,23,-3,FALSE,"10/12/1975",1975,"October","1970s",66,66,12
"2016","197510120sfo","San Francisco 49ers",3,"Atlanta Falcons",17,20,-14,FALSE,"10/12/1975",1975,"October","1970s",57,76,10
"2017","197510120pit","Pittsburgh Steelers",20,"Denver Broncos",9,29,11,TRUE,"10/12/1975",1975,"October","1970s",50,60,10
"2018","197510120min","Minnesota Vikings",29,"New York Jets",21,50,8,TRUE,"10/12/1975",1975,"October","1970s",64,50,13
"2019","197510120nor","New Orleans Saints",20,"Green Bay Packers",19,39,1,TRUE,"10/12/1975",1975,"October","1970s",72,NA,NA
"2020","197510120cle","Cleveland Browns",10,"Houston Oilers",40,50,-30,FALSE,"10/12/1975",1975,"October","1970s",48,82,7
"2021","197510120cin","Cincinnati Bengals",27,"New England Patriots",10,37,17,TRUE,"10/12/1975",1975,"October","1970s",58,61,5
"2022","197510120mia","Miami Dolphins",24,"Philadelphia Eagles",16,40,8,TRUE,"10/12/1975",1975,"October","1970s",80,62,13
"2023","197510120nyg","New York Giants",7,"Dallas Cowboys",13,20,-6,FALSE,"10/12/1975",1975,"October","1970s",58,68,16
"2024","197510120kan","Kansas City Chiefs",42,"Oakland Raiders",10,52,32,TRUE,"10/12/1975",1975,"October","1970s",76,58,16
"2025","197510120clt","Baltimore Colts",31,"Buffalo Bills",38,69,-7,FALSE,"10/12/1975",1975,"October","1970s",59,68,13
"2026","197510120det","Detroit Lions",27,"Chicago Bears",7,34,20,TRUE,"10/12/1975",1975,"October","1970s",72,NA,NA
"2027","197510130was","Washington Redskins",27,"St. Louis Cardinals",17,44,10,TRUE,"10/13/1975",1975,"October","1970s",61,61,8
"2028","197510190sfo","San Francisco 49ers",35,"New Orleans Saints",21,56,14,TRUE,"10/19/1975",1975,"October","1970s",60,73,10
"2029","197510190pit","Pittsburgh Steelers",34,"Chicago Bears",3,37,31,TRUE,"10/19/1975",1975,"October","1970s",50,64,10
"2030","197510190cin","Cincinnati Bengals",14,"Oakland Raiders",10,24,4,TRUE,"10/19/1975",1975,"October","1970s",46,91,10
"2031","197510190dal","Dallas Cowboys",17,"Green Bay Packers",19,36,-2,FALSE,"10/19/1975",1975,"October","1970s",61,40,13
"2032","197510190crd","St. Louis Cardinals",31,"Philadelphia Eagles",20,51,11,TRUE,"10/19/1975",1975,"October","1970s",46,68,10
"2033","197510190den","Denver Broncos",16,"Cleveland Browns",15,31,1,TRUE,"10/19/1975",1975,"October","1970s",57,25,11
"2034","197510190nyj","New York Jets",0,"Miami Dolphins",43,43,-43,FALSE,"10/19/1975",1975,"October","1970s",53,86,22
"2035","197510190sdg","San Diego Chargers",10,"Kansas City Chiefs",12,22,-2,FALSE,"10/19/1975",1975,"October","1970s",64,65,8
"2036","197510190ram","Los Angeles Rams",22,"Atlanta Falcons",7,29,15,TRUE,"10/19/1975",1975,"October","1970s",61,82,7
"2037","197510190min","Minnesota Vikings",25,"Detroit Lions",19,44,6,TRUE,"10/19/1975",1975,"October","1970s",48,50,8
"2038","197510190nwe","New England Patriots",21,"Baltimore Colts",10,31,11,TRUE,"10/19/1975",1975,"October","1970s",51,86,22
"2039","197510190oti","Houston Oilers",13,"Washington Redskins",10,23,3,TRUE,"10/19/1975",1975,"October","1970s",72,NA,NA
"2040","197510200buf","Buffalo Bills",14,"New York Giants",17,31,-3,FALSE,"10/20/1975",1975,"October","1970s",50,86,13
"2041","197510250nyg","New York Giants",13,"St. Louis Cardinals",20,33,-7,FALSE,"10/25/1975",1975,"October","1970s",64,89,14
"2042","197510260ram","Los Angeles Rams",38,"New Orleans Saints",14,52,24,TRUE,"10/26/1975",1975,"October","1970s",61,65,8
"2043","197510260nwe","New England Patriots",24,"San Francisco 49ers",16,40,8,TRUE,"10/26/1975",1975,"October","1970s",62,73,12
"2044","197510260phi","Philadelphia Eagles",17,"Dallas Cowboys",20,37,-3,FALSE,"10/26/1975",1975,"October","1970s",61,78,10
"2045","197510260rai","Oakland Raiders",25,"San Diego Chargers",0,25,25,TRUE,"10/26/1975",1975,"October","1970s",58,87,10
"2046","197510260kan","Kansas City Chiefs",26,"Denver Broncos",13,39,13,TRUE,"10/26/1975",1975,"October","1970s",46,48,16
"2047","197510260gnb","Green Bay Packers",13,"Pittsburgh Steelers",16,29,-3,FALSE,"10/26/1975",1975,"October","1970s",44,50,12
"2048","197510260atl","Atlanta Falcons",14,"Cincinnati Bengals",21,35,-7,FALSE,"10/26/1975",1975,"October","1970s",60,90,8
"2049","197510260buf","Buffalo Bills",30,"Miami Dolphins",35,65,-5,FALSE,"10/26/1975",1975,"October","1970s",48,68,8
"2050","197510260cle","Cleveland Browns",7,"Washington Redskins",23,30,-16,FALSE,"10/26/1975",1975,"October","1970s",45,79,7
"2051","197510260nyj","New York Jets",28,"Baltimore Colts",45,73,-17,FALSE,"10/26/1975",1975,"October","1970s",60,71,12
"2052","197510260oti","Houston Oilers",24,"Detroit Lions",8,32,16,TRUE,"10/26/1975",1975,"October","1970s",72,NA,NA
"2053","197510270chi","Chicago Bears",9,"Minnesota Vikings",13,22,-4,FALSE,"10/27/1975",1975,"October","1970s",52,55,15
"2054","197511010nyg","New York Giants",35,"San Diego Chargers",24,59,11,TRUE,"11/1/1975",1975,"November","1970s",48,41,14
"2055","197511020gnb","Green Bay Packers",17,"Minnesota Vikings",28,45,-11,FALSE,"11/2/1975",1975,"November","1970s",44,74,9
"2056","197511020nyj","New York Jets",23,"Buffalo Bills",24,47,-1,FALSE,"11/2/1975",1975,"November","1970s",58,47,12
"2057","197511020clt","Baltimore Colts",21,"Cleveland Browns",7,28,14,TRUE,"11/2/1975",1975,"November","1970s",55,56,7
"2058","197511020kan","Kansas City Chiefs",13,"Houston Oilers",17,30,-4,FALSE,"11/2/1975",1975,"November","1970s",65,75,11
"2059","197511020was","Washington Redskins",30,"Dallas Cowboys",24,54,6,TRUE,"11/2/1975",1975,"November","1970s",55,58,6
"2060","197511020sfo","San Francisco 49ers",17,"Detroit Lions",28,45,-11,FALSE,"11/2/1975",1975,"November","1970s",54,78,8
"2061","197511020cin","Cincinnati Bengals",24,"Pittsburgh Steelers",30,54,-6,FALSE,"11/2/1975",1975,"November","1970s",61,70,11
"2062","197511020den","Denver Broncos",17,"Oakland Raiders",42,59,-25,FALSE,"11/2/1975",1975,"November","1970s",46,51,11
"2063","197511020chi","Chicago Bears",13,"Miami Dolphins",46,59,-33,FALSE,"11/2/1975",1975,"November","1970s",61,79,11
"2064","197511020nor","New Orleans Saints",23,"Atlanta Falcons",7,30,16,TRUE,"11/2/1975",1975,"November","1970s",72,NA,NA
"2065","197511020crd","St. Louis Cardinals",24,"New England Patriots",17,41,7,TRUE,"11/2/1975",1975,"November","1970s",65,76,9
"2066","197511030phi","Philadelphia Eagles",3,"Los Angeles Rams",42,45,-39,FALSE,"11/3/1975",1975,"November","1970s",61,68,8
"2067","197511090nyg","New York Giants",13,"Washington Redskins",21,34,-8,FALSE,"11/9/1975",1975,"November","1970s",66,73,10
"2068","197511090buf","Buffalo Bills",35,"Baltimore Colts",42,77,-7,FALSE,"11/9/1975",1975,"November","1970s",57,86,8
"2069","197511090rai","Oakland Raiders",48,"New Orleans Saints",10,58,38,TRUE,"11/9/1975",1975,"November","1970s",50,71,17
"2070","197511090min","Minnesota Vikings",38,"Atlanta Falcons",0,38,38,TRUE,"11/9/1975",1975,"November","1970s",46,70,11
"2071","197511090chi","Chicago Bears",27,"Green Bay Packers",14,41,13,TRUE,"11/9/1975",1975,"November","1970s",58,85,12
"2072","197511090mia","Miami Dolphins",27,"New York Jets",7,34,20,TRUE,"11/9/1975",1975,"November","1970s",79,73,15
"2073","197511090pit","Pittsburgh Steelers",24,"Houston Oilers",17,41,7,TRUE,"11/9/1975",1975,"November","1970s",59,80,7
"2074","197511090det","Detroit Lions",21,"Cleveland Browns",10,31,11,TRUE,"11/9/1975",1975,"November","1970s",72,NA,NA
"2075","197511090ram","Los Angeles Rams",23,"San Francisco 49ers",24,47,-1,FALSE,"11/9/1975",1975,"November","1970s",60,74,8
"2076","197511090sdg","San Diego Chargers",19,"New England Patriots",33,52,-14,FALSE,"11/9/1975",1975,"November","1970s",62,73,8
"2077","197511090den","Denver Broncos",16,"Cincinnati Bengals",17,33,-1,FALSE,"11/9/1975",1975,"November","1970s",34,86,8
"2078","197511090phi","Philadelphia Eagles",23,"St. Louis Cardinals",24,47,-1,FALSE,"11/9/1975",1975,"November","1970s",66,85,6
"2079","197511100dal","Dallas Cowboys",31,"Kansas City Chiefs",34,65,-3,FALSE,"11/10/1975",1975,"November","1970s",60,49,14
"2080","197511160det","Detroit Lions",13,"Green Bay Packers",10,23,3,TRUE,"11/16/1975",1975,"November","1970s",72,NA,NA
"2081","197511160pit","Pittsburgh Steelers",28,"Kansas City Chiefs",3,31,25,TRUE,"11/16/1975",1975,"November","1970s",42,51,10
"2082","197511160clt","Baltimore Colts",52,"New York Jets",19,71,33,TRUE,"11/16/1975",1975,"November","1970s",47,52,9
"2083","197511160sdg","San Diego Chargers",17,"Denver Broncos",27,44,-10,FALSE,"11/16/1975",1975,"November","1970s",57,84,8
"2084","197511160atl","Atlanta Falcons",7,"Los Angeles Rams",16,23,-9,FALSE,"11/16/1975",1975,"November","1970s",47,43,8
"2085","197511160sfo","San Francisco 49ers",31,"Chicago Bears",3,34,28,TRUE,"11/16/1975",1975,"November","1970s",55,74,13
"2086","197511160oti","Houston Oilers",20,"Miami Dolphins",19,39,1,TRUE,"11/16/1975",1975,"November","1970s",72,NA,NA
"2087","197511160nor","New Orleans Saints",7,"Minnesota Vikings",20,27,-13,FALSE,"11/16/1975",1975,"November","1970s",72,NA,NA
"2088","197511160rai","Oakland Raiders",38,"Cleveland Browns",17,55,21,TRUE,"11/16/1975",1975,"November","1970s",56,79,9
"2089","197511160crd","St. Louis Cardinals",20,"Washington Redskins",17,37,3,TRUE,"11/16/1975",1975,"November","1970s",58,44,8
"2090","197511160nyg","New York Giants",10,"Philadelphia Eagles",13,23,-3,FALSE,"11/16/1975",1975,"November","1970s",47,48,17
"2091","197511160nwe","New England Patriots",31,"Dallas Cowboys",34,65,-3,FALSE,"11/16/1975",1975,"November","1970s",44,48,13
"2092","197511170cin","Cincinnati Bengals",33,"Buffalo Bills",24,57,9,TRUE,"11/17/1975",1975,"November","1970s",49,65,6
"2093","197511230nyj","New York Jets",6,"St. Louis Cardinals",37,43,-31,FALSE,"11/23/1975",1975,"November","1970s",41,52,12
"2094","197511230was","Washington Redskins",23,"Oakland Raiders",26,49,-3,FALSE,"11/23/1975",1975,"November","1970s",41,58,10
"2095","197511230nor","New Orleans Saints",6,"San Francisco 49ers",16,22,-10,FALSE,"11/23/1975",1975,"November","1970s",72,NA,NA
"2096","197511230gnb","Green Bay Packers",40,"New York Giants",14,54,26,TRUE,"11/23/1975",1975,"November","1970s",29,71,7
"2097","197511230ram","Los Angeles Rams",38,"Chicago Bears",10,48,28,TRUE,"11/23/1975",1975,"November","1970s",61,30,6
"2098","197511230buf","Buffalo Bills",45,"New England Patriots",31,76,14,TRUE,"11/23/1975",1975,"November","1970s",35,66,10
"2099","197511230min","Minnesota Vikings",28,"San Diego Chargers",13,41,15,TRUE,"11/23/1975",1975,"November","1970s",23,75,8
"2100","197511230atl","Atlanta Falcons",35,"Denver Broncos",21,56,14,TRUE,"11/23/1975",1975,"November","1970s",36,82,8
"2101","197511230dal","Dallas Cowboys",27,"Philadelphia Eagles",17,44,10,TRUE,"11/23/1975",1975,"November","1970s",40,38,8
"2102","197511230cle","Cleveland Browns",35,"Cincinnati Bengals",23,58,12,TRUE,"11/23/1975",1975,"November","1970s",33,76,9
"2103","197511230mia","Miami Dolphins",17,"Baltimore Colts",33,50,-16,FALSE,"11/23/1975",1975,"November","1970s",66,71,14
"2104","197511230kan","Kansas City Chiefs",24,"Detroit Lions",21,45,3,TRUE,"11/23/1975",1975,"November","1970s",32,56,13
"2105","197511240oti","Houston Oilers",9,"Pittsburgh Steelers",32,41,-23,FALSE,"11/24/1975",1975,"November","1970s",72,NA,NA
"2106","197511270det","Detroit Lions",0,"Los Angeles Rams",20,20,-20,FALSE,"11/27/1975",1975,"November","1970s",72,NA,NA
"2107","197511270crd","St. Louis Cardinals",14,"Buffalo Bills",32,46,-18,FALSE,"11/27/1975",1975,"November","1970s",28,92,12
"2108","197511300cle","Cleveland Browns",17,"New Orleans Saints",16,33,1,TRUE,"11/30/1975",1975,"November","1970s",56,71,25
"2109","197511300dal","Dallas Cowboys",14,"New York Giants",3,17,11,TRUE,"11/30/1975",1975,"November","1970s",56,42,20
"2110","197511300den","Denver Broncos",13,"San Diego Chargers",10,23,3,TRUE,"11/30/1975",1975,"November","1970s",19,48,18
"2111","197511300nyj","New York Jets",7,"Pittsburgh Steelers",20,27,-13,FALSE,"11/30/1975",1975,"November","1970s",50,68,13
"2112","197511300gnb","Green Bay Packers",28,"Chicago Bears",7,35,21,TRUE,"11/30/1975",1975,"November","1970s",39,86,18
"2113","197511300cin","Cincinnati Bengals",23,"Houston Oilers",19,42,4,TRUE,"11/30/1975",1975,"November","1970s",60,63,21
"2114","197511300rai","Oakland Raiders",37,"Atlanta Falcons",34,71,3,TRUE,"11/30/1975",1975,"November","1970s",47,78,8
"2115","197511300phi","Philadelphia Eagles",27,"San Francisco 49ers",17,44,10,TRUE,"11/30/1975",1975,"November","1970s",48,74,10
"2116","197511300was","Washington Redskins",31,"Minnesota Vikings",30,61,1,TRUE,"11/30/1975",1975,"November","1970s",50,70,12
"2117","197511300clt","Baltimore Colts",28,"Kansas City Chiefs",14,42,14,TRUE,"11/30/1975",1975,"November","1970s",49,66,11
"2118","197512010mia","Miami Dolphins",20,"New England Patriots",7,27,13,TRUE,"12/1/1975",1975,"December","1970s",73,70,8
"2119","197512070nor","New Orleans Saints",7,"Los Angeles Rams",14,21,-7,FALSE,"12/7/1975",1975,"December","1970s",72,NA,NA
"2120","197512070crd","St. Louis Cardinals",31,"Dallas Cowboys",17,48,14,TRUE,"12/7/1975",1975,"December","1970s",33,83,9
"2121","197512070nwe","New England Patriots",28,"New York Jets",30,58,-2,FALSE,"12/7/1975",1975,"December","1970s",38,43,17
"2122","197512070pit","Pittsburgh Steelers",31,"Cleveland Browns",17,48,14,TRUE,"12/7/1975",1975,"December","1970s",31,55,11
"2123","197512070atl","Atlanta Falcons",27,"Washington Redskins",30,57,-3,FALSE,"12/7/1975",1975,"December","1970s",57,86,6
"2124","197512070sfo","San Francisco 49ers",13,"Houston Oilers",27,40,-14,FALSE,"12/7/1975",1975,"December","1970s",52,73,16
"2125","197512070nyg","New York Giants",0,"Baltimore Colts",21,21,-21,FALSE,"12/7/1975",1975,"December","1970s",40,50,17
"2126","197512070mia","Miami Dolphins",31,"Buffalo Bills",21,52,10,TRUE,"12/7/1975",1975,"December","1970s",72,64,10
"2127","197512070phi","Philadelphia Eagles",0,"Cincinnati Bengals",31,31,-31,FALSE,"12/7/1975",1975,"December","1970s",40,54,14
"2128","197512070min","Minnesota Vikings",24,"Green Bay Packers",3,27,21,TRUE,"12/7/1975",1975,"December","1970s",25,62,7
"2129","197512070kan","Kansas City Chiefs",20,"San Diego Chargers",28,48,-8,FALSE,"12/7/1975",1975,"December","1970s",33,59,8
"2130","197512070chi","Chicago Bears",25,"Detroit Lions",21,46,4,TRUE,"12/7/1975",1975,"December","1970s",32,64,10
"2131","197512080rai","Oakland Raiders",17,"Denver Broncos",10,27,7,TRUE,"12/8/1975",1975,"December","1970s",53,77,7
"2132","197512130pit","Pittsburgh Steelers",35,"Cincinnati Bengals",14,49,21,TRUE,"12/13/1975",1975,"December","1970s",45,74,8
"2133","197512130dal","Dallas Cowboys",31,"Washington Redskins",10,41,21,TRUE,"12/13/1975",1975,"December","1970s",64,81,19
"2134","197512140cle","Cleveland Browns",40,"Kansas City Chiefs",14,54,26,TRUE,"12/14/1975",1975,"December","1970s",55,74,19
"2135","197512140rai","Oakland Raiders",26,"Houston Oilers",27,53,-1,FALSE,"12/14/1975",1975,"December","1970s",48,50,15
"2136","197512140clt","Baltimore Colts",10,"Miami Dolphins",7,17,3,TRUE,"12/14/1975",1975,"December","1970s",43,92,4
"2137","197512140chi","Chicago Bears",20,"St. Louis Cardinals",34,54,-14,FALSE,"12/14/1975",1975,"December","1970s",58,86,22
"2138","197512140den","Denver Broncos",25,"Philadelphia Eagles",10,35,15,TRUE,"12/14/1975",1975,"December","1970s",21,83,12
"2139","197512140atl","Atlanta Falcons",31,"San Francisco 49ers",9,40,22,TRUE,"12/14/1975",1975,"December","1970s",57,79,10
"2140","197512140ram","Los Angeles Rams",22,"Green Bay Packers",5,27,17,TRUE,"12/14/1975",1975,"December","1970s",54,46,11
"2141","197512140nwe","New England Patriots",14,"Buffalo Bills",34,48,-20,FALSE,"12/14/1975",1975,"December","1970s",45,77,13
"2142","197512140det","Detroit Lions",17,"Minnesota Vikings",10,27,7,TRUE,"12/14/1975",1975,"December","1970s",72,NA,NA
"2143","197512140nyg","New York Giants",28,"New Orleans Saints",14,42,14,TRUE,"12/14/1975",1975,"December","1970s",48,84,11
"2144","197512150sdg","San Diego Chargers",24,"New York Jets",16,40,8,TRUE,"12/15/1975",1975,"December","1970s",54,33,7
"2145","197512200mia","Miami Dolphins",14,"Denver Broncos",13,27,1,TRUE,"12/20/1975",1975,"December","1970s",64,69,9
"2146","197512200buf","Buffalo Bills",13,"Minnesota Vikings",35,48,-22,FALSE,"12/20/1975",1975,"December","1970s",18,89,14
"2147","197512200ram","Los Angeles Rams",10,"Pittsburgh Steelers",3,13,7,TRUE,"12/20/1975",1975,"December","1970s",52,78,6
"2148","197512210clt","Baltimore Colts",34,"New England Patriots",21,55,13,TRUE,"12/21/1975",1975,"December","1970s",34,60,11
"2149","197512210was","Washington Redskins",3,"Philadelphia Eagles",26,29,-23,FALSE,"12/21/1975",1975,"December","1970s",37,55,11
"2150","197512210nyj","New York Jets",21,"Dallas Cowboys",31,52,-10,FALSE,"12/21/1975",1975,"December","1970s",27,73,17
"2151","197512210sfo","San Francisco 49ers",23,"New York Giants",26,49,-3,FALSE,"12/21/1975",1975,"December","1970s",46,76,8
"2152","197512210oti","Houston Oilers",21,"Cleveland Browns",10,31,11,TRUE,"12/21/1975",1975,"December","1970s",72,NA,NA
"2153","197512210gnb","Green Bay Packers",22,"Atlanta Falcons",13,35,9,TRUE,"12/21/1975",1975,"December","1970s",10,82,8
"2154","197512210nor","New Orleans Saints",17,"Chicago Bears",42,59,-25,FALSE,"12/21/1975",1975,"December","1970s",72,NA,NA
"2155","197512210cin","Cincinnati Bengals",47,"San Diego Chargers",17,64,30,TRUE,"12/21/1975",1975,"December","1970s",28,69,15
"2156","197512210rai","Oakland Raiders",28,"Kansas City Chiefs",20,48,8,TRUE,"12/21/1975",1975,"December","1970s",47,85,8
"2157","197512210det","Detroit Lions",13,"St. Louis Cardinals",24,37,-11,FALSE,"12/21/1975",1975,"December","1970s",72,NA,NA
"2158","197512270pit","Pittsburgh Steelers",28,"Baltimore Colts",10,38,18,TRUE,"12/27/1975",1975,"December","1970s",32,72,12
"2159","197512270ram","Los Angeles Rams",35,"St. Louis Cardinals",23,58,12,TRUE,"12/27/1975",1975,"December","1970s",50,95,6
"2160","197512280min","Minnesota Vikings",14,"Dallas Cowboys",17,31,-3,FALSE,"12/28/1975",1975,"December","1970s",25,76,8
"2161","197512280rai","Oakland Raiders",31,"Cincinnati Bengals",28,59,3,TRUE,"12/28/1975",1975,"December","1970s",51,81,6
"2162","197601040pit","Pittsburgh Steelers",16,"Oakland Raiders",10,26,6,TRUE,"1/4/1976",1976,"January","1970s",18,62,18
"2163","197601040ram","Los Angeles Rams",7,"Dallas Cowboys",37,44,-30,FALSE,"1/4/1976",1976,"January","1970s",51,58,8
"2164","197601180dal","Dallas Cowboys",17,"Pittsburgh Steelers",21,38,-4,FALSE,"1/18/1976",1976,"January","1970s",49,44,18
"2165","197609120atl","Atlanta Falcons",14,"Los Angeles Rams",30,44,-16,FALSE,"9/12/1976",1976,"September","1970s",66,56,9
"2166","197609120gnb","Green Bay Packers",14,"San Francisco 49ers",26,40,-12,FALSE,"9/12/1976",1976,"September","1970s",69,48,13
"2167","197609120chi","Chicago Bears",10,"Detroit Lions",3,13,7,TRUE,"9/12/1976",1976,"September","1970s",69,46,12
"2168","197609120nor","New Orleans Saints",9,"Minnesota Vikings",40,49,-31,FALSE,"9/12/1976",1976,"September","1970s",72,NA,NA
"2169","197609120rai","Oakland Raiders",31,"Pittsburgh Steelers",28,59,3,TRUE,"9/12/1976",1976,"September","1970s",62,75,8
"2170","197609120cin","Cincinnati Bengals",17,"Denver Broncos",7,24,10,TRUE,"9/12/1976",1976,"September","1970s",64,63,8
"2171","197609120oti","Houston Oilers",20,"Tampa Bay Buccaneers",0,20,20,TRUE,"9/12/1976",1976,"September","1970s",72,NA,NA
"2172","197609120cle","Cleveland Browns",38,"New York Jets",17,55,21,TRUE,"9/12/1976",1976,"September","1970s",65,62,9
"2173","197609120kan","Kansas City Chiefs",16,"San Diego Chargers",30,46,-14,FALSE,"9/12/1976",1976,"September","1970s",74,41,15
"2174","197609120nwe","New England Patriots",13,"Baltimore Colts",27,40,-14,FALSE,"9/12/1976",1976,"September","1970s",64,55,14
"2175","197609120sea","Seattle Seahawks",24,"St. Louis Cardinals",30,54,-6,FALSE,"9/12/1976",1976,"September","1970s",72,NA,NA
"2176","197609120was","Washington Redskins",19,"New York Giants",17,36,2,TRUE,"9/12/1976",1976,"September","1970s",72,51,8
"2177","197609120dal","Dallas Cowboys",27,"Philadelphia Eagles",7,34,20,TRUE,"9/12/1976",1976,"September","1970s",74,62,11
"2178","197609130buf","Buffalo Bills",21,"Miami Dolphins",30,51,-9,FALSE,"9/13/1976",1976,"September","1970s",67,61,12
"2179","197609190clt","Baltimore Colts",28,"Cincinnati Bengals",27,55,1,TRUE,"9/19/1976",1976,"September","1970s",69,68,10
"2180","197609190den","Denver Broncos",46,"New York Jets",3,49,43,TRUE,"9/19/1976",1976,"September","1970s",60,61,14
"2181","197609190sfo","San Francisco 49ers",12,"Chicago Bears",19,31,-7,FALSE,"9/19/1976",1976,"September","1970s",57,79,14
"2182","197609190crd","St. Louis Cardinals",29,"Green Bay Packers",0,29,29,TRUE,"9/19/1976",1976,"September","1970s",77,63,10
"2183","197609190nor","New Orleans Saints",6,"Dallas Cowboys",24,30,-18,FALSE,"9/19/1976",1976,"September","1970s",72,NA,NA
"2184","197609190phi","Philadelphia Eagles",20,"New York Giants",7,27,13,TRUE,"9/19/1976",1976,"September","1970s",71,60,11
"2185","197609190pit","Pittsburgh Steelers",31,"Cleveland Browns",14,45,17,TRUE,"9/19/1976",1976,"September","1970s",62,72,8
"2186","197609190tam","Tampa Bay Buccaneers",0,"San Diego Chargers",23,23,-23,FALSE,"9/19/1976",1976,"September","1970s",77,75,7
"2187","197609190nwe","New England Patriots",30,"Miami Dolphins",14,44,16,TRUE,"9/19/1976",1976,"September","1970s",71,69,11
"2188","197609190buf","Buffalo Bills",3,"Houston Oilers",13,16,-10,FALSE,"9/19/1976",1976,"September","1970s",66,79,12
"2189","197609190det","Detroit Lions",24,"Atlanta Falcons",10,34,14,TRUE,"9/19/1976",1976,"September","1970s",72,NA,NA
"2190","197609190min","Minnesota Vikings",10,"Los Angeles Rams",10,20,0,FALSE,"9/19/1976",1976,"September","1970s",67,67,11
"2191","197609190was","Washington Redskins",31,"Seattle Seahawks",7,38,24,TRUE,"9/19/1976",1976,"September","1970s",71,68,9
"2192","197609200kan","Kansas City Chiefs",21,"Oakland Raiders",24,45,-3,FALSE,"9/20/1976",1976,"September","1970s",66,65,13
"2193","197609260cin","Cincinnati Bengals",28,"Green Bay Packers",7,35,21,TRUE,"9/26/1976",1976,"September","1970s",66,75,12
"2194","197609260oti","Houston Oilers",13,"Oakland Raiders",14,27,-1,FALSE,"9/26/1976",1976,"September","1970s",72,NA,NA
"2195","197609260tam","Tampa Bay Buccaneers",9,"Buffalo Bills",14,23,-5,FALSE,"9/26/1976",1976,"September","1970s",80,73,6
"2196","197609260sea","Seattle Seahawks",21,"San Francisco 49ers",37,58,-16,FALSE,"9/26/1976",1976,"September","1970s",72,NA,NA
"2197","197609260mia","Miami Dolphins",16,"New York Jets",0,16,16,TRUE,"9/26/1976",1976,"September","1970s",80,73,11
"2198","197609260det","Detroit Lions",9,"Minnesota Vikings",10,19,-1,FALSE,"9/26/1976",1976,"September","1970s",72,NA,NA
"2199","197609260pit","Pittsburgh Steelers",27,"New England Patriots",30,57,-3,FALSE,"9/26/1976",1976,"September","1970s",56,78,8
"2200","197609260sdg","San Diego Chargers",43,"St. Louis Cardinals",24,67,19,TRUE,"9/26/1976",1976,"September","1970s",71,73,10
"2201","197609260chi","Chicago Bears",0,"Atlanta Falcons",10,10,-10,FALSE,"9/26/1976",1976,"September","1970s",57,79,9
"2202","197609260dal","Dallas Cowboys",30,"Baltimore Colts",27,57,3,TRUE,"9/26/1976",1976,"September","1970s",82,54,11
"2203","197609260den","Denver Broncos",44,"Cleveland Browns",13,57,31,TRUE,"9/26/1976",1976,"September","1970s",54,72,9
"2204","197609260kan","Kansas City Chiefs",17,"New Orleans Saints",27,44,-10,FALSE,"9/26/1976",1976,"September","1970s",61,94,9
"2205","197609260ram","Los Angeles Rams",24,"New York Giants",10,34,14,TRUE,"9/26/1976",1976,"September","1970s",68,83,11
"2206","197609270phi","Philadelphia Eagles",17,"Washington Redskins",20,37,-3,FALSE,"9/27/1976",1976,"September","1970s",70,80,12
"2207","197610030sea","Seattle Seahawks",13,"Dallas Cowboys",28,41,-15,FALSE,"10/3/1976",1976,"October","1970s",72,NA,NA
"2208","197610030den","Denver Broncos",26,"San Diego Chargers",0,26,26,TRUE,"10/3/1976",1976,"October","1970s",61,38,15
"2209","197610030atl","Atlanta Falcons",13,"Philadelphia Eagles",14,27,-1,FALSE,"10/3/1976",1976,"October","1970s",65,58,7
"2210","197610030mia","Miami Dolphins",28,"Los Angeles Rams",31,59,-3,FALSE,"10/3/1976",1976,"October","1970s",75,67,8
"2211","197610030clt","Baltimore Colts",42,"Tampa Bay Buccaneers",17,59,25,TRUE,"10/3/1976",1976,"October","1970s",60,95,10
"2212","197610030crd","St. Louis Cardinals",27,"New York Giants",21,48,6,TRUE,"10/3/1976",1976,"October","1970s",69,56,7
"2213","197610030nwe","New England Patriots",48,"Oakland Raiders",17,65,31,TRUE,"10/3/1976",1976,"October","1970s",60,82,10
"2214","197610030sfo","San Francisco 49ers",17,"New York Jets",6,23,11,TRUE,"10/3/1976",1976,"October","1970s",61,76,9
"2215","197610030gnb","Green Bay Packers",24,"Detroit Lions",14,38,10,TRUE,"10/3/1976",1976,"October","1970s",60,65,12
"2216","197610030cle","Cleveland Browns",24,"Cincinnati Bengals",45,69,-21,FALSE,"10/3/1976",1976,"October","1970s",58,88,6
"2217","197610030chi","Chicago Bears",33,"Washington Redskins",7,40,26,TRUE,"10/3/1976",1976,"October","1970s",65,66,9
"2218","197610030nor","New Orleans Saints",26,"Houston Oilers",31,57,-5,FALSE,"10/3/1976",1976,"October","1970s",72,NA,NA
"2219","197610030buf","Buffalo Bills",50,"Kansas City Chiefs",17,67,33,TRUE,"10/3/1976",1976,"October","1970s",55,81,7
"2220","197610040min","Minnesota Vikings",17,"Pittsburgh Steelers",6,23,11,TRUE,"10/4/1976",1976,"October","1970s",65,55,13
"2221","197610100min","Minnesota Vikings",20,"Chicago Bears",19,39,1,TRUE,"10/10/1976",1976,"October","1970s",48,57,8
"2222","197610100det","Detroit Lions",30,"New England Patriots",10,40,20,TRUE,"10/10/1976",1976,"October","1970s",72,NA,NA
"2223","197610100nyj","New York Jets",17,"Buffalo Bills",14,31,3,TRUE,"10/10/1976",1976,"October","1970s",53,51,18
"2224","197610100was","Washington Redskins",30,"Kansas City Chiefs",33,63,-3,FALSE,"10/10/1976",1976,"October","1970s",56,58,14
"2225","197610100gnb","Green Bay Packers",27,"Seattle Seahawks",20,47,7,TRUE,"10/10/1976",1976,"October","1970s",49,80,6
"2226","197610100crd","St. Louis Cardinals",33,"Philadelphia Eagles",14,47,19,TRUE,"10/10/1976",1976,"October","1970s",51,70,7
"2227","197610100clt","Baltimore Colts",28,"Miami Dolphins",14,42,14,TRUE,"10/10/1976",1976,"October","1970s",53,63,14
"2228","197610100nor","New Orleans Saints",30,"Atlanta Falcons",0,30,30,TRUE,"10/10/1976",1976,"October","1970s",72,NA,NA
"2229","197610100oti","Houston Oilers",17,"Denver Broncos",3,20,14,TRUE,"10/10/1976",1976,"October","1970s",72,NA,NA
"2230","197610100cle","Cleveland Browns",18,"Pittsburgh Steelers",16,34,2,TRUE,"10/10/1976",1976,"October","1970s",48,65,13
"2231","197610100sdg","San Diego Chargers",17,"Oakland Raiders",27,44,-10,FALSE,"10/10/1976",1976,"October","1970s",75,49,6
"2232","197610100nyg","New York Giants",14,"Dallas Cowboys",24,38,-10,FALSE,"10/10/1976",1976,"October","1970s",53,51,18
"2233","197610100cin","Cincinnati Bengals",21,"Tampa Bay Buccaneers",0,21,21,TRUE,"10/10/1976",1976,"October","1970s",47,65,5
"2234","197610110ram","Los Angeles Rams",0,"San Francisco 49ers",16,16,-16,FALSE,"10/11/1976",1976,"October","1970s",67,88,9
"2235","197610170gnb","Green Bay Packers",28,"Philadelphia Eagles",13,41,15,TRUE,"10/17/1976",1976,"October","1970s",34,60,11
"2236","197610170mia","Miami Dolphins",17,"Kansas City Chiefs",20,37,-3,FALSE,"10/17/1976",1976,"October","1970s",80,83,11
"2237","197610170den","Denver Broncos",10,"Oakland Raiders",17,27,-7,FALSE,"10/17/1976",1976,"October","1970s",48,36,10
"2238","197610170sfo","San Francisco 49ers",33,"New Orleans Saints",3,36,30,TRUE,"10/17/1976",1976,"October","1970s",61,66,9
"2239","197610170was","Washington Redskins",20,"Detroit Lions",7,27,13,TRUE,"10/17/1976",1976,"October","1970s",50,75,11
"2240","197610170crd","St. Louis Cardinals",21,"Dallas Cowboys",17,38,4,TRUE,"10/17/1976",1976,"October","1970s",40,57,12
"2241","197610170sdg","San Diego Chargers",30,"Houston Oilers",27,57,3,TRUE,"10/17/1976",1976,"October","1970s",71,76,10
"2242","197610170buf","Buffalo Bills",13,"Baltimore Colts",31,44,-18,FALSE,"10/17/1976",1976,"October","1970s",41,70,8
"2243","197610170min","Minnesota Vikings",24,"New York Giants",7,31,17,TRUE,"10/17/1976",1976,"October","1970s",37,50,6
"2244","197610170ram","Los Angeles Rams",20,"Chicago Bears",12,32,8,TRUE,"10/17/1976",1976,"October","1970s",68,85,10
"2245","197610170tam","Tampa Bay Buccaneers",10,"Seattle Seahawks",13,23,-3,FALSE,"10/17/1976",1976,"October","1970s",78,78,11
"2246","197610170pit","Pittsburgh Steelers",23,"Cincinnati Bengals",6,29,17,TRUE,"10/17/1976",1976,"October","1970s",41,62,9
"2247","197610170atl","Atlanta Falcons",17,"Cleveland Browns",20,37,-3,FALSE,"10/17/1976",1976,"October","1970s",57,78,11
"2248","197610180nwe","New England Patriots",41,"New York Jets",7,48,34,TRUE,"10/18/1976",1976,"October","1970s",46,44,17
"2249","197610230sfo","San Francisco 49ers",15,"Atlanta Falcons",0,15,15,TRUE,"10/23/1976",1976,"October","1970s",57,71,9
"2250","197610240rai","Oakland Raiders",18,"Green Bay Packers",14,32,4,TRUE,"10/24/1976",1976,"October","1970s",59,74,9
"2251","197610240phi","Philadelphia Eagles",12,"Minnesota Vikings",31,43,-19,FALSE,"10/24/1976",1976,"October","1970s",48,68,8
"2252","197610240oti","Houston Oilers",7,"Cincinnati Bengals",27,34,-20,FALSE,"10/24/1976",1976,"October","1970s",72,NA,NA
"2253","197610240buf","Buffalo Bills",22,"New England Patriots",26,48,-4,FALSE,"10/24/1976",1976,"October","1970s",42,82,8
"2254","197610240nor","New Orleans Saints",10,"Los Angeles Rams",16,26,-6,FALSE,"10/24/1976",1976,"October","1970s",72,NA,NA
"2255","197610240dal","Dallas Cowboys",31,"Chicago Bears",21,52,10,TRUE,"10/24/1976",1976,"October","1970s",71,82,14
"2256","197610240sea","Seattle Seahawks",14,"Detroit Lions",41,55,-27,FALSE,"10/24/1976",1976,"October","1970s",72,NA,NA
"2257","197610240kan","Kansas City Chiefs",26,"Denver Broncos",35,61,-9,FALSE,"10/24/1976",1976,"October","1970s",46,97,13
"2258","197610240cle","Cleveland Browns",21,"San Diego Chargers",17,38,4,TRUE,"10/24/1976",1976,"October","1970s",46,90,12
"2259","197610240nyj","New York Jets",0,"Baltimore Colts",20,20,-20,FALSE,"10/24/1976",1976,"October","1970s",51,53,10
"2260","197610240tam","Tampa Bay Buccaneers",20,"Miami Dolphins",23,43,-3,FALSE,"10/24/1976",1976,"October","1970s",70,65,8
"2261","197610240nyg","New York Giants",0,"Pittsburgh Steelers",27,27,-27,FALSE,"10/24/1976",1976,"October","1970s",51,53,10
"2262","197610250was","Washington Redskins",20,"St. Louis Cardinals",10,30,10,TRUE,"10/25/1976",1976,"October","1970s",55,95,7
"2263","197610310ram","Los Angeles Rams",45,"Seattle Seahawks",6,51,39,TRUE,"10/31/1976",1976,"October","1970s",63,68,7
"2264","197610310pit","Pittsburgh Steelers",23,"San Diego Chargers",0,23,23,TRUE,"10/31/1976",1976,"October","1970s",44,86,14
"2265","197610310chi","Chicago Bears",14,"Minnesota Vikings",13,27,1,TRUE,"10/31/1976",1976,"October","1970s",45,74,17
"2266","197610310rai","Oakland Raiders",19,"Denver Broncos",6,25,13,TRUE,"10/31/1976",1976,"October","1970s",57,84,6
"2267","197610310mia","Miami Dolphins",10,"New England Patriots",3,13,7,TRUE,"10/31/1976",1976,"October","1970s",74,72,9
"2268","197610310crd","St. Louis Cardinals",23,"San Francisco 49ers",20,43,3,TRUE,"10/31/1976",1976,"October","1970s",46,87,13
"2269","197610310nyg","New York Giants",0,"Philadelphia Eagles",10,10,-10,FALSE,"10/31/1976",1976,"October","1970s",55,71,12
"2270","197610310was","Washington Redskins",7,"Dallas Cowboys",20,27,-13,FALSE,"10/31/1976",1976,"October","1970s",55,82,12
"2271","197610310det","Detroit Lions",27,"Green Bay Packers",6,33,21,TRUE,"10/31/1976",1976,"October","1970s",72,NA,NA
"2272","197610310cin","Cincinnati Bengals",21,"Cleveland Browns",6,27,15,TRUE,"10/31/1976",1976,"October","1970s",45,82,14
"2273","197610310buf","Buffalo Bills",14,"New York Jets",19,33,-5,FALSE,"10/31/1976",1976,"October","1970s",42,85,10
"2274","197610310atl","Atlanta Falcons",23,"New Orleans Saints",20,43,3,TRUE,"10/31/1976",1976,"October","1970s",48,74,16
"2275","197610310tam","Tampa Bay Buccaneers",19,"Kansas City Chiefs",28,47,-9,FALSE,"10/31/1976",1976,"October","1970s",70,64,12
"2276","197611010clt","Baltimore Colts",38,"Houston Oilers",14,52,24,TRUE,"11/1/1976",1976,"November","1970s",48,53,15
"2277","197611070gnb","Green Bay Packers",32,"New Orleans Saints",27,59,5,TRUE,"11/7/1976",1976,"November","1970s",32,54,16
"2278","197611070nwe","New England Patriots",20,"Buffalo Bills",10,30,10,TRUE,"11/7/1976",1976,"November","1970s",48,46,15
"2279","197611070kan","Kansas City Chiefs",0,"Pittsburgh Steelers",45,45,-45,FALSE,"11/7/1976",1976,"November","1970s",41,48,14
"2280","197611070nyj","New York Jets",7,"Miami Dolphins",27,34,-20,FALSE,"11/7/1976",1976,"November","1970s",49,40,14
"2281","197611070sea","Seattle Seahawks",30,"Atlanta Falcons",13,43,17,TRUE,"11/7/1976",1976,"November","1970s",72,NA,NA
"2282","197611070min","Minnesota Vikings",31,"Detroit Lions",23,54,8,TRUE,"11/7/1976",1976,"November","1970s",28,42,16
"2283","197611070dal","Dallas Cowboys",9,"New York Giants",3,12,6,TRUE,"11/7/1976",1976,"November","1970s",58,57,12
"2284","197611070sdg","San Diego Chargers",21,"Baltimore Colts",37,58,-16,FALSE,"11/7/1976",1976,"November","1970s",70,41,6
"2285","197611070den","Denver Broncos",48,"Tampa Bay Buccaneers",13,61,35,TRUE,"11/7/1976",1976,"November","1970s",42,54,7
"2286","197611070phi","Philadelphia Eagles",14,"St. Louis Cardinals",17,31,-3,FALSE,"11/7/1976",1976,"November","1970s",46,50,11
"2287","197611070oti","Houston Oilers",7,"Cleveland Browns",21,28,-14,FALSE,"11/7/1976",1976,"November","1970s",72,NA,NA
"2288","197611070sfo","San Francisco 49ers",21,"Washington Redskins",24,45,-3,FALSE,"11/7/1976",1976,"November","1970s",58,71,9
"2289","197611070chi","Chicago Bears",27,"Oakland Raiders",28,55,-1,FALSE,"11/7/1976",1976,"November","1970s",36,49,15
"2290","197611080cin","Cincinnati Bengals",20,"Los Angeles Rams",12,32,8,TRUE,"11/8/1976",1976,"November","1970s",28,47,11
"2291","197611140pit","Pittsburgh Steelers",14,"Miami Dolphins",3,17,11,TRUE,"11/14/1976",1976,"November","1970s",29,60,10
"2292","197611140rai","Oakland Raiders",21,"Kansas City Chiefs",10,31,11,TRUE,"11/14/1976",1976,"November","1970s",59,86,14
"2293","197611140cle","Cleveland Browns",24,"Philadelphia Eagles",3,27,21,TRUE,"11/14/1976",1976,"November","1970s",32,67,11
"2294","197611140ram","Los Angeles Rams",28,"St. Louis Cardinals",30,58,-2,FALSE,"11/14/1976",1976,"November","1970s",62,85,7
"2295","197611140nyj","New York Jets",34,"Tampa Bay Buccaneers",0,34,34,TRUE,"11/14/1976",1976,"November","1970s",42,43,12
"2296","197611140nyg","New York Giants",12,"Washington Redskins",9,21,3,TRUE,"11/14/1976",1976,"November","1970s",42,43,12
"2297","197611140clt","Baltimore Colts",14,"New England Patriots",21,35,-7,FALSE,"11/14/1976",1976,"November","1970s",37,54,11
"2298","197611140atl","Atlanta Falcons",21,"San Francisco 49ers",16,37,5,TRUE,"11/14/1976",1976,"November","1970s",37,67,11
"2299","197611140min","Minnesota Vikings",27,"Seattle Seahawks",21,48,6,TRUE,"11/14/1976",1976,"November","1970s",24,53,8
"2300","197611140cin","Cincinnati Bengals",31,"Houston Oilers",27,58,4,TRUE,"11/14/1976",1976,"November","1970s",26,66,4
"2301","197611140chi","Chicago Bears",24,"Green Bay Packers",13,37,11,TRUE,"11/14/1976",1976,"November","1970s",26,66,8
"2302","197611140sdg","San Diego Chargers",0,"Denver Broncos",17,17,-17,FALSE,"11/14/1976",1976,"November","1970s",64,66,6
"2303","197611140nor","New Orleans Saints",17,"Detroit Lions",16,33,1,TRUE,"11/14/1976",1976,"November","1970s",72,NA,NA
"2304","197611150dal","Dallas Cowboys",17,"Buffalo Bills",10,27,7,TRUE,"11/15/1976",1976,"November","1970s",35,74,2
"2305","197611210phi","Philadelphia Eagles",7,"Oakland Raiders",26,33,-19,FALSE,"11/21/1976",1976,"November","1970s",38,46,10
"2306","197611210nyj","New York Jets",24,"New England Patriots",38,62,-14,FALSE,"11/21/1976",1976,"November","1970s",42,44,14
"2307","197611210sfo","San Francisco 49ers",3,"Los Angeles Rams",23,26,-20,FALSE,"11/21/1976",1976,"November","1970s",56,76,6
"2308","197611210sea","Seattle Seahawks",27,"New Orleans Saints",51,78,-24,FALSE,"11/21/1976",1976,"November","1970s",72,NA,NA
"2309","197611210pit","Pittsburgh Steelers",32,"Houston Oilers",16,48,16,TRUE,"11/21/1976",1976,"November","1970s",32,62,11
"2310","197611210det","Detroit Lions",14,"Chicago Bears",10,24,4,TRUE,"11/21/1976",1976,"November","1970s",72,NA,NA
"2311","197611210gnb","Green Bay Packers",10,"Minnesota Vikings",17,27,-7,FALSE,"11/21/1976",1976,"November","1970s",33,66,12
"2312","197611210den","Denver Broncos",14,"New York Giants",13,27,1,TRUE,"11/21/1976",1976,"November","1970s",30,44,9
"2313","197611210buf","Buffalo Bills",13,"San Diego Chargers",34,47,-21,FALSE,"11/21/1976",1976,"November","1970s",28,80,8
"2314","197611210kan","Kansas City Chiefs",24,"Cincinnati Bengals",27,51,-3,FALSE,"11/21/1976",1976,"November","1970s",36,49,16
"2315","197611210crd","St. Louis Cardinals",10,"Washington Redskins",16,26,-6,FALSE,"11/21/1976",1976,"November","1970s",39,59,17
"2316","197611210atl","Atlanta Falcons",17,"Dallas Cowboys",10,27,7,TRUE,"11/21/1976",1976,"November","1970s",47,58,14
"2317","197611210tam","Tampa Bay Buccaneers",7,"Cleveland Browns",24,31,-17,FALSE,"11/21/1976",1976,"November","1970s",69,86,10
"2318","197611220mia","Miami Dolphins",16,"Baltimore Colts",17,33,-1,FALSE,"11/22/1976",1976,"November","1970s",66,84,14
"2319","197611250det","Detroit Lions",27,"Buffalo Bills",14,41,13,TRUE,"11/25/1976",1976,"November","1970s",72,NA,NA
"2320","197611250dal","Dallas Cowboys",19,"St. Louis Cardinals",14,33,5,TRUE,"11/25/1976",1976,"November","1970s",59,85,15
"2321","197611280cin","Cincinnati Bengals",3,"Pittsburgh Steelers",7,10,-4,FALSE,"11/28/1976",1976,"November","1970s",32,78,12
"2322","197611280clt","Baltimore Colts",33,"New York Jets",16,49,17,TRUE,"11/28/1976",1976,"November","1970s",53,91,5
"2323","197611280was","Washington Redskins",24,"Philadelphia Eagles",0,24,24,TRUE,"11/28/1976",1976,"November","1970s",54,98,8
"2324","197611280gnb","Green Bay Packers",10,"Chicago Bears",16,26,-6,FALSE,"11/28/1976",1976,"November","1970s",2,64,15
"2325","197611280ram","Los Angeles Rams",33,"New Orleans Saints",14,47,19,TRUE,"11/28/1976",1976,"November","1970s",53,22,6
"2326","197611280cle","Cleveland Browns",17,"Miami Dolphins",13,30,4,TRUE,"11/28/1976",1976,"November","1970s",33,79,10
"2327","197611280rai","Oakland Raiders",49,"Tampa Bay Buccaneers",16,65,33,TRUE,"11/28/1976",1976,"November","1970s",51,27,10
"2328","197611280sdg","San Diego Chargers",20,"Kansas City Chiefs",23,43,-3,FALSE,"11/28/1976",1976,"November","1970s",53,25,5
"2329","197611280oti","Houston Oilers",20,"Atlanta Falcons",14,34,6,TRUE,"11/28/1976",1976,"November","1970s",72,NA,NA
"2330","197611280nwe","New England Patriots",38,"Denver Broncos",14,52,24,TRUE,"11/28/1976",1976,"November","1970s",54,82,12
"2331","197611280nyg","New York Giants",28,"Seattle Seahawks",16,44,12,TRUE,"11/28/1976",1976,"November","1970s",51,87,9
"2332","197611290sfo","San Francisco 49ers",20,"Minnesota Vikings",16,36,4,TRUE,"11/29/1976",1976,"November","1970s",48,46,6
"2333","197612040ram","Los Angeles Rams",59,"Atlanta Falcons",0,59,59,TRUE,"12/4/1976",1976,"December","1970s",59,80,6
"2334","197612040crd","St. Louis Cardinals",24,"Baltimore Colts",17,41,7,TRUE,"12/4/1976",1976,"December","1970s",28,84,8
"2335","197612050sdg","San Diego Chargers",13,"San Francisco 49ers",7,20,6,TRUE,"12/5/1976",1976,"December","1970s",62,65,8
"2336","197612050mia","Miami Dolphins",45,"Buffalo Bills",27,72,18,TRUE,"12/5/1976",1976,"December","1970s",68,87,16
"2337","197612050nyj","New York Jets",16,"Washington Redskins",37,53,-21,FALSE,"12/5/1976",1976,"December","1970s",32,55,8
"2338","197612050sea","Seattle Seahawks",7,"Chicago Bears",34,41,-27,FALSE,"12/5/1976",1976,"December","1970s",72,NA,NA
"2339","197612050pit","Pittsburgh Steelers",42,"Tampa Bay Buccaneers",0,42,42,TRUE,"12/5/1976",1976,"December","1970s",23,69,5
"2340","197612050den","Denver Broncos",17,"Kansas City Chiefs",16,33,1,TRUE,"12/5/1976",1976,"December","1970s",28,68,9
"2341","197612050cle","Cleveland Browns",13,"Houston Oilers",10,23,3,TRUE,"12/5/1976",1976,"December","1970s",18,80,7
"2342","197612050min","Minnesota Vikings",20,"Green Bay Packers",9,29,11,TRUE,"12/5/1976",1976,"December","1970s",18,71,7
"2343","197612050phi","Philadelphia Eagles",7,"Dallas Cowboys",26,33,-19,FALSE,"12/5/1976",1976,"December","1970s",30,62,4
"2344","197612050nyg","New York Giants",24,"Detroit Lions",10,34,14,TRUE,"12/5/1976",1976,"December","1970s",32,55,8
"2345","197612050nwe","New England Patriots",27,"New Orleans Saints",6,33,21,TRUE,"12/5/1976",1976,"December","1970s",26,72,9
"2346","197612060rai","Oakland Raiders",35,"Cincinnati Bengals",20,55,15,TRUE,"12/6/1976",1976,"December","1970s",52,64,6
"2347","197612110mia","Miami Dolphins",7,"Minnesota Vikings",29,36,-22,FALSE,"12/11/1976",1976,"December","1970s",77,80,21
"2348","197612110oti","Houston Oilers",0,"Pittsburgh Steelers",21,21,-21,FALSE,"12/11/1976",1976,"December","1970s",72,NA,NA
"2349","197612110det","Detroit Lions",17,"Los Angeles Rams",20,37,-3,FALSE,"12/11/1976",1976,"December","1970s",72,NA,NA
"2350","197612120clt","Baltimore Colts",58,"Buffalo Bills",20,78,38,TRUE,"12/12/1976",1976,"December","1970s",41,89,4
"2351","197612120rai","Oakland Raiders",24,"San Diego Chargers",0,24,24,TRUE,"12/12/1976",1976,"December","1970s",48,71,5
"2352","197612120atl","Atlanta Falcons",20,"Green Bay Packers",24,44,-4,FALSE,"12/12/1976",1976,"December","1970s",52,95,7
"2353","197612120nor","New Orleans Saints",7,"San Francisco 49ers",27,34,-20,FALSE,"12/12/1976",1976,"December","1970s",72,NA,NA
"2354","197612120dal","Dallas Cowboys",14,"Washington Redskins",27,41,-13,FALSE,"12/12/1976",1976,"December","1970s",38,78,7
"2355","197612120kan","Kansas City Chiefs",39,"Cleveland Browns",14,53,25,TRUE,"12/12/1976",1976,"December","1970s",30,69,14
"2356","197612120phi","Philadelphia Eagles",27,"Seattle Seahawks",10,37,17,TRUE,"12/12/1976",1976,"December","1970s",41,80,4
"2357","197612120nyg","New York Giants",14,"St. Louis Cardinals",17,31,-3,FALSE,"12/12/1976",1976,"December","1970s",40,70,8
"2358","197612120chi","Chicago Bears",14,"Denver Broncos",28,42,-14,FALSE,"12/12/1976",1976,"December","1970s",23,71,13
"2359","197612120tam","Tampa Bay Buccaneers",14,"New England Patriots",31,45,-17,FALSE,"12/12/1976",1976,"December","1970s",73,82,8
"2360","197612120nyj","New York Jets",3,"Cincinnati Bengals",42,45,-39,FALSE,"12/12/1976",1976,"December","1970s",40,70,8
"2361","197612180rai","Oakland Raiders",24,"New England Patriots",21,45,3,TRUE,"12/18/1976",1976,"December","1970s",50,61,7
"2362","197612180min","Minnesota Vikings",35,"Washington Redskins",20,55,15,TRUE,"12/18/1976",1976,"December","1970s",31,64,7
"2363","197612190clt","Baltimore Colts",14,"Pittsburgh Steelers",40,54,-26,FALSE,"12/19/1976",1976,"December","1970s",36,62,6
"2364","197612190dal","Dallas Cowboys",12,"Los Angeles Rams",14,26,-2,FALSE,"12/19/1976",1976,"December","1970s",62,76,15
"2365","197612260min","Minnesota Vikings",24,"Los Angeles Rams",13,37,11,TRUE,"12/26/1976",1976,"December","1970s",19,59,12
"2366","197612260rai","Oakland Raiders",24,"Pittsburgh Steelers",7,31,17,TRUE,"12/26/1976",1976,"December","1970s",47,70,7
"2367","197701090min","Minnesota Vikings",14,"Oakland Raiders",32,46,-18,FALSE,"1/9/1977",1977,"January","1970s",52,59,6
"2368","197709180atl","Atlanta Falcons",17,"Los Angeles Rams",6,23,11,TRUE,"9/18/1977",1977,"September","1970s",74,81,6
"2369","197709180cin","Cincinnati Bengals",3,"Cleveland Browns",13,16,-10,FALSE,"9/18/1977",1977,"September","1970s",74,82,12
"2370","197709180rai","Oakland Raiders",24,"San Diego Chargers",0,24,24,TRUE,"9/18/1977",1977,"September","1970s",66,71,11
"2371","197709180chi","Chicago Bears",30,"Detroit Lions",20,50,10,TRUE,"9/18/1977",1977,"September","1970s",73,80,8
"2372","197709180phi","Philadelphia Eagles",13,"Tampa Bay Buccaneers",3,16,10,TRUE,"9/18/1977",1977,"September","1970s",74,75,8
"2373","197709180nor","New Orleans Saints",20,"Green Bay Packers",24,44,-4,FALSE,"9/18/1977",1977,"September","1970s",72,NA,NA
"2374","197709180buf","Buffalo Bills",0,"Miami Dolphins",13,13,-13,FALSE,"9/18/1977",1977,"September","1970s",68,94,19
"2375","197709180nwe","New England Patriots",21,"Kansas City Chiefs",17,38,4,TRUE,"9/18/1977",1977,"September","1970s",66,88,7
"2376","197709180min","Minnesota Vikings",10,"Dallas Cowboys",16,26,-6,FALSE,"9/18/1977",1977,"September","1970s",68,86,12
"2377","197709180oti","Houston Oilers",20,"New York Jets",0,20,20,TRUE,"9/18/1977",1977,"September","1970s",72,NA,NA
"2378","197709180nyg","New York Giants",20,"Washington Redskins",17,37,3,TRUE,"9/18/1977",1977,"September","1970s",74,74,10
"2379","197709180den","Denver Broncos",7,"St. Louis Cardinals",0,7,7,TRUE,"9/18/1977",1977,"September","1970s",60,24,10
"2380","197709180sea","Seattle Seahawks",14,"Baltimore Colts",29,43,-15,FALSE,"9/18/1977",1977,"September","1970s",72,NA,NA
"2381","197709190pit","Pittsburgh Steelers",27,"San Francisco 49ers",0,27,27,TRUE,"9/19/1977",1977,"September","1970s",69,72,9
"2382","197709240tam","Tampa Bay Buccaneers",3,"Minnesota Vikings",9,12,-6,FALSE,"9/24/1977",1977,"September","1970s",80,75,5
"2383","197709250cin","Cincinnati Bengals",42,"Seattle Seahawks",20,62,22,TRUE,"9/25/1977",1977,"September","1970s",68,84,9
"2384","197709250crd","St. Louis Cardinals",16,"Chicago Bears",13,29,3,TRUE,"9/25/1977",1977,"September","1970s",68,86,10
"2385","197709250nyj","New York Jets",12,"Baltimore Colts",20,32,-8,FALSE,"9/25/1977",1977,"September","1970s",55,95,17
"2386","197709250was","Washington Redskins",10,"Atlanta Falcons",6,16,4,TRUE,"9/25/1977",1977,"September","1970s",74,85,10
"2387","197709250pit","Pittsburgh Steelers",7,"Oakland Raiders",16,23,-9,FALSE,"9/25/1977",1977,"September","1970s",67,69,9
"2388","197709250ram","Los Angeles Rams",20,"Philadelphia Eagles",0,20,20,TRUE,"9/25/1977",1977,"September","1970s",69,78,10
"2389","197709250gnb","Green Bay Packers",10,"Houston Oilers",16,26,-6,FALSE,"9/25/1977",1977,"September","1970s",62,74,15
"2390","197709250det","Detroit Lions",23,"New Orleans Saints",19,42,4,TRUE,"9/25/1977",1977,"September","1970s",72,NA,NA
"2391","197709250kan","Kansas City Chiefs",7,"San Diego Chargers",23,30,-16,FALSE,"9/25/1977",1977,"September","1970s",66,71,10
"2392","197709250dal","Dallas Cowboys",41,"New York Giants",21,62,20,TRUE,"9/25/1977",1977,"September","1970s",88,58,16
"2393","197709250sfo","San Francisco 49ers",15,"Miami Dolphins",19,34,-4,FALSE,"9/25/1977",1977,"September","1970s",62,58,10
"2394","197709250den","Denver Broncos",26,"Buffalo Bills",6,32,20,TRUE,"9/25/1977",1977,"September","1970s",66,21,11
"2395","197709260cle","Cleveland Browns",30,"New England Patriots",27,57,3,TRUE,"9/26/1977",1977,"September","1970s",71,68,17
"2396","197710020chi","Chicago Bears",24,"New Orleans Saints",42,66,-18,FALSE,"10/2/1977",1977,"October","1970s",56,66,16
"2397","197710020dal","Dallas Cowboys",23,"Tampa Bay Buccaneers",7,30,16,TRUE,"10/2/1977",1977,"October","1970s",74,63,15
"2398","197710020cle","Cleveland Browns",14,"Pittsburgh Steelers",28,42,-14,FALSE,"10/2/1977",1977,"October","1970s",55,83,13
"2399","197710020sdg","San Diego Chargers",24,"Cincinnati Bengals",3,27,21,TRUE,"10/2/1977",1977,"October","1970s",70,82,6
"2400","197710020sea","Seattle Seahawks",13,"Denver Broncos",24,37,-11,FALSE,"10/2/1977",1977,"October","1970s",72,NA,NA
"2401","197710020nyj","New York Jets",30,"New England Patriots",27,57,3,TRUE,"10/2/1977",1977,"October","1970s",67,88,12
"2402","197710020was","Washington Redskins",24,"St. Louis Cardinals",14,38,10,TRUE,"10/2/1977",1977,"October","1970s",74,66,15
"2403","197710020clt","Baltimore Colts",17,"Buffalo Bills",14,31,3,TRUE,"10/2/1977",1977,"October","1970s",72,73,14
"2404","197710020atl","Atlanta Falcons",17,"New York Giants",3,20,14,TRUE,"10/2/1977",1977,"October","1970s",76,83,15
"2405","197710020min","Minnesota Vikings",19,"Green Bay Packers",7,26,12,TRUE,"10/2/1977",1977,"October","1970s",47,62,10
"2406","197710020det","Detroit Lions",17,"Philadelphia Eagles",13,30,4,TRUE,"10/2/1977",1977,"October","1970s",72,NA,NA
"2407","197710020mia","Miami Dolphins",27,"Houston Oilers",7,34,20,TRUE,"10/2/1977",1977,"October","1970s",83,73,8
"2408","197710020ram","Los Angeles Rams",34,"San Francisco 49ers",14,48,20,TRUE,"10/2/1977",1977,"October","1970s",66,86,8
"2409","197710030kan","Kansas City Chiefs",28,"Oakland Raiders",37,65,-9,FALSE,"10/3/1977",1977,"October","1970s",53,68,6
"2410","197710090sfo","San Francisco 49ers",0,"Atlanta Falcons",7,7,-7,FALSE,"10/9/1977",1977,"October","1970s",57,67,14
"2411","197710090nyg","New York Giants",10,"Philadelphia Eagles",28,38,-18,FALSE,"10/9/1977",1977,"October","1970s",61,92,15
"2412","197710090den","Denver Broncos",23,"Kansas City Chiefs",7,30,16,TRUE,"10/9/1977",1977,"October","1970s",51,23,7
"2413","197710090tam","Tampa Bay Buccaneers",0,"Washington Redskins",10,10,-10,FALSE,"10/9/1977",1977,"October","1970s",77,76,7
"2414","197710090clt","Baltimore Colts",45,"Miami Dolphins",28,73,17,TRUE,"10/9/1977",1977,"October","1970s",63,82,13
"2415","197710090min","Minnesota Vikings",14,"Detroit Lions",7,21,7,TRUE,"10/9/1977",1977,"October","1970s",43,82,13
"2416","197710090cle","Cleveland Browns",10,"Oakland Raiders",26,36,-16,FALSE,"10/9/1977",1977,"October","1970s",52,82,16
"2417","197710090buf","Buffalo Bills",19,"New York Jets",24,43,-5,FALSE,"10/9/1977",1977,"October","1970s",54,79,16
"2418","197710090nor","New Orleans Saints",0,"San Diego Chargers",14,14,-14,FALSE,"10/9/1977",1977,"October","1970s",72,NA,NA
"2419","197710090crd","St. Louis Cardinals",24,"Dallas Cowboys",30,54,-6,FALSE,"10/9/1977",1977,"October","1970s",49,73,13
"2420","197710090gnb","Green Bay Packers",7,"Cincinnati Bengals",17,24,-10,FALSE,"10/9/1977",1977,"October","1970s",47,72,19
"2421","197710090oti","Houston Oilers",27,"Pittsburgh Steelers",10,37,17,TRUE,"10/9/1977",1977,"October","1970s",72,NA,NA
"2422","197710090nwe","New England Patriots",31,"Seattle Seahawks",0,31,31,TRUE,"10/9/1977",1977,"October","1970s",58,92,19
"2423","197710100chi","Chicago Bears",24,"Los Angeles Rams",23,47,1,TRUE,"10/10/1977",1977,"October","1970s",52,68,13
"2424","197710160kan","Kansas City Chiefs",6,"Baltimore Colts",17,23,-11,FALSE,"10/16/1977",1977,"October","1970s",46,72,8
"2425","197710160phi","Philadelphia Eagles",17,"St. Louis Cardinals",21,38,-4,FALSE,"10/16/1977",1977,"October","1970s",55,79,9
"2426","197710160oti","Houston Oilers",23,"Cleveland Browns",24,47,-1,FALSE,"10/16/1977",1977,"October","1970s",72,NA,NA
"2427","197710160min","Minnesota Vikings",22,"Chicago Bears",16,38,6,TRUE,"10/16/1977",1977,"October","1970s",41,62,10
"2428","197710160buf","Buffalo Bills",3,"Atlanta Falcons",0,3,3,TRUE,"10/16/1977",1977,"October","1970s",45,84,17
"2429","197710160nyg","New York Giants",20,"San Francisco 49ers",17,37,3,TRUE,"10/16/1977",1977,"October","1970s",58,73,13
"2430","197710160ram","Los Angeles Rams",14,"New Orleans Saints",7,21,7,TRUE,"10/16/1977",1977,"October","1970s",65,88,8
"2431","197710160sdg","San Diego Chargers",20,"New England Patriots",24,44,-4,FALSE,"10/16/1977",1977,"October","1970s",66,86,8
"2432","197710160dal","Dallas Cowboys",34,"Washington Redskins",16,50,18,TRUE,"10/16/1977",1977,"October","1970s",56,36,8
"2433","197710160det","Detroit Lions",10,"Green Bay Packers",6,16,4,TRUE,"10/16/1977",1977,"October","1970s",72,NA,NA
"2434","197710160mia","Miami Dolphins",21,"New York Jets",17,38,4,TRUE,"10/16/1977",1977,"October","1970s",73,64,10
"2435","197710160sea","Seattle Seahawks",30,"Tampa Bay Buccaneers",23,53,7,TRUE,"10/16/1977",1977,"October","1970s",72,NA,NA
"2436","197710160rai","Oakland Raiders",7,"Denver Broncos",30,37,-23,FALSE,"10/16/1977",1977,"October","1970s",60,80,9
"2437","197710170pit","Pittsburgh Steelers",20,"Cincinnati Bengals",14,34,6,TRUE,"10/17/1977",1977,"October","1970s",39,65,18
"2438","197710230was","Washington Redskins",6,"New York Giants",17,23,-11,FALSE,"10/23/1977",1977,"October","1970s",60,47,11
"2439","197710230sfo","San Francisco 49ers",28,"Detroit Lions",7,35,21,TRUE,"10/23/1977",1977,"October","1970s",58,66,12
"2440","197710230phi","Philadelphia Eagles",10,"Dallas Cowboys",16,26,-6,FALSE,"10/23/1977",1977,"October","1970s",53,53,11
"2441","197710230tam","Tampa Bay Buccaneers",0,"Green Bay Packers",13,13,-13,FALSE,"10/23/1977",1977,"October","1970s",73,76,11
"2442","197710230crd","St. Louis Cardinals",49,"New Orleans Saints",31,80,18,TRUE,"10/23/1977",1977,"October","1970s",62,81,11
"2443","197710230sdg","San Diego Chargers",16,"Kansas City Chiefs",21,37,-5,FALSE,"10/23/1977",1977,"October","1970s",69,82,7
"2444","197710230mia","Miami Dolphins",31,"Seattle Seahawks",13,44,18,TRUE,"10/23/1977",1977,"October","1970s",77,85,14
"2445","197710230nwe","New England Patriots",17,"Baltimore Colts",3,20,14,TRUE,"10/23/1977",1977,"October","1970s",50,45,15
"2446","197710230nyj","New York Jets",27,"Oakland Raiders",28,55,-1,FALSE,"10/23/1977",1977,"October","1970s",52,54,12
"2447","197710230chi","Chicago Bears",10,"Atlanta Falcons",16,26,-6,FALSE,"10/23/1977",1977,"October","1970s",49,76,16
"2448","197710230buf","Buffalo Bills",16,"Cleveland Browns",27,43,-11,FALSE,"10/23/1977",1977,"October","1970s",42,68,11
"2449","197710230cin","Cincinnati Bengals",13,"Denver Broncos",24,37,-11,FALSE,"10/23/1977",1977,"October","1970s",58,75,8
"2450","197710230pit","Pittsburgh Steelers",27,"Houston Oilers",10,37,17,TRUE,"10/23/1977",1977,"October","1970s",50,61,12
"2451","197710240ram","Los Angeles Rams",35,"Minnesota Vikings",3,38,32,TRUE,"10/24/1977",1977,"October","1970s",64,93,7
"2452","197710300cle","Cleveland Browns",44,"Kansas City Chiefs",7,51,37,TRUE,"10/30/1977",1977,"October","1970s",51,76,9
"2453","197710300was","Washington Redskins",23,"Philadelphia Eagles",17,40,6,TRUE,"10/30/1977",1977,"October","1970s",56,50,9
"2454","197710300dal","Dallas Cowboys",37,"Detroit Lions",0,37,37,TRUE,"10/30/1977",1977,"October","1970s",70,82,11
"2455","197710300nor","New Orleans Saints",27,"Los Angeles Rams",26,53,1,TRUE,"10/30/1977",1977,"October","1970s",72,NA,NA
"2456","197710300nwe","New England Patriots",24,"New York Jets",13,37,11,TRUE,"10/30/1977",1977,"October","1970s",48,68,12
"2457","197710300gnb","Green Bay Packers",0,"Chicago Bears",26,26,-26,FALSE,"10/30/1977",1977,"October","1970s",45,87,10
"2458","197710300cin","Cincinnati Bengals",13,"Houston Oilers",10,23,3,TRUE,"10/30/1977",1977,"October","1970s",52,68,9
"2459","197710300den","Denver Broncos",14,"Oakland Raiders",24,38,-10,FALSE,"10/30/1977",1977,"October","1970s",53,32,9
"2460","197710300sea","Seattle Seahawks",56,"Buffalo Bills",17,73,39,TRUE,"10/30/1977",1977,"October","1970s",72,NA,NA
"2461","197710300clt","Baltimore Colts",31,"Pittsburgh Steelers",21,52,10,TRUE,"10/30/1977",1977,"October","1970s",53,54,8
"2462","197710300atl","Atlanta Falcons",7,"Minnesota Vikings",14,21,-7,FALSE,"10/30/1977",1977,"October","1970s",60,81,12
"2463","197710300mia","Miami Dolphins",13,"San Diego Chargers",14,27,-1,FALSE,"10/30/1977",1977,"October","1970s",75,74,6
"2464","197710300sfo","San Francisco 49ers",20,"Tampa Bay Buccaneers",10,30,10,TRUE,"10/30/1977",1977,"October","1970s",59,68,11
"2465","197710310crd","St. Louis Cardinals",28,"New York Giants",0,28,28,TRUE,"10/31/1977",1977,"October","1970s",62,84,14
"2466","197711060den","Denver Broncos",21,"Pittsburgh Steelers",7,28,14,TRUE,"11/6/1977",1977,"November","1970s",52,45,7
"2467","197711060cle","Cleveland Browns",7,"Cincinnati Bengals",10,17,-3,FALSE,"11/6/1977",1977,"November","1970s",67,80,11
"2468","197711060phi","Philadelphia Eagles",28,"New Orleans Saints",7,35,21,TRUE,"11/6/1977",1977,"November","1970s",55,94,15
"2469","197711060atl","Atlanta Falcons",3,"San Francisco 49ers",10,13,-7,FALSE,"11/6/1977",1977,"November","1970s",62,92,11
"2470","197711060oti","Houston Oilers",47,"Chicago Bears",0,47,47,TRUE,"11/6/1977",1977,"November","1970s",72,NA,NA
"2471","197711060det","Detroit Lions",20,"San Diego Chargers",0,20,20,TRUE,"11/6/1977",1977,"November","1970s",72,NA,NA
"2472","197711060nyj","New York Jets",10,"Miami Dolphins",14,24,-4,FALSE,"11/6/1977",1977,"November","1970s",54,86,16
"2473","197711060kan","Kansas City Chiefs",20,"Green Bay Packers",10,30,10,TRUE,"11/6/1977",1977,"November","1970s",56,91,8
"2474","197711060ram","Los Angeles Rams",31,"Tampa Bay Buccaneers",0,31,31,TRUE,"11/6/1977",1977,"November","1970s",62,50,17
"2475","197711060nwe","New England Patriots",14,"Buffalo Bills",24,38,-10,FALSE,"11/6/1977",1977,"November","1970s",54,78,10
"2476","197711060min","Minnesota Vikings",7,"St. Louis Cardinals",27,34,-20,FALSE,"11/6/1977",1977,"November","1970s",49,81,8
"2477","197711060rai","Oakland Raiders",44,"Seattle Seahawks",7,51,37,TRUE,"11/6/1977",1977,"November","1970s",58,61,14
"2478","197711060nyg","New York Giants",10,"Dallas Cowboys",24,34,-14,FALSE,"11/6/1977",1977,"November","1970s",54,86,16
"2479","197711070clt","Baltimore Colts",10,"Washington Redskins",3,13,7,TRUE,"11/7/1977",1977,"November","1970s",61,93,16
"2480","197711130gnb","Green Bay Packers",6,"Los Angeles Rams",24,30,-18,FALSE,"11/13/1977",1977,"November","1970s",32,64,8
"2481","197711130rai","Oakland Raiders",34,"Houston Oilers",29,63,5,TRUE,"11/13/1977",1977,"November","1970s",56,76,7
"2482","197711130buf","Buffalo Bills",13,"Baltimore Colts",31,44,-18,FALSE,"11/13/1977",1977,"November","1970s",29,82,13
"2483","197711130mia","Miami Dolphins",17,"New England Patriots",5,22,12,TRUE,"11/13/1977",1977,"November","1970s",64,54,15
"2484","197711130tam","Tampa Bay Buccaneers",0,"New York Giants",10,10,-10,FALSE,"11/13/1977",1977,"November","1970s",53,51,9
"2485","197711130pit","Pittsburgh Steelers",35,"Cleveland Browns",31,66,4,TRUE,"11/13/1977",1977,"November","1970s",30,81,13
"2486","197711130phi","Philadelphia Eagles",14,"Washington Redskins",17,31,-3,FALSE,"11/13/1977",1977,"November","1970s",34,61,15
"2487","197711130atl","Atlanta Falcons",17,"Detroit Lions",6,23,11,TRUE,"11/13/1977",1977,"November","1970s",39,38,7
"2488","197711130sdg","San Diego Chargers",14,"Denver Broncos",17,31,-3,FALSE,"11/13/1977",1977,"November","1970s",64,73,7
"2489","197711130min","Minnesota Vikings",42,"Cincinnati Bengals",10,52,32,TRUE,"11/13/1977",1977,"November","1970s",30,66,11
"2490","197711130nor","New Orleans Saints",7,"San Francisco 49ers",10,17,-3,FALSE,"11/13/1977",1977,"November","1970s",72,NA,NA
"2491","197711130chi","Chicago Bears",28,"Kansas City Chiefs",27,55,1,TRUE,"11/13/1977",1977,"November","1970s",32,66,10
"2492","197711130nyj","New York Jets",0,"Seattle Seahawks",17,17,-17,FALSE,"11/13/1977",1977,"November","1970s",37,60,16
"2493","197711140dal","Dallas Cowboys",17,"St. Louis Cardinals",24,41,-7,FALSE,"11/14/1977",1977,"November","1970s",61,73,12
"2494","197711200sfo","San Francisco 49ers",10,"Los Angeles Rams",23,33,-13,FALSE,"11/20/1977",1977,"November","1970s",45,66,8
"2495","197711200clt","Baltimore Colts",33,"New York Jets",12,45,21,TRUE,"11/20/1977",1977,"November","1970s",43,53,6
"2496","197711200crd","St. Louis Cardinals",21,"Philadelphia Eagles",16,37,5,TRUE,"11/20/1977",1977,"November","1970s",58,86,17
"2497","197711200nor","New Orleans Saints",21,"Atlanta Falcons",20,41,1,TRUE,"11/20/1977",1977,"November","1970s",72,NA,NA
"2498","197711200kan","Kansas City Chiefs",7,"Denver Broncos",14,21,-7,FALSE,"11/20/1977",1977,"November","1970s",56,68,20
"2499","197711200sea","Seattle Seahawks",10,"Houston Oilers",22,32,-12,FALSE,"11/20/1977",1977,"November","1970s",72,NA,NA
"2500","197711200pit","Pittsburgh Steelers",28,"Dallas Cowboys",13,41,15,TRUE,"11/20/1977",1977,"November","1970s",48,48,9
"2501","197711200chi","Chicago Bears",10,"Minnesota Vikings",7,17,3,TRUE,"11/20/1977",1977,"November","1970s",48,82,21
"2502","197711200sdg","San Diego Chargers",12,"Oakland Raiders",7,19,5,TRUE,"11/20/1977",1977,"November","1970s",59,56,9
"2503","197711200cin","Cincinnati Bengals",23,"Miami Dolphins",17,40,6,TRUE,"11/20/1977",1977,"November","1970s",47,64,13
"2504","197711200det","Detroit Lions",16,"Tampa Bay Buccaneers",7,23,9,TRUE,"11/20/1977",1977,"November","1970s",72,NA,NA
"2505","197711200buf","Buffalo Bills",7,"New England Patriots",20,27,-13,FALSE,"11/20/1977",1977,"November","1970s",39,68,12
"2506","197711200nyg","New York Giants",7,"Cleveland Browns",21,28,-14,FALSE,"11/20/1977",1977,"November","1970s",42,50,10
"2507","197711210was","Washington Redskins",10,"Green Bay Packers",9,19,1,TRUE,"11/21/1977",1977,"November","1970s",50,77,11
"2508","197711240crd","St. Louis Cardinals",14,"Miami Dolphins",55,69,-41,FALSE,"11/24/1977",1977,"November","1970s",39,95,8
"2509","197711240det","Detroit Lions",14,"Chicago Bears",31,45,-17,FALSE,"11/24/1977",1977,"November","1970s",72,NA,NA
"2510","197711270sea","Seattle Seahawks",28,"San Diego Chargers",30,58,-2,FALSE,"11/27/1977",1977,"November","1970s",72,NA,NA
"2511","197711270sfo","San Francisco 49ers",20,"New Orleans Saints",17,37,3,TRUE,"11/27/1977",1977,"November","1970s",54,91,12
"2512","197711270nwe","New England Patriots",14,"Philadelphia Eagles",6,20,8,TRUE,"11/27/1977",1977,"November","1970s",34,50,27
"2513","197711270tam","Tampa Bay Buccaneers",0,"Atlanta Falcons",17,17,-17,FALSE,"11/27/1977",1977,"November","1970s",53,62,10
"2514","197711270was","Washington Redskins",7,"Dallas Cowboys",14,21,-7,FALSE,"11/27/1977",1977,"November","1970s",31,41,16
"2515","197711270den","Denver Broncos",27,"Baltimore Colts",13,40,14,TRUE,"11/27/1977",1977,"November","1970s",40,48,15
"2516","197711270cin","Cincinnati Bengals",30,"New York Giants",13,43,17,TRUE,"11/27/1977",1977,"November","1970s",20,79,10
"2517","197711270nyj","New York Jets",20,"Pittsburgh Steelers",23,43,-3,FALSE,"11/27/1977",1977,"November","1970s",31,49,22
"2518","197711270cle","Cleveland Browns",0,"Los Angeles Rams",9,9,-9,FALSE,"11/27/1977",1977,"November","1970s",21,66,15
"2519","197711270gnb","Green Bay Packers",6,"Minnesota Vikings",13,19,-7,FALSE,"11/27/1977",1977,"November","1970s",10,71,10
"2520","197711270oti","Houston Oilers",34,"Kansas City Chiefs",20,54,14,TRUE,"11/27/1977",1977,"November","1970s",72,NA,NA
"2521","197711280rai","Oakland Raiders",34,"Buffalo Bills",13,47,21,TRUE,"11/28/1977",1977,"November","1970s",56,90,6
"2522","197712040tam","Tampa Bay Buccaneers",0,"Chicago Bears",10,10,-10,FALSE,"12/4/1977",1977,"December","1970s",60,76,5
"2523","197712040atl","Atlanta Falcons",10,"New England Patriots",16,26,-6,FALSE,"12/4/1977",1977,"December","1970s",60,76,15
"2524","197712040nyg","New York Giants",27,"St. Louis Cardinals",7,34,20,TRUE,"12/4/1977",1977,"December","1970s",40,54,15
"2525","197712040buf","Buffalo Bills",0,"Washington Redskins",10,10,-10,FALSE,"12/4/1977",1977,"December","1970s",29,63,15
"2526","197712040dal","Dallas Cowboys",24,"Philadelphia Eagles",14,38,10,TRUE,"12/4/1977",1977,"December","1970s",59,64,12
"2527","197712040sdg","San Diego Chargers",37,"Cleveland Browns",14,51,23,TRUE,"12/4/1977",1977,"December","1970s",59,82,6
"2528","197712040kan","Kansas City Chiefs",7,"Cincinnati Bengals",27,34,-20,FALSE,"12/4/1977",1977,"December","1970s",31,90,10
"2529","197712040ram","Los Angeles Rams",20,"Oakland Raiders",14,34,6,TRUE,"12/4/1977",1977,"December","1970s",57,91,6
"2530","197712040pit","Pittsburgh Steelers",30,"Seattle Seahawks",20,50,10,TRUE,"12/4/1977",1977,"December","1970s",33,62,7
"2531","197712040min","Minnesota Vikings",28,"San Francisco 49ers",27,55,1,TRUE,"12/4/1977",1977,"December","1970s",12,71,11
"2532","197712040nor","New Orleans Saints",13,"New York Jets",16,29,-3,FALSE,"12/4/1977",1977,"December","1970s",72,NA,NA
"2533","197712040oti","Houston Oilers",14,"Denver Broncos",24,38,-10,FALSE,"12/4/1977",1977,"December","1970s",72,NA,NA
"2534","197712040gnb","Green Bay Packers",10,"Detroit Lions",9,19,1,TRUE,"12/4/1977",1977,"December","1970s",6,70,9
"2535","197712050mia","Miami Dolphins",17,"Baltimore Colts",6,23,11,TRUE,"12/5/1977",1977,"December","1970s",79,78,10
"2536","197712100cin","Cincinnati Bengals",17,"Pittsburgh Steelers",10,27,7,TRUE,"12/10/1977",1977,"December","1970s",0,86,12
"2537","197712100crd","St. Louis Cardinals",20,"Washington Redskins",26,46,-6,FALSE,"12/10/1977",1977,"December","1970s",6,69,12
"2538","197712110chi","Chicago Bears",21,"Green Bay Packers",10,31,11,TRUE,"12/11/1977",1977,"December","1970s",3,76,8
"2539","197712110clt","Baltimore Colts",10,"Detroit Lions",13,23,-3,FALSE,"12/11/1977",1977,"December","1970s",22,45,11
"2540","197712110nyj","New York Jets",10,"Buffalo Bills",14,24,-4,FALSE,"12/11/1977",1977,"December","1970s",20,45,17
"2541","197712110cle","Cleveland Browns",15,"Houston Oilers",19,34,-4,FALSE,"12/11/1977",1977,"December","1970s",5,83,11
"2542","197712110nwe","New England Patriots",14,"Miami Dolphins",10,24,4,TRUE,"12/11/1977",1977,"December","1970s",13,46,19
"2543","197712110den","Denver Broncos",17,"San Diego Chargers",9,26,8,TRUE,"12/11/1977",1977,"December","1970s",44,27,10
"2544","197712110rai","Oakland Raiders",35,"Minnesota Vikings",13,48,22,TRUE,"12/11/1977",1977,"December","1970s",53,86,8
"2545","197712110ram","Los Angeles Rams",23,"Atlanta Falcons",7,30,16,TRUE,"12/11/1977",1977,"December","1970s",60,82,6
"2546","197712110phi","Philadelphia Eagles",17,"New York Giants",14,31,3,TRUE,"12/11/1977",1977,"December","1970s",18,48,14
"2547","197712110nor","New Orleans Saints",14,"Tampa Bay Buccaneers",33,47,-19,FALSE,"12/11/1977",1977,"December","1970s",72,NA,NA
"2548","197712110kan","Kansas City Chiefs",31,"Seattle Seahawks",34,65,-3,FALSE,"12/11/1977",1977,"December","1970s",23,64,12
"2549","197712120sfo","San Francisco 49ers",35,"Dallas Cowboys",42,77,-7,FALSE,"12/12/1977",1977,"December","1970s",53,90,6
"2550","197712170det","Detroit Lions",21,"Minnesota Vikings",30,51,-9,FALSE,"12/17/1977",1977,"December","1970s",72,NA,NA
"2551","197712170was","Washington Redskins",17,"Los Angeles Rams",14,31,3,TRUE,"12/17/1977",1977,"December","1970s",41,80,7
"2552","197712170mia","Miami Dolphins",31,"Buffalo Bills",14,45,17,TRUE,"12/17/1977",1977,"December","1970s",76,93,8
"2553","197712180sdg","San Diego Chargers",9,"Pittsburgh Steelers",10,19,-1,FALSE,"12/18/1977",1977,"December","1970s",63,81,12
"2554","197712180atl","Atlanta Falcons",35,"New Orleans Saints",7,42,28,TRUE,"12/18/1977",1977,"December","1970s",50,69,17
"2555","197712180gnb","Green Bay Packers",16,"San Francisco 49ers",14,30,2,TRUE,"12/18/1977",1977,"December","1970s",40,97,8
"2556","197712180nyg","New York Giants",9,"Chicago Bears",12,21,-3,FALSE,"12/18/1977",1977,"December","1970s",36,64,16
"2557","197712180tam","Tampa Bay Buccaneers",17,"St. Louis Cardinals",7,24,10,TRUE,"12/18/1977",1977,"December","1970s",66,72,14
"2558","197712180clt","Baltimore Colts",30,"New England Patriots",24,54,6,TRUE,"12/18/1977",1977,"December","1970s",41,81,14
"2559","197712180rai","Oakland Raiders",21,"Kansas City Chiefs",20,41,1,TRUE,"12/18/1977",1977,"December","1970s",50,82,10
"2560","197712180sea","Seattle Seahawks",20,"Cleveland Browns",19,39,1,TRUE,"12/18/1977",1977,"December","1970s",72,NA,NA
"2561","197712180phi","Philadelphia Eagles",27,"New York Jets",0,27,27,TRUE,"12/18/1977",1977,"December","1970s",36,83,16
"2562","197712180oti","Houston Oilers",21,"Cincinnati Bengals",16,37,5,TRUE,"12/18/1977",1977,"December","1970s",72,NA,NA
"2563","197712180dal","Dallas Cowboys",14,"Denver Broncos",6,20,8,TRUE,"12/18/1977",1977,"December","1970s",52,25,10
"2564","197712240den","Denver Broncos",34,"Pittsburgh Steelers",21,55,13,TRUE,"12/24/1977",1977,"December","1970s",44,31,16
"2565","197712240clt","Baltimore Colts",31,"Oakland Raiders",37,68,-6,FALSE,"12/24/1977",1977,"December","1970s",41,56,9
"2566","197712260dal","Dallas Cowboys",37,"Chicago Bears",7,44,30,TRUE,"12/26/1977",1977,"December","1970s",37,35,8
"2567","197712260ram","Los Angeles Rams",7,"Minnesota Vikings",14,21,-7,FALSE,"12/26/1977",1977,"December","1970s",60,91,12
"2568","197801010den","Denver Broncos",20,"Oakland Raiders",17,37,3,TRUE,"1/1/1978",1978,"January","1970s",13,61,6
"2569","197801010dal","Dallas Cowboys",23,"Minnesota Vikings",6,29,17,TRUE,"1/1/1978",1978,"January","1970s",38,76,19
"2570","197801150dal","Dallas Cowboys",27,"Denver Broncos",10,37,17,TRUE,"1/15/1978",1978,"January","1970s",72,NA,NA
"2571","197809020tam","Tampa Bay Buccaneers",13,"New York Giants",19,32,-6,FALSE,"9/2/1978",1978,"September","1970s",83,76,8
"2572","197809030atl","Atlanta Falcons",20,"Houston Oilers",14,34,6,TRUE,"9/3/1978",1978,"September","1970s",77,75,10
"2573","197809030nor","New Orleans Saints",31,"Minnesota Vikings",24,55,7,TRUE,"9/3/1978",1978,"September","1970s",72,NA,NA
"2574","197809030det","Detroit Lions",7,"Green Bay Packers",13,20,-6,FALSE,"9/3/1978",1978,"September","1970s",72,NA,NA
"2575","197809030sea","Seattle Seahawks",20,"San Diego Chargers",24,44,-4,FALSE,"9/3/1978",1978,"September","1970s",72,NA,NA
"2576","197809030buf","Buffalo Bills",17,"Pittsburgh Steelers",28,45,-11,FALSE,"9/3/1978",1978,"September","1970s",66,80,12
"2577","197809030nyj","New York Jets",33,"Miami Dolphins",20,53,13,TRUE,"9/3/1978",1978,"September","1970s",72,68,7
"2578","197809030chi","Chicago Bears",17,"St. Louis Cardinals",10,27,7,TRUE,"9/3/1978",1978,"September","1970s",74,69,13
"2579","197809030den","Denver Broncos",14,"Oakland Raiders",6,20,8,TRUE,"9/3/1978",1978,"September","1970s",75,25,13
"2580","197809030phi","Philadelphia Eagles",14,"Los Angeles Rams",16,30,-2,FALSE,"9/3/1978",1978,"September","1970s",73,69,9
"2581","197809030cle","Cleveland Browns",24,"San Francisco 49ers",7,31,17,TRUE,"9/3/1978",1978,"September","1970s",69,76,11
"2582","197809030cin","Cincinnati Bengals",23,"Kansas City Chiefs",24,47,-1,FALSE,"9/3/1978",1978,"September","1970s",68,77,6
"2583","197809030nwe","New England Patriots",14,"Washington Redskins",16,30,-2,FALSE,"9/3/1978",1978,"September","1970s",71,70,13
"2584","197809040dal","Dallas Cowboys",38,"Baltimore Colts",0,38,38,TRUE,"9/4/1978",1978,"September","1970s",87,46,8
"2585","197809090tam","Tampa Bay Buccaneers",7,"Detroit Lions",15,22,-8,FALSE,"9/9/1978",1978,"September","1970s",83,76,6
"2586","197809100gnb","Green Bay Packers",28,"New Orleans Saints",17,45,11,TRUE,"9/10/1978",1978,"September","1970s",75,77,8
"2587","197809100pit","Pittsburgh Steelers",21,"Seattle Seahawks",10,31,11,TRUE,"9/10/1978",1978,"September","1970s",70,78,5
"2588","197809100was","Washington Redskins",35,"Philadelphia Eagles",30,65,5,TRUE,"9/10/1978",1978,"September","1970s",73,56,7
"2589","197809100sfo","San Francisco 49ers",13,"Chicago Bears",16,29,-3,FALSE,"9/10/1978",1978,"September","1970s",64,81,13
"2590","197809100crd","St. Louis Cardinals",6,"New England Patriots",16,22,-10,FALSE,"9/10/1978",1978,"September","1970s",81,57,9
"2591","197809100cle","Cleveland Browns",13,"Cincinnati Bengals",10,23,3,TRUE,"9/10/1978",1978,"September","1970s",75,67,9
"2592","197809100clt","Baltimore Colts",0,"Miami Dolphins",42,42,-42,FALSE,"9/10/1978",1978,"September","1970s",67,59,9
"2593","197809100nyg","New York Giants",24,"Dallas Cowboys",34,58,-10,FALSE,"9/10/1978",1978,"September","1970s",61,51,14
"2594","197809100sdg","San Diego Chargers",20,"Oakland Raiders",21,41,-1,FALSE,"9/10/1978",1978,"September","1970s",71,70,11
"2595","197809100kan","Kansas City Chiefs",17,"Houston Oilers",20,37,-3,FALSE,"9/10/1978",1978,"September","1970s",78,67,9
"2596","197809100buf","Buffalo Bills",20,"New York Jets",21,41,-1,FALSE,"9/10/1978",1978,"September","1970s",59,64,11
"2597","197809100ram","Los Angeles Rams",10,"Atlanta Falcons",0,10,10,TRUE,"9/10/1978",1978,"September","1970s",67,78,6
"2598","197809110min","Minnesota Vikings",12,"Denver Broncos",9,21,3,TRUE,"9/11/1978",1978,"September","1970s",79,65,11
"2599","197809170nor","New Orleans Saints",17,"Philadelphia Eagles",24,41,-7,FALSE,"9/17/1978",1978,"September","1970s",72,NA,NA
"2600","197809170gnb","Green Bay Packers",3,"Oakland Raiders",28,31,-25,FALSE,"9/17/1978",1978,"September","1970s",59,82,13
"2601","197809170nyj","New York Jets",17,"Seattle Seahawks",24,41,-7,FALSE,"9/17/1978",1978,"September","1970s",68,66,8
"2602","197809170atl","Atlanta Falcons",16,"Cleveland Browns",24,40,-8,FALSE,"9/17/1978",1978,"September","1970s",79,70,6
"2603","197809170det","Detroit Lions",0,"Chicago Bears",19,19,-19,FALSE,"9/17/1978",1978,"September","1970s",72,NA,NA
"2604","197809170cin","Cincinnati Bengals",3,"Pittsburgh Steelers",28,31,-25,FALSE,"9/17/1978",1978,"September","1970s",76,79,12
"2605","197809170min","Minnesota Vikings",10,"Tampa Bay Buccaneers",16,26,-6,FALSE,"9/17/1978",1978,"September","1970s",59,78,9
"2606","197809170oti","Houston Oilers",20,"San Francisco 49ers",19,39,1,TRUE,"9/17/1978",1978,"September","1970s",72,NA,NA
"2607","197809170den","Denver Broncos",27,"San Diego Chargers",14,41,13,TRUE,"9/17/1978",1978,"September","1970s",67,32,14
"2608","197809170mia","Miami Dolphins",31,"Buffalo Bills",24,55,7,TRUE,"9/17/1978",1978,"September","1970s",82,70,12
"2609","197809170ram","Los Angeles Rams",27,"Dallas Cowboys",14,41,13,TRUE,"9/17/1978",1978,"September","1970s",67,77,10
"2610","197809170nyg","New York Giants",26,"Kansas City Chiefs",10,36,16,TRUE,"9/17/1978",1978,"September","1970s",68,66,8
"2611","197809170crd","St. Louis Cardinals",10,"Washington Redskins",28,38,-18,FALSE,"9/17/1978",1978,"September","1970s",82,65,14
"2612","197809180nwe","New England Patriots",27,"Baltimore Colts",34,61,-7,FALSE,"9/18/1978",1978,"September","1970s",58,73,9
"2613","197809240dal","Dallas Cowboys",21,"St. Louis Cardinals",12,33,9,TRUE,"9/24/1978",1978,"September","1970s",76,70,5
"2614","197809240nyg","New York Giants",27,"San Francisco 49ers",10,37,17,TRUE,"9/24/1978",1978,"September","1970s",61,62,8
"2615","197809240kan","Kansas City Chiefs",17,"Denver Broncos",23,40,-6,FALSE,"9/24/1978",1978,"September","1970s",68,66,6
"2616","197809240phi","Philadelphia Eagles",17,"Miami Dolphins",3,20,14,TRUE,"9/24/1978",1978,"September","1970s",60,73,7
"2617","197809240cin","Cincinnati Bengals",18,"New Orleans Saints",20,38,-2,FALSE,"9/24/1978",1978,"September","1970s",68,65,6
"2618","197809240sea","Seattle Seahawks",28,"Detroit Lions",16,44,12,TRUE,"9/24/1978",1978,"September","1970s",72,NA,NA
"2619","197809240buf","Buffalo Bills",24,"Baltimore Colts",17,41,7,TRUE,"9/24/1978",1978,"September","1970s",56,77,11
"2620","197809240tam","Tampa Bay Buccaneers",14,"Atlanta Falcons",9,23,5,TRUE,"9/24/1978",1978,"September","1970s",78,87,11
"2621","197809240oti","Houston Oilers",6,"Los Angeles Rams",10,16,-4,FALSE,"9/24/1978",1978,"September","1970s",72,NA,NA
"2622","197809240pit","Pittsburgh Steelers",15,"Cleveland Browns",9,24,6,TRUE,"9/24/1978",1978,"September","1970s",58,86,4
"2623","197809240rai","Oakland Raiders",14,"New England Patriots",21,35,-7,FALSE,"9/24/1978",1978,"September","1970s",74,56,7
"2624","197809240sdg","San Diego Chargers",3,"Green Bay Packers",24,27,-21,FALSE,"9/24/1978",1978,"September","1970s",85,35,9
"2625","197809240was","Washington Redskins",23,"New York Jets",3,26,20,TRUE,"9/24/1978",1978,"September","1970s",65,65,6
"2626","197809250chi","Chicago Bears",20,"Minnesota Vikings",24,44,-4,FALSE,"9/25/1978",1978,"September","1970s",63,62,12
"2627","197810010cle","Cleveland Browns",13,"Houston Oilers",16,29,-3,FALSE,"10/1/1978",1978,"October","1970s",61,86,10
"2628","197810010tam","Tampa Bay Buccaneers",7,"Minnesota Vikings",24,31,-17,FALSE,"10/1/1978",1978,"October","1970s",78,83,6
"2629","197810010gnb","Green Bay Packers",35,"Detroit Lions",14,49,21,TRUE,"10/1/1978",1978,"October","1970s",57,78,10
"2630","197810010den","Denver Broncos",28,"Seattle Seahawks",7,35,21,TRUE,"10/1/1978",1978,"October","1970s",65,23,9
"2631","197810010nor","New Orleans Saints",20,"Los Angeles Rams",26,46,-6,FALSE,"10/1/1978",1978,"October","1970s",72,NA,NA
"2632","197810010nwe","New England Patriots",28,"San Diego Chargers",23,51,5,TRUE,"10/1/1978",1978,"October","1970s",59,83,10
"2633","197810010mia","Miami Dolphins",24,"St. Louis Cardinals",10,34,14,TRUE,"10/1/1978",1978,"October","1970s",83,70,6
"2634","197810010clt","Baltimore Colts",14,"Philadelphia Eagles",17,31,-3,FALSE,"10/1/1978",1978,"October","1970s",65,78,6
"2635","197810010nyj","New York Jets",17,"Pittsburgh Steelers",28,45,-11,FALSE,"10/1/1978",1978,"October","1970s",66,75,9
"2636","197810010buf","Buffalo Bills",28,"Kansas City Chiefs",13,41,15,TRUE,"10/1/1978",1978,"October","1970s",60,84,18
"2637","197810010atl","Atlanta Falcons",23,"New York Giants",20,43,3,TRUE,"10/1/1978",1978,"October","1970s",63,85,10
"2638","197810010sfo","San Francisco 49ers",28,"Cincinnati Bengals",12,40,16,TRUE,"10/1/1978",1978,"October","1970s",62,71,11
"2639","197810010chi","Chicago Bears",19,"Oakland Raiders",25,44,-6,FALSE,"10/1/1978",1978,"October","1970s",60,69,8
"2640","197810020was","Washington Redskins",9,"Dallas Cowboys",5,14,4,TRUE,"10/2/1978",1978,"October","1970s",68,58,13
"2641","197810080rai","Oakland Raiders",21,"Houston Oilers",17,38,4,TRUE,"10/8/1978",1978,"October","1970s",60,81,8
"2642","197810080crd","St. Louis Cardinals",17,"Baltimore Colts",30,47,-13,FALSE,"10/8/1978",1978,"October","1970s",48,70,6
"2643","197810080nwe","New England Patriots",24,"Philadelphia Eagles",14,38,10,TRUE,"10/8/1978",1978,"October","1970s",48,60,14
"2644","197810080sea","Seattle Seahawks",29,"Minnesota Vikings",28,57,1,TRUE,"10/8/1978",1978,"October","1970s",72,NA,NA
"2645","197810080gnb","Green Bay Packers",24,"Chicago Bears",14,38,10,TRUE,"10/8/1978",1978,"October","1970s",40,70,9
"2646","197810080nyj","New York Jets",45,"Buffalo Bills",14,59,31,TRUE,"10/8/1978",1978,"October","1970s",50,55,15
"2647","197810080dal","Dallas Cowboys",24,"New York Giants",3,27,21,TRUE,"10/8/1978",1978,"October","1970s",69,40,10
"2648","197810080sdg","San Diego Chargers",23,"Denver Broncos",0,23,23,TRUE,"10/8/1978",1978,"October","1970s",70,80,7
"2649","197810080ram","Los Angeles Rams",27,"San Francisco 49ers",10,37,17,TRUE,"10/8/1978",1978,"October","1970s",69,79,8
"2650","197810080pit","Pittsburgh Steelers",31,"Atlanta Falcons",7,38,24,TRUE,"10/8/1978",1978,"October","1970s",42,77,13
"2651","197810080det","Detroit Lions",19,"Washington Redskins",21,40,-2,FALSE,"10/8/1978",1978,"October","1970s",72,NA,NA
"2652","197810080nor","New Orleans Saints",16,"Cleveland Browns",24,40,-8,FALSE,"10/8/1978",1978,"October","1970s",72,NA,NA
"2653","197810080kan","Kansas City Chiefs",13,"Tampa Bay Buccaneers",30,43,-17,FALSE,"10/8/1978",1978,"October","1970s",54,58,12
"2654","197810090mia","Miami Dolphins",21,"Cincinnati Bengals",0,21,21,TRUE,"10/9/1978",1978,"October","1970s",79,65,19
"2655","197810150phi","Philadelphia Eagles",17,"Washington Redskins",10,27,7,TRUE,"10/15/1978",1978,"October","1970s",48,61,14
"2656","197810150rai","Oakland Raiders",28,"Kansas City Chiefs",6,34,22,TRUE,"10/15/1978",1978,"October","1970s",60,82,9
"2657","197810150gnb","Green Bay Packers",45,"Seattle Seahawks",28,73,17,TRUE,"10/15/1978",1978,"October","1970s",39,87,11
"2658","197810150cin","Cincinnati Bengals",3,"New England Patriots",10,13,-7,FALSE,"10/15/1978",1978,"October","1970s",44,73,13
"2659","197810150sfo","San Francisco 49ers",7,"New Orleans Saints",14,21,-7,FALSE,"10/15/1978",1978,"October","1970s",58,86,15
"2660","197810150min","Minnesota Vikings",17,"Los Angeles Rams",34,51,-17,FALSE,"10/15/1978",1978,"October","1970s",45,72,15
"2661","197810150atl","Atlanta Falcons",14,"Detroit Lions",0,14,14,TRUE,"10/15/1978",1978,"October","1970s",49,54,12
"2662","197810150sdg","San Diego Chargers",21,"Miami Dolphins",28,49,-7,FALSE,"10/15/1978",1978,"October","1970s",68,85,9
"2663","197810150oti","Houston Oilers",17,"Buffalo Bills",10,27,7,TRUE,"10/15/1978",1978,"October","1970s",72,NA,NA
"2664","197810150clt","Baltimore Colts",10,"New York Jets",33,43,-23,FALSE,"10/15/1978",1978,"October","1970s",50,58,13
"2665","197810150nyg","New York Giants",17,"Tampa Bay Buccaneers",14,31,3,TRUE,"10/15/1978",1978,"October","1970s",49,53,17
"2666","197810150cle","Cleveland Browns",14,"Pittsburgh Steelers",34,48,-20,FALSE,"10/15/1978",1978,"October","1970s",47,66,12
"2667","197810150crd","St. Louis Cardinals",21,"Dallas Cowboys",24,45,-3,FALSE,"10/15/1978",1978,"October","1970s",48,67,11
"2668","197810160den","Denver Broncos",16,"Chicago Bears",7,23,9,TRUE,"10/16/1978",1978,"October","1970s",54,26,6
"2669","197810220sfo","San Francisco 49ers",17,"Atlanta Falcons",20,37,-3,FALSE,"10/22/1978",1978,"October","1970s",57,80,11
"2670","197810220ram","Los Angeles Rams",3,"New Orleans Saints",10,13,-7,FALSE,"10/22/1978",1978,"October","1970s",65,77,10
"2671","197810220nyg","New York Giants",17,"Washington Redskins",6,23,11,TRUE,"10/22/1978",1978,"October","1970s",61,55,11
"2672","197810220buf","Buffalo Bills",5,"Cincinnati Bengals",0,5,5,TRUE,"10/22/1978",1978,"October","1970s",63,54,16
"2673","197810220clt","Baltimore Colts",7,"Denver Broncos",6,13,1,TRUE,"10/22/1978",1978,"October","1970s",58,65,6
"2674","197810220det","Detroit Lions",31,"San Diego Chargers",14,45,17,TRUE,"10/22/1978",1978,"October","1970s",72,NA,NA
"2675","197810220nyj","New York Jets",23,"St. Louis Cardinals",10,33,13,TRUE,"10/22/1978",1978,"October","1970s",61,55,11
"2676","197810220sea","Seattle Seahawks",27,"Oakland Raiders",7,34,20,TRUE,"10/22/1978",1978,"October","1970s",72,NA,NA
"2677","197810220nwe","New England Patriots",33,"Miami Dolphins",24,57,9,TRUE,"10/22/1978",1978,"October","1970s",61,54,10
"2678","197810220min","Minnesota Vikings",21,"Green Bay Packers",7,28,14,TRUE,"10/22/1978",1978,"October","1970s",51,60,13
"2679","197810220tam","Tampa Bay Buccaneers",33,"Chicago Bears",19,52,14,TRUE,"10/22/1978",1978,"October","1970s",74,63,10
"2680","197810220dal","Dallas Cowboys",14,"Philadelphia Eagles",7,21,7,TRUE,"10/22/1978",1978,"October","1970s",76,51,14
"2681","197810220kan","Kansas City Chiefs",17,"Cleveland Browns",3,20,14,TRUE,"10/22/1978",1978,"October","1970s",67,43,13
"2682","197810230pit","Pittsburgh Steelers",17,"Houston Oilers",24,41,-7,FALSE,"10/23/1978",1978,"October","1970s",56,72,12
"2683","197810260dal","Dallas Cowboys",10,"Minnesota Vikings",21,31,-11,FALSE,"10/26/1978",1978,"October","1970s",61,58,11
"2684","197810290rai","Oakland Raiders",23,"San Diego Chargers",27,50,-4,FALSE,"10/29/1978",1978,"October","1970s",58,66,11
"2685","197810290phi","Philadelphia Eagles",10,"St. Louis Cardinals",16,26,-6,FALSE,"10/29/1978",1978,"October","1970s",52,61,8
"2686","197810290cin","Cincinnati Bengals",28,"Houston Oilers",13,41,15,TRUE,"10/29/1978",1978,"October","1970s",49,60,12
"2687","197810290chi","Chicago Bears",17,"Detroit Lions",21,38,-4,FALSE,"10/29/1978",1978,"October","1970s",48,59,10
"2688","197810290pit","Pittsburgh Steelers",27,"Kansas City Chiefs",24,51,3,TRUE,"10/29/1978",1978,"October","1970s",43,70,10
"2689","197810290sea","Seattle Seahawks",17,"Denver Broncos",20,37,-3,FALSE,"10/29/1978",1978,"October","1970s",72,NA,NA
"2690","197810290mia","Miami Dolphins",26,"Baltimore Colts",8,34,18,TRUE,"10/29/1978",1978,"October","1970s",80,76,13
"2691","197810290was","Washington Redskins",38,"San Francisco 49ers",20,58,18,TRUE,"10/29/1978",1978,"October","1970s",56,56,8
"2692","197810290gnb","Green Bay Packers",9,"Tampa Bay Buccaneers",7,16,2,TRUE,"10/29/1978",1978,"October","1970s",40,77,11
"2693","197810290cle","Cleveland Browns",41,"Buffalo Bills",20,61,21,TRUE,"10/29/1978",1978,"October","1970s",42,70,9
"2694","197810290nor","New Orleans Saints",28,"New York Giants",17,45,11,TRUE,"10/29/1978",1978,"October","1970s",72,NA,NA
"2695","197810290nwe","New England Patriots",55,"New York Jets",21,76,34,TRUE,"10/29/1978",1978,"October","1970s",51,62,12
"2696","197810300atl","Atlanta Falcons",15,"Los Angeles Rams",7,22,8,TRUE,"10/30/1978",1978,"October","1970s",62,57,17
"2697","197811050sdg","San Diego Chargers",22,"Cincinnati Bengals",13,35,9,TRUE,"11/5/1978",1978,"November","1970s",67,83,8
"2698","197811050oti","Houston Oilers",14,"Cleveland Browns",10,24,4,TRUE,"11/5/1978",1978,"November","1970s",72,NA,NA
"2699","197811050atl","Atlanta Falcons",21,"San Francisco 49ers",10,31,11,TRUE,"11/5/1978",1978,"November","1970s",60,45,6
"2700","197811050kan","Kansas City Chiefs",10,"Oakland Raiders",20,30,-10,FALSE,"11/5/1978",1978,"November","1970s",64,64,13
"2701","197811050phi","Philadelphia Eagles",10,"Green Bay Packers",3,13,7,TRUE,"11/5/1978",1978,"November","1970s",56,69,9
"2702","197811050min","Minnesota Vikings",17,"Detroit Lions",7,24,10,TRUE,"11/5/1978",1978,"November","1970s",57,43,18
"2703","197811050ram","Los Angeles Rams",26,"Tampa Bay Buccaneers",23,49,3,TRUE,"11/5/1978",1978,"November","1970s",64,81,8
"2704","197811050crd","St. Louis Cardinals",20,"New York Giants",10,30,10,TRUE,"11/5/1978",1978,"November","1970s",69,55,9
"2705","197811050chi","Chicago Bears",29,"Seattle Seahawks",31,60,-2,FALSE,"11/5/1978",1978,"November","1970s",59,74,13
"2706","197811050mia","Miami Dolphins",23,"Dallas Cowboys",16,39,7,TRUE,"11/5/1978",1978,"November","1970s",70,60,9
"2707","197811050pit","Pittsburgh Steelers",20,"New Orleans Saints",14,34,6,TRUE,"11/5/1978",1978,"November","1970s",52,68,6
"2708","197811050buf","Buffalo Bills",10,"New England Patriots",14,24,-4,FALSE,"11/5/1978",1978,"November","1970s",56,65,13
"2709","197811050den","Denver Broncos",28,"New York Jets",31,59,-3,FALSE,"11/5/1978",1978,"November","1970s",48,36,10
"2710","197811060clt","Baltimore Colts",21,"Washington Redskins",17,38,4,TRUE,"11/6/1978",1978,"November","1970s",55,61,8
"2711","197811120det","Detroit Lions",34,"Tampa Bay Buccaneers",23,57,11,TRUE,"11/12/1978",1978,"November","1970s",72,NA,NA
"2712","197811120phi","Philadelphia Eagles",17,"New York Jets",9,26,8,TRUE,"11/12/1978",1978,"November","1970s",50,76,9
"2713","197811120sfo","San Francisco 49ers",10,"St. Louis Cardinals",16,26,-6,FALSE,"11/12/1978",1978,"November","1970s",49,57,13
"2714","197811120was","Washington Redskins",16,"New York Giants",13,29,3,TRUE,"11/12/1978",1978,"November","1970s",56,81,7
"2715","197811120ram","Los Angeles Rams",10,"Pittsburgh Steelers",7,17,3,TRUE,"11/12/1978",1978,"November","1970s",49,76,10
"2716","197811120min","Minnesota Vikings",17,"Chicago Bears",14,31,3,TRUE,"11/12/1978",1978,"November","1970s",32,71,14
"2717","197811120nwe","New England Patriots",23,"Houston Oilers",26,49,-3,FALSE,"11/12/1978",1978,"November","1970s",47,67,14
"2718","197811120cle","Cleveland Browns",7,"Denver Broncos",19,26,-12,FALSE,"11/12/1978",1978,"November","1970s",50,83,12
"2719","197811120gnb","Green Bay Packers",14,"Dallas Cowboys",42,56,-28,FALSE,"11/12/1978",1978,"November","1970s",31,73,14
"2720","197811120sea","Seattle Seahawks",14,"Baltimore Colts",17,31,-3,FALSE,"11/12/1978",1978,"November","1970s",72,NA,NA
"2721","197811120sdg","San Diego Chargers",29,"Kansas City Chiefs",23,52,6,TRUE,"11/12/1978",1978,"November","1970s",58,65,14
"2722","197811120buf","Buffalo Bills",24,"Miami Dolphins",25,49,-1,FALSE,"11/12/1978",1978,"November","1970s",39,87,14
"2723","197811120nor","New Orleans Saints",17,"Atlanta Falcons",20,37,-3,FALSE,"11/12/1978",1978,"November","1970s",72,NA,NA
"2724","197811130cin","Cincinnati Bengals",21,"Oakland Raiders",34,55,-13,FALSE,"11/13/1978",1978,"November","1970s",56,86,12
"2725","197811190den","Denver Broncos",16,"Green Bay Packers",3,19,13,TRUE,"11/19/1978",1978,"November","1970s",30,58,9
"2726","197811190sfo","San Francisco 49ers",28,"Los Angeles Rams",31,59,-3,FALSE,"11/19/1978",1978,"November","1970s",52,81,14
"2727","197811190min","Minnesota Vikings",7,"San Diego Chargers",13,20,-6,FALSE,"11/19/1978",1978,"November","1970s",16,66,14
"2728","197811190was","Washington Redskins",17,"St. Louis Cardinals",27,44,-10,FALSE,"11/19/1978",1978,"November","1970s",50,56,11
"2729","197811190rai","Oakland Raiders",29,"Detroit Lions",17,46,12,TRUE,"11/19/1978",1978,"November","1970s",52,80,13
"2730","197811190dal","Dallas Cowboys",27,"New Orleans Saints",7,34,20,TRUE,"11/19/1978",1978,"November","1970s",53,79,6
"2731","197811190tam","Tampa Bay Buccaneers",31,"Buffalo Bills",10,41,21,TRUE,"11/19/1978",1978,"November","1970s",72,73,6
"2732","197811190nyg","New York Giants",17,"Philadelphia Eagles",19,36,-2,FALSE,"11/19/1978",1978,"November","1970s",49,56,14
"2733","197811190kan","Kansas City Chiefs",10,"Seattle Seahawks",13,23,-3,FALSE,"11/19/1978",1978,"November","1970s",32,73,14
"2734","197811190chi","Chicago Bears",13,"Atlanta Falcons",7,20,6,TRUE,"11/19/1978",1978,"November","1970s",36,72,10
"2735","197811190pit","Pittsburgh Steelers",7,"Cincinnati Bengals",6,13,1,TRUE,"11/19/1978",1978,"November","1970s",41,76,9
"2736","197811190nyj","New York Jets",17,"New England Patriots",19,36,-2,FALSE,"11/19/1978",1978,"November","1970s",49,56,14
"2737","197811190clt","Baltimore Colts",24,"Cleveland Browns",45,69,-21,FALSE,"11/19/1978",1978,"November","1970s",46,65,9
"2738","197811200oti","Houston Oilers",35,"Miami Dolphins",30,65,5,TRUE,"11/20/1978",1978,"November","1970s",72,NA,NA
"2739","197811230dal","Dallas Cowboys",37,"Washington Redskins",10,47,27,TRUE,"11/23/1978",1978,"November","1970s",61,88,7
"2740","197811230det","Detroit Lions",17,"Denver Broncos",14,31,3,TRUE,"11/23/1978",1978,"November","1970s",72,NA,NA
"2741","197811260oti","Houston Oilers",17,"Cincinnati Bengals",10,27,7,TRUE,"11/26/1978",1978,"November","1970s",72,NA,NA
"2742","197811260crd","St. Louis Cardinals",10,"Philadelphia Eagles",14,24,-4,FALSE,"11/26/1978",1978,"November","1970s",43,100,15
"2743","197811260atl","Atlanta Falcons",20,"New Orleans Saints",17,37,3,TRUE,"11/26/1978",1978,"November","1970s",51,50,8
"2744","197811260gnb","Green Bay Packers",10,"Minnesota Vikings",10,20,0,FALSE,"11/26/1978",1978,"November","1970s",27,89,11
"2745","197811260chi","Chicago Bears",14,"Tampa Bay Buccaneers",3,17,11,TRUE,"11/26/1978",1978,"November","1970s",35,75,13
"2746","197811260clt","Baltimore Colts",14,"New England Patriots",35,49,-21,FALSE,"11/26/1978",1978,"November","1970s",40,50,11
"2747","197811260kan","Kansas City Chiefs",23,"San Diego Chargers",0,23,23,TRUE,"11/26/1978",1978,"November","1970s",40,94,18
"2748","197811260mia","Miami Dolphins",13,"New York Jets",24,37,-11,FALSE,"11/26/1978",1978,"November","1970s",69,70,9
"2749","197811260cle","Cleveland Browns",30,"Los Angeles Rams",19,49,11,TRUE,"11/26/1978",1978,"November","1970s",36,69,12
"2750","197811260rai","Oakland Raiders",16,"Seattle Seahawks",17,33,-1,FALSE,"11/26/1978",1978,"November","1970s",49,84,5
"2751","197811260buf","Buffalo Bills",41,"New York Giants",17,58,24,TRUE,"11/26/1978",1978,"November","1970s",23,71,10
"2752","197811270sfo","San Francisco 49ers",7,"Pittsburgh Steelers",24,31,-17,FALSE,"11/27/1978",1978,"November","1970s",49,82,8
"2753","197812030nyj","New York Jets",24,"Baltimore Colts",16,40,8,TRUE,"12/3/1978",1978,"December","1970s",37,57,14
"2754","197812030sea","Seattle Seahawks",47,"Cleveland Browns",24,71,23,TRUE,"12/3/1978",1978,"December","1970s",72,NA,NA
"2755","197812030tam","Tampa Bay Buccaneers",7,"Green Bay Packers",17,24,-10,FALSE,"12/3/1978",1978,"December","1970s",76,81,8
"2756","197812030rai","Oakland Raiders",6,"Denver Broncos",21,27,-15,FALSE,"12/3/1978",1978,"December","1970s",48,70,6
"2757","197812030crd","St. Louis Cardinals",21,"Detroit Lions",14,35,7,TRUE,"12/3/1978",1978,"December","1970s",45,97,16
"2758","197812030oti","Houston Oilers",3,"Pittsburgh Steelers",13,16,-10,FALSE,"12/3/1978",1978,"December","1970s",72,NA,NA
"2759","197812030cin","Cincinnati Bengals",37,"Atlanta Falcons",7,44,30,TRUE,"12/3/1978",1978,"December","1970s",49,91,15
"2760","197812030was","Washington Redskins",0,"Miami Dolphins",16,16,-16,FALSE,"12/3/1978",1978,"December","1970s",48,72,9
"2761","197812030min","Minnesota Vikings",28,"Philadelphia Eagles",27,55,1,TRUE,"12/3/1978",1978,"December","1970s",16,70,15
"2762","197812030nor","New Orleans Saints",24,"San Francisco 49ers",13,37,11,TRUE,"12/3/1978",1978,"December","1970s",72,NA,NA
"2763","197812030nyg","New York Giants",17,"Los Angeles Rams",20,37,-3,FALSE,"12/3/1978",1978,"December","1970s",37,57,14
"2764","197812030kan","Kansas City Chiefs",14,"Buffalo Bills",10,24,4,TRUE,"12/3/1978",1978,"December","1970s",24,84,13
"2765","197812030dal","Dallas Cowboys",17,"New England Patriots",10,27,7,TRUE,"12/3/1978",1978,"December","1970s",48,70,16
"2766","197812040sdg","San Diego Chargers",40,"Chicago Bears",7,47,33,TRUE,"12/4/1978",1978,"December","1970s",56,51,6
"2767","197812090pit","Pittsburgh Steelers",35,"Baltimore Colts",13,48,22,TRUE,"12/9/1978",1978,"December","1970s",31,0,14
"2768","197812090det","Detroit Lions",45,"Minnesota Vikings",14,59,31,TRUE,"12/9/1978",1978,"December","1970s",72,NA,NA
"2769","197812100nwe","New England Patriots",26,"Buffalo Bills",24,50,2,TRUE,"12/10/1978",1978,"December","1970s",29,77,19
"2770","197812100phi","Philadelphia Eagles",13,"Dallas Cowboys",31,44,-18,FALSE,"12/10/1978",1978,"December","1970s",31,51,18
"2771","197812100sdg","San Diego Chargers",37,"Seattle Seahawks",10,47,27,TRUE,"12/10/1978",1978,"December","1970s",52,50,8
"2772","197812100chi","Chicago Bears",14,"Green Bay Packers",0,14,14,TRUE,"12/10/1978",1978,"December","1970s",1,67,11
"2773","197812100atl","Atlanta Falcons",20,"Washington Redskins",17,37,3,TRUE,"12/10/1978",1978,"December","1970s",29,61,14
"2774","197812100cle","Cleveland Browns",37,"New York Jets",34,71,3,TRUE,"12/10/1978",1978,"December","1970s",16,72,19
"2775","197812100mia","Miami Dolphins",23,"Oakland Raiders",6,29,17,TRUE,"12/10/1978",1978,"December","1970s",72,82,11
"2776","197812100nor","New Orleans Saints",12,"Houston Oilers",17,29,-5,FALSE,"12/10/1978",1978,"December","1970s",72,NA,NA
"2777","197812100nyg","New York Giants",17,"St. Louis Cardinals",0,17,17,TRUE,"12/10/1978",1978,"December","1970s",30,61,20
"2778","197812100sfo","San Francisco 49ers",6,"Tampa Bay Buccaneers",3,9,3,TRUE,"12/10/1978",1978,"December","1970s",44,56,4
"2779","197812100den","Denver Broncos",24,"Kansas City Chiefs",3,27,21,TRUE,"12/10/1978",1978,"December","1970s",24,61,6
"2780","197812110ram","Los Angeles Rams",19,"Cincinnati Bengals",20,39,-1,FALSE,"12/11/1978",1978,"December","1970s",61,32,7
"2781","197812160was","Washington Redskins",10,"Chicago Bears",14,24,-4,FALSE,"12/16/1978",1978,"December","1970s",46,39,11
"2782","197812160den","Denver Broncos",17,"Pittsburgh Steelers",21,38,-4,FALSE,"12/16/1978",1978,"December","1970s",26,56,12
"2783","197812170ram","Los Angeles Rams",31,"Green Bay Packers",14,45,17,TRUE,"12/17/1978",1978,"December","1970s",54,84,10
"2784","197812170rai","Oakland Raiders",27,"Minnesota Vikings",20,47,7,TRUE,"12/17/1978",1978,"December","1970s",51,75,11
"2785","197812170crd","St. Louis Cardinals",42,"Atlanta Falcons",21,63,21,TRUE,"12/17/1978",1978,"December","1970s",34,62,11
"2786","197812170clt","Baltimore Colts",14,"Buffalo Bills",21,35,-7,FALSE,"12/17/1978",1978,"December","1970s",45,46,22
"2787","197812170sea","Seattle Seahawks",23,"Kansas City Chiefs",19,42,4,TRUE,"12/17/1978",1978,"December","1970s",72,NA,NA
"2788","197812170oti","Houston Oilers",24,"San Diego Chargers",45,69,-21,FALSE,"12/17/1978",1978,"December","1970s",72,NA,NA
"2789","197812170nyj","New York Jets",7,"Dallas Cowboys",30,37,-23,FALSE,"12/17/1978",1978,"December","1970s",43,62,23
"2790","197812170tam","Tampa Bay Buccaneers",10,"New Orleans Saints",17,27,-7,FALSE,"12/17/1978",1978,"December","1970s",65,79,7
"2791","197812170phi","Philadelphia Eagles",20,"New York Giants",3,23,17,TRUE,"12/17/1978",1978,"December","1970s",43,53,22
"2792","197812170det","Detroit Lions",33,"San Francisco 49ers",14,47,19,TRUE,"12/17/1978",1978,"December","1970s",72,NA,NA
"2793","197812170cin","Cincinnati Bengals",48,"Cleveland Browns",16,64,32,TRUE,"12/17/1978",1978,"December","1970s",34,67,16
"2794","197812180mia","Miami Dolphins",23,"New England Patriots",3,26,20,TRUE,"12/18/1978",1978,"December","1970s",68,60,16
"2795","197812240atl","Atlanta Falcons",14,"Philadelphia Eagles",13,27,1,TRUE,"12/24/1978",1978,"December","1970s",43,77,11
"2796","197812240mia","Miami Dolphins",9,"Houston Oilers",17,26,-8,FALSE,"12/24/1978",1978,"December","1970s",77,78,12
"2797","197812300pit","Pittsburgh Steelers",33,"Denver Broncos",10,43,23,TRUE,"12/30/1978",1978,"December","1970s",30,75,7
"2798","197812300dal","Dallas Cowboys",27,"Atlanta Falcons",20,47,7,TRUE,"12/30/1978",1978,"December","1970s",38,97,15
"2799","197812310ram","Los Angeles Rams",34,"Minnesota Vikings",10,44,24,TRUE,"12/31/1978",1978,"December","1970s",53,52,6
"2800","197812310nwe","New England Patriots",14,"Houston Oilers",31,45,-17,FALSE,"12/31/1978",1978,"December","1970s",36,70,8
"2801","197901070ram","Los Angeles Rams",0,"Dallas Cowboys",28,28,-28,FALSE,"1/7/1979",1979,"January","1970s",56,77,8
"2802","197901070pit","Pittsburgh Steelers",34,"Houston Oilers",5,39,29,TRUE,"1/7/1979",1979,"January","1970s",25,85,8
"2803","197901210dal","Dallas Cowboys",31,"Pittsburgh Steelers",35,66,-4,FALSE,"1/21/1979",1979,"January","1970s",71,84,18
"2804","197909010tam","Tampa Bay Buccaneers",31,"Detroit Lions",16,47,15,TRUE,"9/1/1979",1979,"September","1970s",79,87,9
"2805","197909020buf","Buffalo Bills",7,"Miami Dolphins",9,16,-2,FALSE,"9/2/1979",1979,"September","1970s",74,74,15
"2806","197909020min","Minnesota Vikings",28,"San Francisco 49ers",22,50,6,TRUE,"9/2/1979",1979,"September","1970s",70,67,11
"2807","197909020sea","Seattle Seahawks",16,"San Diego Chargers",33,49,-17,FALSE,"9/2/1979",1979,"September","1970s",72,NA,NA
"2808","197909020phi","Philadelphia Eagles",23,"New York Giants",17,40,6,TRUE,"9/2/1979",1979,"September","1970s",76,84,9
"2809","197909020chi","Chicago Bears",6,"Green Bay Packers",3,9,3,TRUE,"9/2/1979",1979,"September","1970s",78,68,11
"2810","197909020nor","New Orleans Saints",34,"Atlanta Falcons",40,74,-6,FALSE,"9/2/1979",1979,"September","1970s",72,NA,NA
"2811","197909020crd","St. Louis Cardinals",21,"Dallas Cowboys",22,43,-1,FALSE,"9/2/1979",1979,"September","1970s",76,73,7
"2812","197909020kan","Kansas City Chiefs",14,"Baltimore Colts",0,14,14,TRUE,"9/2/1979",1979,"September","1970s",76,71,8
"2813","197909020was","Washington Redskins",27,"Houston Oilers",29,56,-2,FALSE,"9/2/1979",1979,"September","1970s",80,85,11
"2814","197909020ram","Los Angeles Rams",17,"Oakland Raiders",24,41,-7,FALSE,"9/2/1979",1979,"September","1970s",70,77,10
"2815","197909020nyj","New York Jets",22,"Cleveland Browns",25,47,-3,FALSE,"9/2/1979",1979,"September","1970s",73,76,10
"2816","197909020den","Denver Broncos",10,"Cincinnati Bengals",0,10,10,TRUE,"9/2/1979",1979,"September","1970s",69,38,6
"2817","197909030nwe","New England Patriots",13,"Pittsburgh Steelers",16,29,-3,FALSE,"9/3/1979",1979,"September","1970s",78,80,13
"2818","197909060den","Denver Broncos",9,"Los Angeles Rams",13,22,-4,FALSE,"9/6/1979",1979,"September","1970s",67,50,8
"2819","197909090nwe","New England Patriots",56,"New York Jets",3,59,53,TRUE,"9/9/1979",1979,"September","1970s",59,68,12
"2820","197909090sfo","San Francisco 49ers",13,"Dallas Cowboys",21,34,-8,FALSE,"9/9/1979",1979,"September","1970s",65,65,15
"2821","197909090nyg","New York Giants",14,"St. Louis Cardinals",27,41,-13,FALSE,"9/9/1979",1979,"September","1970s",63,54,13
"2822","197909090pit","Pittsburgh Steelers",38,"Houston Oilers",7,45,31,TRUE,"9/9/1979",1979,"September","1970s",55,69,6
"2823","197909090kan","Kansas City Chiefs",24,"Cleveland Browns",27,51,-3,FALSE,"9/9/1979",1979,"September","1970s",71,60,14
"2824","197909090chi","Chicago Bears",26,"Minnesota Vikings",7,33,19,TRUE,"9/9/1979",1979,"September","1970s",60,64,11
"2825","197909090clt","Baltimore Colts",26,"Tampa Bay Buccaneers",29,55,-3,FALSE,"9/9/1979",1979,"September","1970s",64,65,8
"2826","197909090det","Detroit Lions",24,"Washington Redskins",27,51,-3,FALSE,"9/9/1979",1979,"September","1970s",72,NA,NA
"2827","197909090mia","Miami Dolphins",19,"Seattle Seahawks",10,29,9,TRUE,"9/9/1979",1979,"September","1970s",81,81,13
"2828","197909090gnb","Green Bay Packers",28,"New Orleans Saints",19,47,9,TRUE,"9/9/1979",1979,"September","1970s",60,71,13
"2829","197909090buf","Buffalo Bills",51,"Cincinnati Bengals",24,75,27,TRUE,"9/9/1979",1979,"September","1970s",54,63,7
"2830","197909090sdg","San Diego Chargers",30,"Oakland Raiders",10,40,20,TRUE,"9/9/1979",1979,"September","1970s",73,82,9
"2831","197909100phi","Philadelphia Eagles",10,"Atlanta Falcons",14,24,-4,FALSE,"9/10/1979",1979,"September","1970s",65,72,7
"2832","197909160cle","Cleveland Browns",13,"Baltimore Colts",10,23,3,TRUE,"9/16/1979",1979,"September","1970s",59,71,9
"2833","197909160gnb","Green Bay Packers",10,"Tampa Bay Buccaneers",21,31,-11,FALSE,"9/16/1979",1979,"September","1970s",60,71,9
"2834","197909160min","Minnesota Vikings",12,"Miami Dolphins",27,39,-15,FALSE,"9/16/1979",1979,"September","1970s",64,58,11
"2835","197909160nor","New Orleans Saints",14,"Philadelphia Eagles",26,40,-12,FALSE,"9/16/1979",1979,"September","1970s",72,NA,NA
"2836","197909160oti","Houston Oilers",20,"Kansas City Chiefs",6,26,14,TRUE,"9/16/1979",1979,"September","1970s",72,NA,NA
"2837","197909160nyj","New York Jets",31,"Detroit Lions",10,41,21,TRUE,"9/16/1979",1979,"September","1970s",65,55,10
"2838","197909160dal","Dallas Cowboys",24,"Chicago Bears",20,44,4,TRUE,"9/16/1979",1979,"September","1970s",68,41,8
"2839","197909160sea","Seattle Seahawks",27,"Oakland Raiders",10,37,17,TRUE,"9/16/1979",1979,"September","1970s",72,NA,NA
"2840","197909160atl","Atlanta Falcons",17,"Denver Broncos",20,37,-3,FALSE,"9/16/1979",1979,"September","1970s",71,76,15
"2841","197909160ram","Los Angeles Rams",27,"San Francisco 49ers",24,51,3,TRUE,"9/16/1979",1979,"September","1970s",83,33,8
"2842","197909160crd","St. Louis Cardinals",21,"Pittsburgh Steelers",24,45,-3,FALSE,"9/16/1979",1979,"September","1970s",63,56,5
"2843","197909160cin","Cincinnati Bengals",14,"New England Patriots",20,34,-6,FALSE,"9/16/1979",1979,"September","1970s",58,59,7
"2844","197909160sdg","San Diego Chargers",27,"Buffalo Bills",19,46,8,TRUE,"9/16/1979",1979,"September","1970s",79,64,8
"2845","197909170was","Washington Redskins",27,"New York Giants",0,27,27,TRUE,"9/17/1979",1979,"September","1970s",68,72,6
"2846","197909230kan","Kansas City Chiefs",35,"Oakland Raiders",7,42,28,TRUE,"9/23/1979",1979,"September","1970s",65,47,10
"2847","197909230den","Denver Broncos",37,"Seattle Seahawks",34,71,3,TRUE,"9/23/1979",1979,"September","1970s",69,24,9
"2848","197909230pit","Pittsburgh Steelers",17,"Baltimore Colts",13,30,4,TRUE,"9/23/1979",1979,"September","1970s",54,65,10
"2849","197909230nyg","New York Giants",13,"Philadelphia Eagles",17,30,-4,FALSE,"9/23/1979",1979,"September","1970s",61,58,16
"2850","197909230min","Minnesota Vikings",27,"Green Bay Packers",21,48,6,TRUE,"9/23/1979",1979,"September","1970s",59,53,14
"2851","197909230nwe","New England Patriots",27,"San Diego Chargers",21,48,6,TRUE,"9/23/1979",1979,"September","1970s",55,72,14
"2852","197909230crd","St. Louis Cardinals",7,"Washington Redskins",17,24,-10,FALSE,"9/23/1979",1979,"September","1970s",61,53,8
"2853","197909230sfo","San Francisco 49ers",21,"New Orleans Saints",30,51,-9,FALSE,"9/23/1979",1979,"September","1970s",62,71,9
"2854","197909230buf","Buffalo Bills",46,"New York Jets",31,77,15,TRUE,"9/23/1979",1979,"September","1970s",50,66,9
"2855","197909230tam","Tampa Bay Buccaneers",21,"Los Angeles Rams",6,27,15,TRUE,"9/23/1979",1979,"September","1970s",82,76,8
"2856","197909230mia","Miami Dolphins",31,"Chicago Bears",16,47,15,TRUE,"9/23/1979",1979,"September","1970s",79,86,8
"2857","197909230det","Detroit Lions",24,"Atlanta Falcons",23,47,1,TRUE,"9/23/1979",1979,"September","1970s",72,NA,NA
"2858","197909230cin","Cincinnati Bengals",27,"Houston Oilers",30,57,-3,FALSE,"9/23/1979",1979,"September","1970s",56,64,11
"2859","197909240cle","Cleveland Browns",26,"Dallas Cowboys",7,33,19,TRUE,"9/24/1979",1979,"September","1970s",56,68,8
"2860","197909300ram","Los Angeles Rams",21,"St. Louis Cardinals",0,21,21,TRUE,"9/30/1979",1979,"September","1970s",65,80,10
"2861","197909300det","Detroit Lions",10,"Minnesota Vikings",13,23,-3,FALSE,"9/30/1979",1979,"September","1970s",72,NA,NA
"2862","197909300oti","Houston Oilers",31,"Cleveland Browns",10,41,21,TRUE,"9/30/1979",1979,"September","1970s",72,NA,NA
"2863","197909300sdg","San Diego Chargers",31,"San Francisco 49ers",9,40,22,TRUE,"9/30/1979",1979,"September","1970s",72,69,11
"2864","197909300nor","New Orleans Saints",24,"New York Giants",14,38,10,TRUE,"9/30/1979",1979,"September","1970s",72,NA,NA
"2865","197909300dal","Dallas Cowboys",38,"Cincinnati Bengals",13,51,25,TRUE,"9/30/1979",1979,"September","1970s",79,54,5
"2866","197909300clt","Baltimore Colts",13,"Buffalo Bills",31,44,-18,FALSE,"9/30/1979",1979,"September","1970s",71,90,7
"2867","197909300phi","Philadelphia Eagles",17,"Pittsburgh Steelers",14,31,3,TRUE,"9/30/1979",1979,"September","1970s",68,96,12
"2868","197909300sea","Seattle Seahawks",6,"Kansas City Chiefs",24,30,-18,FALSE,"9/30/1979",1979,"September","1970s",72,NA,NA
"2869","197909300rai","Oakland Raiders",27,"Denver Broncos",3,30,24,TRUE,"9/30/1979",1979,"September","1970s",64,78,8
"2870","197909300nyj","New York Jets",33,"Miami Dolphins",27,60,6,TRUE,"9/30/1979",1979,"September","1970s",67,83,13
"2871","197909300chi","Chicago Bears",13,"Tampa Bay Buccaneers",17,30,-4,FALSE,"9/30/1979",1979,"September","1970s",67,68,9
"2872","197909300atl","Atlanta Falcons",7,"Washington Redskins",16,23,-9,FALSE,"9/30/1979",1979,"September","1970s",72,79,8
"2873","197910010gnb","Green Bay Packers",27,"New England Patriots",14,41,13,TRUE,"10/1/1979",1979,"October","1970s",52,88,7
"2874","197910070buf","Buffalo Bills",0,"Chicago Bears",7,7,-7,FALSE,"10/7/1979",1979,"October","1970s",50,74,21
"2875","197910070clt","Baltimore Colts",10,"New York Jets",8,18,2,TRUE,"10/7/1979",1979,"October","1970s",57,65,14
"2876","197910070min","Minnesota Vikings",20,"Dallas Cowboys",36,56,-16,FALSE,"10/7/1979",1979,"October","1970s",43,65,5
"2877","197910070oti","Houston Oilers",17,"St. Louis Cardinals",24,41,-7,FALSE,"10/7/1979",1979,"October","1970s",72,NA,NA
"2878","197910070nyg","New York Giants",17,"Tampa Bay Buccaneers",14,31,3,TRUE,"10/7/1979",1979,"October","1970s",60,55,16
"2879","197910070nor","New Orleans Saints",17,"Los Angeles Rams",35,52,-18,FALSE,"10/7/1979",1979,"October","1970s",72,NA,NA
"2880","197910070cin","Cincinnati Bengals",7,"Kansas City Chiefs",10,17,-3,FALSE,"10/7/1979",1979,"October","1970s",49,68,14
"2881","197910070atl","Atlanta Falcons",25,"Green Bay Packers",7,32,18,TRUE,"10/7/1979",1979,"October","1970s",62,55,13
"2882","197910070phi","Philadelphia Eagles",28,"Washington Redskins",17,45,11,TRUE,"10/7/1979",1979,"October","1970s",57,76,14
"2883","197910070nwe","New England Patriots",24,"Detroit Lions",17,41,7,TRUE,"10/7/1979",1979,"October","1970s",56,88,13
"2884","197910070cle","Cleveland Browns",35,"Pittsburgh Steelers",51,86,-16,FALSE,"10/7/1979",1979,"October","1970s",48,87,17
"2885","197910070sfo","San Francisco 49ers",24,"Seattle Seahawks",35,59,-11,FALSE,"10/7/1979",1979,"October","1970s",61,77,14
"2886","197910070den","Denver Broncos",7,"San Diego Chargers",0,7,7,TRUE,"10/7/1979",1979,"October","1970s",67,26,11
"2887","197910080rai","Oakland Raiders",13,"Miami Dolphins",3,16,10,TRUE,"10/8/1979",1979,"October","1970s",63,78,12
"2888","197910140tam","Tampa Bay Buccaneers",14,"New Orleans Saints",42,56,-28,FALSE,"10/14/1979",1979,"October","1970s",75,84,11
"2889","197910140rai","Oakland Raiders",50,"Atlanta Falcons",19,69,31,TRUE,"10/14/1979",1979,"October","1970s",68,80,9
"2890","197910140mia","Miami Dolphins",17,"Buffalo Bills",7,24,10,TRUE,"10/14/1979",1979,"October","1970s",74,90,12
"2891","197910140gnb","Green Bay Packers",24,"Detroit Lions",16,40,8,TRUE,"10/14/1979",1979,"October","1970s",41,63,10
"2892","197910140dal","Dallas Cowboys",30,"Los Angeles Rams",6,36,24,TRUE,"10/14/1979",1979,"October","1970s",67,41,10
"2893","197910140crd","St. Louis Cardinals",20,"Philadelphia Eagles",24,44,-4,FALSE,"10/14/1979",1979,"October","1970s",47,50,9
"2894","197910140sdg","San Diego Chargers",20,"Seattle Seahawks",10,30,10,TRUE,"10/14/1979",1979,"October","1970s",72,78,8
"2895","197910140cle","Cleveland Browns",9,"Washington Redskins",13,22,-4,FALSE,"10/14/1979",1979,"October","1970s",44,76,12
"2896","197910140chi","Chicago Bears",7,"New England Patriots",27,34,-20,FALSE,"10/14/1979",1979,"October","1970s",45,47,9
"2897","197910140clt","Baltimore Colts",16,"Houston Oilers",28,44,-12,FALSE,"10/14/1979",1979,"October","1970s",46,62,13
"2898","197910140kan","Kansas City Chiefs",10,"Denver Broncos",24,34,-14,FALSE,"10/14/1979",1979,"October","1970s",47,43,12
"2899","197910140cin","Cincinnati Bengals",34,"Pittsburgh Steelers",10,44,24,TRUE,"10/14/1979",1979,"October","1970s",40,60,7
"2900","197910140nyg","New York Giants",32,"San Francisco 49ers",16,48,16,TRUE,"10/14/1979",1979,"October","1970s",49,54,18
"2901","197910150nyj","New York Jets",14,"Minnesota Vikings",7,21,7,TRUE,"10/15/1979",1979,"October","1970s",50,52,13
"2902","197910210nwe","New England Patriots",28,"Miami Dolphins",13,41,15,TRUE,"10/21/1979",1979,"October","1970s",65,85,14
"2903","197910210min","Minnesota Vikings",30,"Chicago Bears",27,57,3,TRUE,"10/21/1979",1979,"October","1970s",51,66,12
"2904","197910210nor","New Orleans Saints",17,"Detroit Lions",7,24,10,TRUE,"10/21/1979",1979,"October","1970s",72,NA,NA
"2905","197910210was","Washington Redskins",17,"Philadelphia Eagles",7,24,10,TRUE,"10/21/1979",1979,"October","1970s",70,86,9
"2906","197910210tam","Tampa Bay Buccaneers",21,"Green Bay Packers",3,24,18,TRUE,"10/21/1979",1979,"October","1970s",78,71,10
"2907","197910210nyj","New York Jets",28,"Oakland Raiders",19,47,9,TRUE,"10/21/1979",1979,"October","1970s",65,81,9
"2908","197910210sea","Seattle Seahawks",34,"Houston Oilers",14,48,20,TRUE,"10/21/1979",1979,"October","1970s",72,NA,NA
"2909","197910210sfo","San Francisco 49ers",20,"Atlanta Falcons",15,35,5,TRUE,"10/21/1979",1979,"October","1970s",57,72,7
"2910","197910210buf","Buffalo Bills",13,"Baltimore Colts",14,27,-1,FALSE,"10/21/1979",1979,"October","1970s",71,63,18
"2911","197910210ram","Los Angeles Rams",16,"San Diego Chargers",40,56,-24,FALSE,"10/21/1979",1979,"October","1970s",63,55,14
"2912","197910210dal","Dallas Cowboys",22,"St. Louis Cardinals",13,35,9,TRUE,"10/21/1979",1979,"October","1970s",81,63,24
"2913","197910210kan","Kansas City Chiefs",17,"New York Giants",21,38,-4,FALSE,"10/21/1979",1979,"October","1970s",79,57,30
"2914","197910210cle","Cleveland Browns",28,"Cincinnati Bengals",27,55,1,TRUE,"10/21/1979",1979,"October","1970s",71,68,18
"2915","197910220pit","Pittsburgh Steelers",42,"Denver Broncos",7,49,35,TRUE,"10/22/1979",1979,"October","1970s",68,65,9
"2916","197910250rai","Oakland Raiders",45,"San Diego Chargers",22,67,23,TRUE,"10/25/1979",1979,"October","1970s",66,79,17
"2917","197910280was","Washington Redskins",10,"New Orleans Saints",14,24,-4,FALSE,"10/28/1979",1979,"October","1970s",51,71,10
"2918","197910280ram","Los Angeles Rams",14,"New York Giants",20,34,-6,FALSE,"10/28/1979",1979,"October","1970s",62,82,8
"2919","197910280crd","St. Louis Cardinals",20,"Cleveland Browns",38,58,-18,FALSE,"10/28/1979",1979,"October","1970s",60,61,8
"2920","197910280min","Minnesota Vikings",10,"Tampa Bay Buccaneers",12,22,-2,FALSE,"10/28/1979",1979,"October","1970s",47,68,5
"2921","197910280clt","Baltimore Colts",31,"New England Patriots",26,57,5,TRUE,"10/28/1979",1979,"October","1970s",46,75,6
"2922","197910280pit","Pittsburgh Steelers",14,"Dallas Cowboys",3,17,11,TRUE,"10/28/1979",1979,"October","1970s",51,60,12
"2923","197910280den","Denver Broncos",20,"Kansas City Chiefs",3,23,17,TRUE,"10/28/1979",1979,"October","1970s",47,52,7
"2924","197910280oti","Houston Oilers",27,"New York Jets",24,51,3,TRUE,"10/28/1979",1979,"October","1970s",72,NA,NA
"2925","197910280mia","Miami Dolphins",27,"Green Bay Packers",7,34,20,TRUE,"10/28/1979",1979,"October","1970s",75,65,13
"2926","197910280sfo","San Francisco 49ers",27,"Chicago Bears",28,55,-1,FALSE,"10/28/1979",1979,"October","1970s",60,71,17
"2927","197910280cin","Cincinnati Bengals",37,"Philadelphia Eagles",13,50,24,TRUE,"10/28/1979",1979,"October","1970s",58,57,11
"2928","197910280det","Detroit Lions",17,"Buffalo Bills",20,37,-3,FALSE,"10/28/1979",1979,"October","1970s",72,NA,NA
"2929","197910290atl","Atlanta Falcons",28,"Seattle Seahawks",31,59,-3,FALSE,"10/29/1979",1979,"October","1970s",60,84,9
"2930","197911040kan","Kansas City Chiefs",14,"San Diego Chargers",20,34,-6,FALSE,"11/4/1979",1979,"November","1970s",47,45,16
"2931","197911040gnb","Green Bay Packers",22,"New York Jets",27,49,-5,FALSE,"11/4/1979",1979,"November","1970s",34,72,10
"2932","197911040pit","Pittsburgh Steelers",38,"Washington Redskins",7,45,31,TRUE,"11/4/1979",1979,"November","1970s",41,53,7
"2933","197911040clt","Baltimore Colts",38,"Cincinnati Bengals",28,66,10,TRUE,"11/4/1979",1979,"November","1970s",45,57,10
"2934","197911040atl","Atlanta Falcons",17,"Tampa Bay Buccaneers",14,31,3,TRUE,"11/4/1979",1979,"November","1970s",49,45,10
"2935","197911040nyg","New York Giants",14,"Dallas Cowboys",16,30,-2,FALSE,"11/4/1979",1979,"November","1970s",47,61,13
"2936","197911040sea","Seattle Seahawks",0,"Los Angeles Rams",24,24,-24,FALSE,"11/4/1979",1979,"November","1970s",72,NA,NA
"2937","197911040crd","St. Louis Cardinals",37,"Minnesota Vikings",7,44,30,TRUE,"11/4/1979",1979,"November","1970s",44,59,8
"2938","197911040buf","Buffalo Bills",6,"New England Patriots",26,32,-20,FALSE,"11/4/1979",1979,"November","1970s",42,68,11
"2939","197911040phi","Philadelphia Eagles",19,"Cleveland Browns",24,43,-5,FALSE,"11/4/1979",1979,"November","1970s",44,61,10
"2940","197911040rai","Oakland Raiders",23,"San Francisco 49ers",10,33,13,TRUE,"11/4/1979",1979,"November","1970s",59,81,9
"2941","197911040den","Denver Broncos",10,"New Orleans Saints",3,13,7,TRUE,"11/4/1979",1979,"November","1970s",38,58,7
"2942","197911040chi","Chicago Bears",35,"Detroit Lions",7,42,28,TRUE,"11/4/1979",1979,"November","1970s",38,58,9
"2943","197911050mia","Miami Dolphins",6,"Houston Oilers",9,15,-3,FALSE,"11/5/1979",1979,"November","1970s",77,70,17
"2944","197911110nyj","New York Jets",12,"Buffalo Bills",14,26,-2,FALSE,"11/11/1979",1979,"November","1970s",52,78,10
"2945","197911110chi","Chicago Bears",27,"Los Angeles Rams",23,50,4,TRUE,"11/11/1979",1979,"November","1970s",28,57,6
"2946","197911110was","Washington Redskins",30,"St. Louis Cardinals",28,58,2,TRUE,"11/11/1979",1979,"November","1970s",55,79,12
"2947","197911110mia","Miami Dolphins",19,"Baltimore Colts",0,19,19,TRUE,"11/11/1979",1979,"November","1970s",81,82,13
"2948","197911110kan","Kansas City Chiefs",3,"Pittsburgh Steelers",30,33,-27,FALSE,"11/11/1979",1979,"November","1970s",34,47,15
"2949","197911110gnb","Green Bay Packers",19,"Minnesota Vikings",7,26,12,TRUE,"11/11/1979",1979,"November","1970s",26,65,6
"2950","197911110den","Denver Broncos",45,"New England Patriots",10,55,35,TRUE,"11/11/1979",1979,"November","1970s",35,59,11
"2951","197911110nor","New Orleans Saints",31,"San Francisco 49ers",20,51,11,TRUE,"11/11/1979",1979,"November","1970s",72,NA,NA
"2952","197911110cin","Cincinnati Bengals",24,"San Diego Chargers",26,50,-2,FALSE,"11/11/1979",1979,"November","1970s",35,78,10
"2953","197911110oti","Houston Oilers",31,"Oakland Raiders",17,48,14,TRUE,"11/11/1979",1979,"November","1970s",72,NA,NA
"2954","197911110cle","Cleveland Browns",24,"Seattle Seahawks",29,53,-5,FALSE,"11/11/1979",1979,"November","1970s",36,75,12
"2955","197911110det","Detroit Lions",14,"Tampa Bay Buccaneers",16,30,-2,FALSE,"11/11/1979",1979,"November","1970s",72,NA,NA
"2956","197911110nyg","New York Giants",24,"Atlanta Falcons",3,27,21,TRUE,"11/11/1979",1979,"November","1970s",52,78,10
"2957","197911120dal","Dallas Cowboys",21,"Philadelphia Eagles",31,52,-10,FALSE,"11/12/1979",1979,"November","1970s",45,65,5
"2958","197911180sdg","San Diego Chargers",35,"Pittsburgh Steelers",7,42,28,TRUE,"11/18/1979",1979,"November","1970s",63,78,9
"2959","197911180sea","Seattle Seahawks",38,"New Orleans Saints",24,62,14,TRUE,"11/18/1979",1979,"November","1970s",72,NA,NA
"2960","197911180tam","Tampa Bay Buccaneers",31,"New York Giants",3,34,28,TRUE,"11/18/1979",1979,"November","1970s",63,68,7
"2961","197911180nwe","New England Patriots",50,"Baltimore Colts",21,71,29,TRUE,"11/18/1979",1979,"November","1970s",49,55,11
"2962","197911180was","Washington Redskins",34,"Dallas Cowboys",20,54,14,TRUE,"11/18/1979",1979,"November","1970s",56,59,7
"2963","197911180phi","Philadelphia Eagles",16,"St. Louis Cardinals",13,29,3,TRUE,"11/18/1979",1979,"November","1970s",50,62,8
"2964","197911180oti","Houston Oilers",42,"Cincinnati Bengals",21,63,21,TRUE,"11/18/1979",1979,"November","1970s",72,NA,NA
"2965","197911180sfo","San Francisco 49ers",28,"Denver Broncos",38,66,-10,FALSE,"11/18/1979",1979,"November","1970s",55,69,14
"2966","197911180min","Minnesota Vikings",14,"Detroit Lions",7,21,7,TRUE,"11/18/1979",1979,"November","1970s",47,70,9
"2967","197911180cle","Cleveland Browns",30,"Miami Dolphins",24,54,6,TRUE,"11/18/1979",1979,"November","1970s",50,61,12
"2968","197911180chi","Chicago Bears",23,"New York Jets",13,36,10,TRUE,"11/18/1979",1979,"November","1970s",56,51,12
"2969","197911180buf","Buffalo Bills",19,"Green Bay Packers",12,31,7,TRUE,"11/18/1979",1979,"November","1970s",44,88,10
"2970","197911180rai","Oakland Raiders",21,"Kansas City Chiefs",24,45,-3,FALSE,"11/18/1979",1979,"November","1970s",57,66,13
"2971","197911190ram","Los Angeles Rams",20,"Atlanta Falcons",14,34,6,TRUE,"11/19/1979",1979,"November","1970s",59,38,16
"2972","197911220det","Detroit Lions",20,"Chicago Bears",0,20,20,TRUE,"11/22/1979",1979,"November","1970s",72,NA,NA
"2973","197911220dal","Dallas Cowboys",24,"Houston Oilers",30,54,-6,FALSE,"11/22/1979",1979,"November","1970s",46,44,16
"2974","197911250atl","Atlanta Falcons",6,"New Orleans Saints",37,43,-31,FALSE,"11/25/1979",1979,"November","1970s",64,99,16
"2975","197911250clt","Baltimore Colts",24,"Miami Dolphins",28,52,-4,FALSE,"11/25/1979",1979,"November","1970s",63,85,8
"2976","197911250sfo","San Francisco 49ers",20,"Los Angeles Rams",26,46,-6,FALSE,"11/25/1979",1979,"November","1970s",55,80,10
"2977","197911250den","Denver Broncos",10,"Oakland Raiders",14,24,-4,FALSE,"11/25/1979",1979,"November","1970s",35,62,13
"2978","197911250nyg","New York Giants",14,"Washington Redskins",6,20,8,TRUE,"11/25/1979",1979,"November","1970s",61,76,10
"2979","197911250pit","Pittsburgh Steelers",33,"Cleveland Browns",30,63,3,TRUE,"11/25/1979",1979,"November","1970s",49,79,6
"2980","197911250tam","Tampa Bay Buccaneers",22,"Minnesota Vikings",23,45,-1,FALSE,"11/25/1979",1979,"November","1970s",75,69,12
"2981","197911250gnb","Green Bay Packers",10,"Philadelphia Eagles",21,31,-11,FALSE,"11/25/1979",1979,"November","1970s",35,91,6
"2982","197911250cin","Cincinnati Bengals",34,"St. Louis Cardinals",28,62,6,TRUE,"11/25/1979",1979,"November","1970s",42,92,11
"2983","197911250nwe","New England Patriots",13,"Buffalo Bills",16,29,-3,FALSE,"11/25/1979",1979,"November","1970s",62,78,11
"2984","197911250sdg","San Diego Chargers",28,"Kansas City Chiefs",7,35,21,TRUE,"11/25/1979",1979,"November","1970s",60,70,5
"2985","197911260sea","Seattle Seahawks",30,"New York Jets",7,37,23,TRUE,"11/26/1979",1979,"November","1970s",72,NA,NA
"2986","197911290mia","Miami Dolphins",39,"New England Patriots",24,63,15,TRUE,"11/29/1979",1979,"November","1970s",73,87,11
"2987","197912020tam","Tampa Bay Buccaneers",0,"Chicago Bears",14,14,-14,FALSE,"12/2/1979",1979,"December","1970s",53,48,9
"2988","197912020sdg","San Diego Chargers",26,"Atlanta Falcons",28,54,-2,FALSE,"12/2/1979",1979,"December","1970s",64,32,6
"2989","197912020nyj","New York Jets",30,"Baltimore Colts",17,47,13,TRUE,"12/2/1979",1979,"December","1970s",36,58,13
"2990","197912020ram","Los Angeles Rams",27,"Minnesota Vikings",21,48,6,TRUE,"12/2/1979",1979,"December","1970s",64,32,9
"2991","197912020kan","Kansas City Chiefs",37,"Seattle Seahawks",21,58,16,TRUE,"12/2/1979",1979,"December","1970s",21,51,10
"2992","197912020crd","St. Louis Cardinals",13,"San Francisco 49ers",10,23,3,TRUE,"12/2/1979",1979,"December","1970s",23,71,9
"2993","197912020cle","Cleveland Browns",14,"Houston Oilers",7,21,7,TRUE,"12/2/1979",1979,"December","1970s",28,70,15
"2994","197912020phi","Philadelphia Eagles",44,"Detroit Lions",7,51,37,TRUE,"12/2/1979",1979,"December","1970s",34,64,12
"2995","197912020pit","Pittsburgh Steelers",37,"Cincinnati Bengals",17,54,20,TRUE,"12/2/1979",1979,"December","1970s",28,59,12
"2996","197912020dal","Dallas Cowboys",28,"New York Giants",7,35,21,TRUE,"12/2/1979",1979,"December","1970s",41,39,7
"2997","197912020buf","Buffalo Bills",16,"Denver Broncos",19,35,-3,FALSE,"12/2/1979",1979,"December","1970s",25,80,14
"2998","197912020was","Washington Redskins",38,"Green Bay Packers",21,59,17,TRUE,"12/2/1979",1979,"December","1970s",39,54,15
"2999","197912030nor","New Orleans Saints",35,"Oakland Raiders",42,77,-7,FALSE,"12/3/1979",1979,"December","1970s",72,NA,NA
"3000","197912080sea","Seattle Seahawks",28,"Denver Broncos",23,51,5,TRUE,"12/8/1979",1979,"December","1970s",72,NA,NA
"3001","197912080phi","Philadelphia Eagles",17,"Dallas Cowboys",24,41,-7,FALSE,"12/8/1979",1979,"December","1970s",44,56,21
"3002","197912090rai","Oakland Raiders",19,"Cleveland Browns",14,33,5,TRUE,"12/9/1979",1979,"December","1970s",54,78,6
"3003","197912090gnb","Green Bay Packers",14,"Chicago Bears",15,29,-1,FALSE,"12/9/1979",1979,"December","1970s",29,64,17
"3004","197912090det","Detroit Lions",10,"Miami Dolphins",28,38,-18,FALSE,"12/9/1979",1979,"December","1970s",72,NA,NA
"3005","197912090nor","New Orleans Saints",0,"San Diego Chargers",35,35,-35,FALSE,"12/9/1979",1979,"December","1970s",72,NA,NA
"3006","197912090min","Minnesota Vikings",10,"Buffalo Bills",3,13,7,TRUE,"12/9/1979",1979,"December","1970s",32,56,12
"3007","197912090clt","Baltimore Colts",7,"Kansas City Chiefs",10,17,-3,FALSE,"12/9/1979",1979,"December","1970s",35,46,11
"3008","197912090was","Washington Redskins",28,"Cincinnati Bengals",14,42,14,TRUE,"12/9/1979",1979,"December","1970s",39,48,10
"3009","197912090atl","Atlanta Falcons",13,"Los Angeles Rams",34,47,-21,FALSE,"12/9/1979",1979,"December","1970s",42,41,11
"3010","197912090sfo","San Francisco 49ers",23,"Tampa Bay Buccaneers",7,30,16,TRUE,"12/9/1979",1979,"December","1970s",52,85,6
"3011","197912090nyj","New York Jets",27,"New England Patriots",26,53,1,TRUE,"12/9/1979",1979,"December","1970s",32,52,14
"3012","197912090crd","St. Louis Cardinals",29,"New York Giants",20,49,9,TRUE,"12/9/1979",1979,"December","1970s",39,48,11
"3013","197912100oti","Houston Oilers",20,"Pittsburgh Steelers",17,37,3,TRUE,"12/10/1979",1979,"December","1970s",72,NA,NA
"3014","197912150mia","Miami Dolphins",24,"New York Jets",27,51,-3,FALSE,"12/15/1979",1979,"December","1970s",75,82,7
"3015","197912150det","Detroit Lions",13,"Green Bay Packers",18,31,-5,FALSE,"12/15/1979",1979,"December","1970s",72,NA,NA
"3016","197912160tam","Tampa Bay Buccaneers",3,"Kansas City Chiefs",0,3,3,TRUE,"12/16/1979",1979,"December","1970s",67,92,8
"3017","197912160rai","Oakland Raiders",24,"Seattle Seahawks",29,53,-5,FALSE,"12/16/1979",1979,"December","1970s",50,69,7
"3018","197912160nwe","New England Patriots",27,"Minnesota Vikings",23,50,4,TRUE,"12/16/1979",1979,"December","1970s",40,80,14
"3019","197912160chi","Chicago Bears",42,"St. Louis Cardinals",6,48,36,TRUE,"12/16/1979",1979,"December","1970s",29,56,19
"3020","197912160atl","Atlanta Falcons",31,"San Francisco 49ers",21,52,10,TRUE,"12/16/1979",1979,"December","1970s",46,73,11
"3021","197912160pit","Pittsburgh Steelers",28,"Buffalo Bills",0,28,28,TRUE,"12/16/1979",1979,"December","1970s",38,50,13
"3022","197912160ram","Los Angeles Rams",14,"New Orleans Saints",29,43,-15,FALSE,"12/16/1979",1979,"December","1970s",57,42,7
"3023","197912160dal","Dallas Cowboys",35,"Washington Redskins",34,69,1,TRUE,"12/16/1979",1979,"December","1970s",40,71,12
"3024","197912160nyg","New York Giants",7,"Baltimore Colts",31,38,-24,FALSE,"12/16/1979",1979,"December","1970s",39,78,7
"3025","197912160oti","Houston Oilers",20,"Philadelphia Eagles",26,46,-6,FALSE,"12/16/1979",1979,"December","1970s",72,NA,NA
"3026","197912160cin","Cincinnati Bengals",16,"Cleveland Browns",12,28,4,TRUE,"12/16/1979",1979,"December","1970s",34,78,16
"3027","197912170sdg","San Diego Chargers",17,"Denver Broncos",7,24,10,TRUE,"12/17/1979",1979,"December","1970s",61,28,7
"3028","197912230oti","Houston Oilers",13,"Denver Broncos",7,20,6,TRUE,"12/23/1979",1979,"December","1970s",72,NA,NA
"3029","197912230phi","Philadelphia Eagles",27,"Chicago Bears",17,44,10,TRUE,"12/23/1979",1979,"December","1970s",42,99,5
"3030","197912290sdg","San Diego Chargers",14,"Houston Oilers",17,31,-3,FALSE,"12/29/1979",1979,"December","1970s",60,37,8
"3031","197912290tam","Tampa Bay Buccaneers",24,"Philadelphia Eagles",17,41,7,TRUE,"12/29/1979",1979,"December","1970s",60,76,6
"3032","197912300dal","Dallas Cowboys",19,"Los Angeles Rams",21,40,-2,FALSE,"12/30/1979",1979,"December","1970s",43,71,12
"3033","197912300pit","Pittsburgh Steelers",34,"Miami Dolphins",14,48,20,TRUE,"12/30/1979",1979,"December","1970s",25,73,7
"3034","198001060pit","Pittsburgh Steelers",27,"Houston Oilers",13,40,14,TRUE,"1/6/1980",1980,"January","1980s",18,66,18
"3035","198001200pit","Pittsburgh Steelers",31,"Los Angeles Rams",19,50,12,TRUE,"1/20/1980",1980,"January","1980s",54,53,8
"3036","198009070pit","Pittsburgh Steelers",31,"Houston Oilers",17,48,14,TRUE,"9/7/1980",1980,"September","1980s",70,60,8
"3037","198009070gnb","Green Bay Packers",12,"Chicago Bears",6,18,6,TRUE,"9/7/1980",1980,"September","1980s",65,77,5
"3038","198009070cin","Cincinnati Bengals",12,"Tampa Bay Buccaneers",17,29,-5,FALSE,"9/7/1980",1980,"September","1980s",72,81,9
"3039","198009070nyj","New York Jets",14,"Baltimore Colts",17,31,-3,FALSE,"9/7/1980",1980,"September","1980s",75,58,12
"3040","198009070crd","St. Louis Cardinals",35,"New York Giants",41,76,-6,FALSE,"9/7/1980",1980,"September","1980s",80,64,14
"3041","198009070nwe","New England Patriots",34,"Cleveland Browns",17,51,17,TRUE,"9/7/1980",1980,"September","1980s",73,46,12
"3042","198009070buf","Buffalo Bills",17,"Miami Dolphins",7,24,10,TRUE,"9/7/1980",1980,"September","1980s",64,66,8
"3043","198009070sea","Seattle Seahawks",13,"San Diego Chargers",34,47,-21,FALSE,"9/7/1980",1980,"September","1980s",72,NA,NA
"3044","198009070nor","New Orleans Saints",23,"San Francisco 49ers",26,49,-3,FALSE,"9/7/1980",1980,"September","1980s",72,NA,NA
"3045","198009070min","Minnesota Vikings",24,"Atlanta Falcons",23,47,1,TRUE,"9/7/1980",1980,"September","1980s",73,74,8
"3046","198009070phi","Philadelphia Eagles",27,"Denver Broncos",6,33,21,TRUE,"9/7/1980",1980,"September","1980s",76,51,11
"3047","198009070kan","Kansas City Chiefs",14,"Oakland Raiders",27,41,-13,FALSE,"9/7/1980",1980,"September","1980s",82,58,10
"3048","198009070ram","Los Angeles Rams",20,"Detroit Lions",41,61,-21,FALSE,"9/7/1980",1980,"September","1980s",66,70,11
"3049","198009080was","Washington Redskins",3,"Dallas Cowboys",17,20,-14,FALSE,"9/8/1980",1980,"September","1980s",78,46,9
"3050","198009110tam","Tampa Bay Buccaneers",10,"Los Angeles Rams",9,19,1,TRUE,"9/11/1980",1980,"September","1980s",76,86,7
"3051","198009140sfo","San Francisco 49ers",24,"St. Louis Cardinals",21,45,3,TRUE,"9/14/1980",1980,"September","1980s",58,70,16
"3052","198009140kan","Kansas City Chiefs",16,"Seattle Seahawks",17,33,-1,FALSE,"9/14/1980",1980,"September","1980s",68,66,9
"3053","198009140chi","Chicago Bears",22,"New Orleans Saints",3,25,19,TRUE,"9/14/1980",1980,"September","1980s",67,83,10
"3054","198009140nyg","New York Giants",21,"Washington Redskins",23,44,-2,FALSE,"9/14/1980",1980,"September","1980s",74,81,12
"3055","198009140buf","Buffalo Bills",20,"New York Jets",10,30,10,TRUE,"9/14/1980",1980,"September","1980s",68,92,13
"3056","198009140gnb","Green Bay Packers",7,"Detroit Lions",29,36,-22,FALSE,"9/14/1980",1980,"September","1980s",64,78,14
"3057","198009140den","Denver Broncos",41,"Dallas Cowboys",20,61,21,TRUE,"9/14/1980",1980,"September","1980s",67,53,8
"3058","198009140nwe","New England Patriots",21,"Atlanta Falcons",37,58,-16,FALSE,"9/14/1980",1980,"September","1980s",69,78,13
"3059","198009140sdg","San Diego Chargers",30,"Oakland Raiders",24,54,6,TRUE,"9/14/1980",1980,"September","1980s",68,68,8
"3060","198009140min","Minnesota Vikings",7,"Philadelphia Eagles",42,49,-35,FALSE,"9/14/1980",1980,"September","1980s",57,74,12
"3061","198009140mia","Miami Dolphins",17,"Cincinnati Bengals",16,33,1,TRUE,"9/14/1980",1980,"September","1980s",77,93,8
"3062","198009140clt","Baltimore Colts",17,"Pittsburgh Steelers",20,37,-3,FALSE,"9/14/1980",1980,"September","1980s",77,64,7
"3063","198009150cle","Cleveland Browns",7,"Houston Oilers",16,23,-9,FALSE,"9/15/1980",1980,"September","1980s",62,80,12
"3064","198009210chi","Chicago Bears",14,"Minnesota Vikings",34,48,-20,FALSE,"9/21/1980",1980,"September","1980s",77,66,14
"3065","198009210oti","Houston Oilers",21,"Baltimore Colts",16,37,5,TRUE,"9/21/1980",1980,"September","1980s",72,NA,NA
"3066","198009210cin","Cincinnati Bengals",30,"Pittsburgh Steelers",28,58,2,TRUE,"9/21/1980",1980,"September","1980s",76,79,12
"3067","198009210den","Denver Broncos",13,"San Diego Chargers",30,43,-17,FALSE,"9/21/1980",1980,"September","1980s",66,37,9
"3068","198009210atl","Atlanta Falcons",17,"Miami Dolphins",20,37,-3,FALSE,"9/21/1980",1980,"September","1980s",77,88,8
"3069","198009210ram","Los Angeles Rams",51,"Green Bay Packers",21,72,30,TRUE,"9/21/1980",1980,"September","1980s",67,70,9
"3070","198009210sea","Seattle Seahawks",31,"New England Patriots",37,68,-6,FALSE,"9/21/1980",1980,"September","1980s",72,NA,NA
"3071","198009210dal","Dallas Cowboys",28,"Tampa Bay Buccaneers",17,45,11,TRUE,"9/21/1980",1980,"September","1980s",86,58,19
"3072","198009210nor","New Orleans Saints",26,"Buffalo Bills",35,61,-9,FALSE,"9/21/1980",1980,"September","1980s",72,NA,NA
"3073","198009210det","Detroit Lions",20,"St. Louis Cardinals",7,27,13,TRUE,"9/21/1980",1980,"September","1980s",72,NA,NA
"3074","198009210cle","Cleveland Browns",20,"Kansas City Chiefs",13,33,7,TRUE,"9/21/1980",1980,"September","1980s",76,70,17
"3075","198009210nyj","New York Jets",27,"San Francisco 49ers",37,64,-10,FALSE,"9/21/1980",1980,"September","1980s",74,77,14
"3076","198009210rai","Oakland Raiders",24,"Washington Redskins",21,45,3,TRUE,"9/21/1980",1980,"September","1980s",62,74,8
"3077","198009220phi","Philadelphia Eagles",35,"New York Giants",3,38,32,TRUE,"9/22/1980",1980,"September","1980s",79,78,8
"3078","198009280sfo","San Francisco 49ers",17,"Atlanta Falcons",20,37,-3,FALSE,"9/28/1980",1980,"September","1980s",60,78,19
"3079","198009280gnb","Green Bay Packers",7,"Dallas Cowboys",28,35,-21,FALSE,"9/28/1980",1980,"September","1980s",55,82,9
"3080","198009280clt","Baltimore Colts",35,"New York Jets",21,56,14,TRUE,"9/28/1980",1980,"September","1980s",59,53,8
"3081","198009280buf","Buffalo Bills",24,"Oakland Raiders",7,31,17,TRUE,"9/28/1980",1980,"September","1980s",54,64,9
"3082","198009280pit","Pittsburgh Steelers",38,"Chicago Bears",3,41,35,TRUE,"9/28/1980",1980,"September","1980s",58,58,6
"3083","198009280tam","Tampa Bay Buccaneers",27,"Cleveland Browns",34,61,-7,FALSE,"9/28/1980",1980,"September","1980s",81,78,7
"3084","198009280crd","St. Louis Cardinals",24,"Philadelphia Eagles",14,38,10,TRUE,"9/28/1980",1980,"September","1980s",63,64,7
"3085","198009280mia","Miami Dolphins",21,"New Orleans Saints",16,37,5,TRUE,"9/28/1980",1980,"September","1980s",85,72,10
"3086","198009280nyg","New York Giants",7,"Los Angeles Rams",28,35,-21,FALSE,"9/28/1980",1980,"September","1980s",61,47,11
"3087","198009280kan","Kansas City Chiefs",7,"San Diego Chargers",24,31,-17,FALSE,"9/28/1980",1980,"September","1980s",58,59,8
"3088","198009280det","Detroit Lions",27,"Minnesota Vikings",7,34,20,TRUE,"9/28/1980",1980,"September","1980s",72,NA,NA
"3089","198009280was","Washington Redskins",0,"Seattle Seahawks",14,14,-14,FALSE,"9/28/1980",1980,"September","1980s",64,60,8
"3090","198009280cin","Cincinnati Bengals",10,"Houston Oilers",13,23,-3,FALSE,"9/28/1980",1980,"September","1980s",58,68,6
"3091","198009290nwe","New England Patriots",23,"Denver Broncos",14,37,9,TRUE,"9/29/1980",1980,"September","1980s",53,51,14
"3092","198010050atl","Atlanta Falcons",43,"Detroit Lions",28,71,15,TRUE,"10/5/1980",1980,"October","1980s",60,70,12
"3093","198010050rai","Oakland Raiders",17,"Kansas City Chiefs",31,48,-14,FALSE,"10/5/1980",1980,"October","1980s",62,83,8
"3094","198010050min","Minnesota Vikings",17,"Pittsburgh Steelers",23,40,-6,FALSE,"10/5/1980",1980,"October","1980s",45,60,11
"3095","198010050nor","New Orleans Saints",7,"St. Louis Cardinals",40,47,-33,FALSE,"10/5/1980",1980,"October","1980s",72,NA,NA
"3096","198010050cle","Cleveland Browns",16,"Denver Broncos",19,35,-3,FALSE,"10/5/1980",1980,"October","1980s",41,75,10
"3097","198010050mia","Miami Dolphins",17,"Baltimore Colts",30,47,-13,FALSE,"10/5/1980",1980,"October","1980s",79,84,8
"3098","198010050gnb","Green Bay Packers",14,"Cincinnati Bengals",9,23,5,TRUE,"10/5/1980",1980,"October","1980s",39,65,7
"3099","198010050sdg","San Diego Chargers",24,"Buffalo Bills",26,50,-2,FALSE,"10/5/1980",1980,"October","1980s",68,82,10
"3100","198010050phi","Philadelphia Eagles",24,"Washington Redskins",14,38,10,TRUE,"10/5/1980",1980,"October","1980s",54,59,6
"3101","198010050ram","Los Angeles Rams",48,"San Francisco 49ers",26,74,22,TRUE,"10/5/1980",1980,"October","1980s",65,79,7
"3102","198010050oti","Houston Oilers",7,"Seattle Seahawks",26,33,-19,FALSE,"10/5/1980",1980,"October","1980s",72,NA,NA
"3103","198010050nyj","New York Jets",11,"New England Patriots",21,32,-10,FALSE,"10/5/1980",1980,"October","1980s",58,53,11
"3104","198010050dal","Dallas Cowboys",24,"New York Giants",3,27,21,TRUE,"10/5/1980",1980,"October","1980s",69,46,10
"3105","198010060chi","Chicago Bears",23,"Tampa Bay Buccaneers",0,23,23,TRUE,"10/6/1980",1980,"October","1980s",49,59,14
"3106","198010120det","Detroit Lions",24,"New Orleans Saints",13,37,11,TRUE,"10/12/1980",1980,"October","1980s",72,NA,NA
"3107","198010120nyg","New York Giants",16,"Philadelphia Eagles",31,47,-15,FALSE,"10/12/1980",1980,"October","1980s",57,61,16
"3108","198010120pit","Pittsburgh Steelers",16,"Cincinnati Bengals",17,33,-1,FALSE,"10/12/1980",1980,"October","1980s",44,71,13
"3109","198010120buf","Buffalo Bills",12,"Baltimore Colts",17,29,-5,FALSE,"10/12/1980",1980,"October","1980s",49,74,12
"3110","198010120atl","Atlanta Falcons",7,"New York Jets",14,21,-7,FALSE,"10/12/1980",1980,"October","1980s",59,48,12
"3111","198010120dal","Dallas Cowboys",59,"San Francisco 49ers",14,73,45,TRUE,"10/12/1980",1980,"October","1980s",64,37,7
"3112","198010120crd","St. Louis Cardinals",13,"Los Angeles Rams",21,34,-8,FALSE,"10/12/1980",1980,"October","1980s",49,54,10
"3113","198010120tam","Tampa Bay Buccaneers",14,"Green Bay Packers",14,28,0,FALSE,"10/12/1980",1980,"October","1980s",73,66,7
"3114","198010120rai","Oakland Raiders",38,"San Diego Chargers",24,62,14,TRUE,"10/12/1980",1980,"October","1980s",62,78,8
"3115","198010120sea","Seattle Seahawks",3,"Cleveland Browns",27,30,-24,FALSE,"10/12/1980",1980,"October","1980s",72,NA,NA
"3116","198010120nwe","New England Patriots",34,"Miami Dolphins",0,34,34,TRUE,"10/12/1980",1980,"October","1980s",58,71,14
"3117","198010120min","Minnesota Vikings",13,"Chicago Bears",7,20,6,TRUE,"10/12/1980",1980,"October","1980s",38,62,7
"3118","198010120kan","Kansas City Chiefs",21,"Houston Oilers",20,41,1,TRUE,"10/12/1980",1980,"October","1980s",50,44,6
"3119","198010130den","Denver Broncos",20,"Washington Redskins",17,37,3,TRUE,"10/13/1980",1980,"October","1980s",61,33,10
"3120","198010190chi","Chicago Bears",24,"Detroit Lions",7,31,17,TRUE,"10/19/1980",1980,"October","1980s",47,58,13
"3121","198010190sfo","San Francisco 49ers",17,"Los Angeles Rams",31,48,-14,FALSE,"10/19/1980",1980,"October","1980s",55,76,11
"3122","198010190nyj","New York Jets",17,"Seattle Seahawks",27,44,-10,FALSE,"10/19/1980",1980,"October","1980s",62,70,14
"3123","198010190sdg","San Diego Chargers",44,"New York Giants",7,51,37,TRUE,"10/19/1980",1980,"October","1980s",67,44,9
"3124","198010190cin","Cincinnati Bengals",14,"Minnesota Vikings",0,14,14,TRUE,"10/19/1980",1980,"October","1980s",49,74,10
"3125","198010190was","Washington Redskins",23,"St. Louis Cardinals",0,23,23,TRUE,"10/19/1980",1980,"October","1980s",66,74,9
"3126","198010190cle","Cleveland Browns",26,"Green Bay Packers",21,47,5,TRUE,"10/19/1980",1980,"October","1980s",46,66,12
"3127","198010190oti","Houston Oilers",20,"Tampa Bay Buccaneers",14,34,6,TRUE,"10/19/1980",1980,"October","1980s",72,NA,NA
"3128","198010190clt","Baltimore Colts",21,"New England Patriots",37,58,-16,FALSE,"10/19/1980",1980,"October","1980s",62,72,7
"3129","198010190mia","Miami Dolphins",17,"Buffalo Bills",14,31,3,TRUE,"10/19/1980",1980,"October","1980s",80,72,8
"3130","198010190phi","Philadelphia Eagles",17,"Dallas Cowboys",10,27,7,TRUE,"10/19/1980",1980,"October","1980s",61,76,9
"3131","198010190nor","New Orleans Saints",14,"Atlanta Falcons",41,55,-27,FALSE,"10/19/1980",1980,"October","1980s",72,NA,NA
"3132","198010190den","Denver Broncos",17,"Kansas City Chiefs",23,40,-6,FALSE,"10/19/1980",1980,"October","1980s",49,34,8
"3133","198010200pit","Pittsburgh Steelers",34,"Oakland Raiders",45,79,-11,FALSE,"10/20/1980",1980,"October","1980s",42,71,12
"3134","198010260was","Washington Redskins",22,"New Orleans Saints",14,36,8,TRUE,"10/26/1980",1980,"October","1980s",49,43,21
"3135","198010260nyg","New York Giants",9,"Denver Broncos",14,23,-5,FALSE,"10/26/1980",1980,"October","1980s",47,62,30
"3136","198010260phi","Philadelphia Eagles",17,"Chicago Bears",14,31,3,TRUE,"10/26/1980",1980,"October","1980s",45,60,21
"3137","198010260dal","Dallas Cowboys",42,"San Diego Chargers",31,73,11,TRUE,"10/26/1980",1980,"October","1980s",55,59,9
"3138","198010260kan","Kansas City Chiefs",20,"Detroit Lions",17,37,3,TRUE,"10/26/1980",1980,"October","1980s",37,63,10
"3139","198010260atl","Atlanta Falcons",13,"Los Angeles Rams",10,23,3,TRUE,"10/26/1980",1980,"October","1980s",48,64,11
"3140","198010260oti","Houston Oilers",23,"Cincinnati Bengals",3,26,20,TRUE,"10/26/1980",1980,"October","1980s",72,NA,NA
"3141","198010260sfo","San Francisco 49ers",23,"Tampa Bay Buccaneers",24,47,-1,FALSE,"10/26/1980",1980,"October","1980s",56,72,11
"3142","198010260cle","Cleveland Browns",27,"Pittsburgh Steelers",26,53,1,TRUE,"10/26/1980",1980,"October","1980s",37,54,25
"3143","198010260gnb","Green Bay Packers",16,"Minnesota Vikings",3,19,13,TRUE,"10/26/1980",1980,"October","1980s",35,54,16
"3144","198010260rai","Oakland Raiders",33,"Seattle Seahawks",14,47,19,TRUE,"10/26/1980",1980,"October","1980s",57,82,7
"3145","198010260clt","Baltimore Colts",10,"St. Louis Cardinals",17,27,-7,FALSE,"10/26/1980",1980,"October","1980s",45,47,24
"3146","198010260buf","Buffalo Bills",31,"New England Patriots",13,44,18,TRUE,"10/26/1980",1980,"October","1980s",41,71,26
"3147","198010270nyj","New York Jets",17,"Miami Dolphins",14,31,3,TRUE,"10/27/1980",1980,"October","1980s",47,52,21
"3148","198011020den","Denver Broncos",16,"Houston Oilers",20,36,-4,FALSE,"11/2/1980",1980,"November","1980s",54,21,11
"3149","198011020tam","Tampa Bay Buccaneers",30,"New York Giants",13,43,17,TRUE,"11/2/1980",1980,"November","1980s",67,70,8
"3150","198011020pit","Pittsburgh Steelers",22,"Green Bay Packers",20,42,2,TRUE,"11/2/1980",1980,"November","1980s",40,58,6
"3151","198011020sea","Seattle Seahawks",20,"Philadelphia Eagles",27,47,-7,FALSE,"11/2/1980",1980,"November","1980s",72,NA,NA
"3152","198011020was","Washington Redskins",14,"Minnesota Vikings",39,53,-25,FALSE,"11/2/1980",1980,"November","1980s",50,45,15
"3153","198011020kan","Kansas City Chiefs",24,"Baltimore Colts",31,55,-7,FALSE,"11/2/1980",1980,"November","1980s",51,52,10
"3154","198011020crd","St. Louis Cardinals",24,"Dallas Cowboys",27,51,-3,FALSE,"11/2/1980",1980,"November","1980s",49,59,12
"3155","198011020nwe","New England Patriots",34,"New York Jets",21,55,13,TRUE,"11/2/1980",1980,"November","1980s",40,46,15
"3156","198011020rai","Oakland Raiders",16,"Miami Dolphins",10,26,6,TRUE,"11/2/1980",1980,"November","1980s",58,56,6
"3157","198011020det","Detroit Lions",17,"San Francisco 49ers",13,30,4,TRUE,"11/2/1980",1980,"November","1980s",72,NA,NA
"3158","198011020ram","Los Angeles Rams",45,"New Orleans Saints",31,76,14,TRUE,"11/2/1980",1980,"November","1980s",65,48,7
"3159","198011020cin","Cincinnati Bengals",14,"San Diego Chargers",31,45,-17,FALSE,"11/2/1980",1980,"November","1980s",42,58,6
"3160","198011020buf","Buffalo Bills",14,"Atlanta Falcons",30,44,-16,FALSE,"11/2/1980",1980,"November","1980s",40,59,9
"3161","198011030cle","Cleveland Browns",27,"Chicago Bears",21,48,6,TRUE,"11/3/1980",1980,"November","1980s",48,44,15
"3162","198011090chi","Chicago Bears",35,"Washington Redskins",21,56,14,TRUE,"11/9/1980",1980,"November","1980s",58,52,15
"3163","198011090min","Minnesota Vikings",34,"Detroit Lions",0,34,34,TRUE,"11/9/1980",1980,"November","1980s",45,64,15
"3164","198011090ram","Los Angeles Rams",14,"Miami Dolphins",35,49,-21,FALSE,"11/9/1980",1980,"November","1980s",59,82,6
"3165","198011090gnb","Green Bay Packers",23,"San Francisco 49ers",16,39,7,TRUE,"11/9/1980",1980,"November","1980s",51,63,17
"3166","198011090sea","Seattle Seahawks",30,"Kansas City Chiefs",31,61,-1,FALSE,"11/9/1980",1980,"November","1980s",72,NA,NA
"3167","198011090nyj","New York Jets",24,"Buffalo Bills",31,55,-7,FALSE,"11/9/1980",1980,"November","1980s",44,66,12
"3168","198011090nor","New Orleans Saints",21,"Philadelphia Eagles",34,55,-13,FALSE,"11/9/1980",1980,"November","1980s",72,NA,NA
"3169","198011090nyg","New York Giants",38,"Dallas Cowboys",35,73,3,TRUE,"11/9/1980",1980,"November","1980s",44,66,12
"3170","198011090clt","Baltimore Colts",27,"Cleveland Browns",28,55,-1,FALSE,"11/9/1980",1980,"November","1980s",52,66,6
"3171","198011090tam","Tampa Bay Buccaneers",21,"Pittsburgh Steelers",24,45,-3,FALSE,"11/9/1980",1980,"November","1980s",74,78,6
"3172","198011090crd","St. Louis Cardinals",27,"Atlanta Falcons",33,60,-6,FALSE,"11/9/1980",1980,"November","1980s",66,45,17
"3173","198011090sdg","San Diego Chargers",13,"Denver Broncos",20,33,-7,FALSE,"11/9/1980",1980,"November","1980s",61,86,6
"3174","198011090rai","Oakland Raiders",28,"Cincinnati Bengals",17,45,11,TRUE,"11/9/1980",1980,"November","1980s",57,80,5
"3175","198011100oti","Houston Oilers",38,"New England Patriots",34,72,4,TRUE,"11/10/1980",1980,"November","1980s",72,NA,NA
"3176","198011160pit","Pittsburgh Steelers",16,"Cleveland Browns",13,29,3,TRUE,"11/16/1980",1980,"November","1980s",36,59,8
"3177","198011160sdg","San Diego Chargers",20,"Kansas City Chiefs",7,27,13,TRUE,"11/16/1980",1980,"November","1980s",60,37,8
"3178","198011160was","Washington Redskins",0,"Philadelphia Eagles",24,24,-24,FALSE,"11/16/1980",1980,"November","1980s",45,70,16
"3179","198011160nyg","New York Giants",27,"Green Bay Packers",21,48,6,TRUE,"11/16/1980",1980,"November","1980s",40,53,15
"3180","198011160cin","Cincinnati Bengals",0,"Buffalo Bills",14,14,-14,FALSE,"11/16/1980",1980,"November","1980s",34,86,11
"3181","198011160chi","Chicago Bears",6,"Houston Oilers",10,16,-4,FALSE,"11/16/1980",1980,"November","1980s",35,71,6
"3182","198011160det","Detroit Lions",9,"Baltimore Colts",10,19,-1,FALSE,"11/16/1980",1980,"November","1980s",72,NA,NA
"3183","198011160min","Minnesota Vikings",38,"Tampa Bay Buccaneers",30,68,8,TRUE,"11/16/1980",1980,"November","1980s",35,64,7
"3184","198011160den","Denver Broncos",31,"New York Jets",24,55,7,TRUE,"11/16/1980",1980,"November","1980s",24,75,5
"3185","198011160atl","Atlanta Falcons",31,"New Orleans Saints",13,44,18,TRUE,"11/16/1980",1980,"November","1980s",60,90,11
"3186","198011160nwe","New England Patriots",14,"Los Angeles Rams",17,31,-3,FALSE,"11/16/1980",1980,"November","1980s",34,46,14
"3187","198011160mia","Miami Dolphins",17,"San Francisco 49ers",13,30,4,TRUE,"11/16/1980",1980,"November","1980s",77,90,9
"3188","198011160dal","Dallas Cowboys",31,"St. Louis Cardinals",21,52,10,TRUE,"11/16/1980",1980,"November","1980s",44,82,18
"3189","198011170sea","Seattle Seahawks",17,"Oakland Raiders",19,36,-2,FALSE,"11/17/1980",1980,"November","1980s",72,NA,NA
"3190","198011200mia","Miami Dolphins",24,"San Diego Chargers",27,51,-3,FALSE,"11/20/1980",1980,"November","1980s",64,72,12
"3191","198011230sfo","San Francisco 49ers",12,"New York Giants",0,12,12,TRUE,"11/23/1980",1980,"November","1980s",56,84,11
"3192","198011230phi","Philadelphia Eagles",10,"Oakland Raiders",7,17,3,TRUE,"11/23/1980",1980,"November","1980s",37,69,5
"3193","198011230nyj","New York Jets",31,"Houston Oilers",28,59,3,TRUE,"11/23/1980",1980,"November","1980s",42,59,9
"3194","198011230den","Denver Broncos",36,"Seattle Seahawks",20,56,16,TRUE,"11/23/1980",1980,"November","1980s",34,70,10
"3195","198011230cle","Cleveland Browns",31,"Cincinnati Bengals",7,38,24,TRUE,"11/23/1980",1980,"November","1980s",40,59,13
"3196","198011230buf","Buffalo Bills",28,"Pittsburgh Steelers",13,41,15,TRUE,"11/23/1980",1980,"November","1980s",41,49,10
"3197","198011230tam","Tampa Bay Buccaneers",10,"Detroit Lions",24,34,-14,FALSE,"11/23/1980",1980,"November","1980s",69,77,9
"3198","198011230dal","Dallas Cowboys",14,"Washington Redskins",10,24,4,TRUE,"11/23/1980",1980,"November","1980s",47,93,8
"3199","198011230nwe","New England Patriots",47,"Baltimore Colts",21,68,26,TRUE,"11/23/1980",1980,"November","1980s",39,63,8
"3200","198011230crd","St. Louis Cardinals",13,"Kansas City Chiefs",21,34,-8,FALSE,"11/23/1980",1980,"November","1980s",45,83,11
"3201","198011230min","Minnesota Vikings",13,"Green Bay Packers",25,38,-12,FALSE,"11/23/1980",1980,"November","1980s",39,58,14
"3202","198011230atl","Atlanta Falcons",28,"Chicago Bears",17,45,11,TRUE,"11/23/1980",1980,"November","1980s",47,62,15
"3203","198011240nor","New Orleans Saints",7,"Los Angeles Rams",27,34,-20,FALSE,"11/24/1980",1980,"November","1980s",72,NA,NA
"3204","198011270dal","Dallas Cowboys",51,"Seattle Seahawks",7,58,44,TRUE,"11/27/1980",1980,"November","1980s",40,70,14
"3205","198011270det","Detroit Lions",17,"Chicago Bears",23,40,-6,FALSE,"11/27/1980",1980,"November","1980s",72,NA,NA
"3206","198011300kan","Kansas City Chiefs",6,"Cincinnati Bengals",20,26,-14,FALSE,"11/30/1980",1980,"November","1980s",49,45,19
"3207","198011300oti","Houston Oilers",14,"Cleveland Browns",17,31,-3,FALSE,"11/30/1980",1980,"November","1980s",72,NA,NA
"3208","198011300nyg","New York Giants",7,"St. Louis Cardinals",23,30,-16,FALSE,"11/30/1980",1980,"November","1980s",39,65,18
"3209","198011300pit","Pittsburgh Steelers",23,"Miami Dolphins",10,33,13,TRUE,"11/30/1980",1980,"November","1980s",36,74,14
"3210","198011300sfo","San Francisco 49ers",21,"New England Patriots",17,38,4,TRUE,"11/30/1980",1980,"November","1980s",56,76,8
"3211","198011300ram","Los Angeles Rams",38,"New York Jets",13,51,25,TRUE,"11/30/1980",1980,"November","1980s",59,82,7
"3212","198011300atl","Atlanta Falcons",10,"Washington Redskins",6,16,4,TRUE,"11/30/1980",1980,"November","1980s",44,45,8
"3213","198011300clt","Baltimore Colts",28,"Buffalo Bills",24,52,4,TRUE,"11/30/1980",1980,"November","1980s",43,52,14
"3214","198011300sdg","San Diego Chargers",22,"Philadelphia Eagles",21,43,1,TRUE,"11/30/1980",1980,"November","1980s",61,81,6
"3215","198011300nor","New Orleans Saints",20,"Minnesota Vikings",23,43,-3,FALSE,"11/30/1980",1980,"November","1980s",72,NA,NA
"3216","198011300gnb","Green Bay Packers",17,"Tampa Bay Buccaneers",20,37,-3,FALSE,"11/30/1980",1980,"November","1980s",37,65,16
"3217","198012010rai","Oakland Raiders",9,"Denver Broncos",3,12,6,TRUE,"12/1/1980",1980,"December","1980s",51,79,6
"3218","198012040oti","Houston Oilers",6,"Pittsburgh Steelers",0,6,6,TRUE,"12/4/1980",1980,"December","1980s",72,NA,NA
"3219","198012070was","Washington Redskins",40,"San Diego Chargers",17,57,23,TRUE,"12/7/1980",1980,"December","1980s",54,65,7
"3220","198012070phi","Philadelphia Eagles",17,"Atlanta Falcons",20,37,-3,FALSE,"12/7/1980",1980,"December","1980s",46,46,7
"3221","198012070tam","Tampa Bay Buccaneers",10,"Minnesota Vikings",21,31,-11,FALSE,"12/7/1980",1980,"December","1980s",64,72,7
"3222","198012070cle","Cleveland Browns",17,"New York Jets",14,31,3,TRUE,"12/7/1980",1980,"December","1980s",54,83,11
"3223","198012070sea","Seattle Seahawks",21,"New York Giants",27,48,-6,FALSE,"12/7/1980",1980,"December","1980s",72,NA,NA
"3224","198012070cin","Cincinnati Bengals",34,"Baltimore Colts",33,67,1,TRUE,"12/7/1980",1980,"December","1980s",58,70,12
"3225","198012070buf","Buffalo Bills",10,"Los Angeles Rams",7,17,3,TRUE,"12/7/1980",1980,"December","1980s",43,83,9
"3226","198012070chi","Chicago Bears",61,"Green Bay Packers",7,68,54,TRUE,"12/7/1980",1980,"December","1980s",56,90,10
"3227","198012070crd","St. Louis Cardinals",24,"Detroit Lions",23,47,1,TRUE,"12/7/1980",1980,"December","1980s",62,86,12
"3228","198012070kan","Kansas City Chiefs",31,"Denver Broncos",14,45,17,TRUE,"12/7/1980",1980,"December","1980s",39,82,11
"3229","198012070sfo","San Francisco 49ers",38,"New Orleans Saints",35,73,3,TRUE,"12/7/1980",1980,"December","1980s",48,53,12
"3230","198012070rai","Oakland Raiders",13,"Dallas Cowboys",19,32,-6,FALSE,"12/7/1980",1980,"December","1980s",48,62,8
"3231","198012080mia","Miami Dolphins",16,"New England Patriots",13,29,3,TRUE,"12/8/1980",1980,"December","1980s",75,58,16
"3232","198012130sdg","San Diego Chargers",21,"Seattle Seahawks",14,35,7,TRUE,"12/13/1980",1980,"December","1980s",60,48,6
"3233","198012130was","Washington Redskins",16,"New York Giants",13,29,3,TRUE,"12/13/1980",1980,"December","1980s",49,61,12
"3234","198012140den","Denver Broncos",21,"Oakland Raiders",24,45,-3,FALSE,"12/14/1980",1980,"December","1980s",41,37,9
"3235","198012140chi","Chicago Bears",14,"Cincinnati Bengals",17,31,-3,FALSE,"12/14/1980",1980,"December","1980s",27,60,14
"3236","198012140nwe","New England Patriots",24,"Buffalo Bills",2,26,22,TRUE,"12/14/1980",1980,"December","1980s",28,55,15
"3237","198012140det","Detroit Lions",27,"Tampa Bay Buccaneers",14,41,13,TRUE,"12/14/1980",1980,"December","1980s",72,NA,NA
"3238","198012140gnb","Green Bay Packers",3,"Houston Oilers",22,25,-19,FALSE,"12/14/1980",1980,"December","1980s",19,51,14
"3239","198012140atl","Atlanta Falcons",35,"San Francisco 49ers",10,45,25,TRUE,"12/14/1980",1980,"December","1980s",45,52,14
"3240","198012140phi","Philadelphia Eagles",17,"St. Louis Cardinals",3,20,14,TRUE,"12/14/1980",1980,"December","1980s",34,51,15
"3241","198012140min","Minnesota Vikings",28,"Cleveland Browns",23,51,5,TRUE,"12/14/1980",1980,"December","1980s",23,52,12
"3242","198012140pit","Pittsburgh Steelers",21,"Kansas City Chiefs",16,37,5,TRUE,"12/14/1980",1980,"December","1980s",26,63,17
"3243","198012140nyj","New York Jets",20,"New Orleans Saints",21,41,-1,FALSE,"12/14/1980",1980,"December","1980s",31,59,21
"3244","198012140clt","Baltimore Colts",14,"Miami Dolphins",24,38,-10,FALSE,"12/14/1980",1980,"December","1980s",37,46,16
"3245","198012150ram","Los Angeles Rams",38,"Dallas Cowboys",14,52,24,TRUE,"12/15/1980",1980,"December","1980s",60,40,5
"3246","198012200tam","Tampa Bay Buccaneers",13,"Chicago Bears",14,27,-1,FALSE,"12/20/1980",1980,"December","1980s",59,72,8
"3247","198012200mia","Miami Dolphins",17,"New York Jets",24,41,-7,FALSE,"12/20/1980",1980,"December","1980s",69,61,12
"3248","198012210det","Detroit Lions",24,"Green Bay Packers",3,27,21,TRUE,"12/21/1980",1980,"December","1980s",72,NA,NA
"3249","198012210ram","Los Angeles Rams",20,"Atlanta Falcons",17,37,3,TRUE,"12/21/1980",1980,"December","1980s",57,79,7
"3250","198012210sea","Seattle Seahawks",17,"Denver Broncos",25,42,-8,FALSE,"12/21/1980",1980,"December","1980s",72,NA,NA
"3251","198012210cin","Cincinnati Bengals",24,"Cleveland Browns",27,51,-3,FALSE,"12/21/1980",1980,"December","1980s",14,62,7
"3252","198012210clt","Baltimore Colts",28,"Kansas City Chiefs",38,66,-10,FALSE,"12/21/1980",1980,"December","1980s",18,51,9
"3253","198012210nyg","New York Giants",17,"Oakland Raiders",33,50,-16,FALSE,"12/21/1980",1980,"December","1980s",19,58,16
"3254","198012210dal","Dallas Cowboys",35,"Philadelphia Eagles",27,62,8,TRUE,"12/21/1980",1980,"December","1980s",28,50,9
"3255","198012210sfo","San Francisco 49ers",13,"Buffalo Bills",18,31,-5,FALSE,"12/21/1980",1980,"December","1980s",53,82,6
"3256","198012210oti","Houston Oilers",20,"Minnesota Vikings",16,36,4,TRUE,"12/21/1980",1980,"December","1980s",72,NA,NA
"3257","198012210nor","New Orleans Saints",27,"New England Patriots",38,65,-11,FALSE,"12/21/1980",1980,"December","1980s",72,NA,NA
"3258","198012210crd","St. Louis Cardinals",7,"Washington Redskins",31,38,-24,FALSE,"12/21/1980",1980,"December","1980s",15,54,7
"3259","198012220sdg","San Diego Chargers",26,"Pittsburgh Steelers",17,43,9,TRUE,"12/22/1980",1980,"December","1980s",57,87,7
"3260","198012280rai","Oakland Raiders",27,"Houston Oilers",7,34,20,TRUE,"12/28/1980",1980,"December","1980s",51,90,5
"3261","198012280dal","Dallas Cowboys",34,"Los Angeles Rams",13,47,21,TRUE,"12/28/1980",1980,"December","1980s",49,59,12
"3262","198101030sdg","San Diego Chargers",20,"Buffalo Bills",14,34,6,TRUE,"1/3/1981",1981,"January","1980s",61,83,9
"3263","198101030phi","Philadelphia Eagles",31,"Minnesota Vikings",16,47,15,TRUE,"1/3/1981",1981,"January","1980s",24,58,10
"3264","198101040cle","Cleveland Browns",12,"Oakland Raiders",14,26,-2,FALSE,"1/4/1981",1981,"January","1980s",2,65,21
"3265","198101040atl","Atlanta Falcons",27,"Dallas Cowboys",30,57,-3,FALSE,"1/4/1981",1981,"January","1980s",40,39,16
"3266","198101110sdg","San Diego Chargers",27,"Oakland Raiders",34,61,-7,FALSE,"1/11/1981",1981,"January","1980s",67,51,8
"3267","198101110phi","Philadelphia Eagles",20,"Dallas Cowboys",7,27,13,TRUE,"1/11/1981",1981,"January","1980s",12,58,12
"3268","198101250phi","Philadelphia Eagles",10,"Oakland Raiders",27,37,-17,FALSE,"1/25/1981",1981,"January","1980s",72,NA,NA
"3269","198109050tam","Tampa Bay Buccaneers",21,"Minnesota Vikings",13,34,8,TRUE,"9/5/1981",1981,"September","1980s",81,74,8
"3270","198109060atl","Atlanta Falcons",27,"New Orleans Saints",0,27,27,TRUE,"9/6/1981",1981,"September","1980s",77,76,8
"3271","198109060ram","Los Angeles Rams",20,"Houston Oilers",27,47,-7,FALSE,"9/6/1981",1981,"September","1980s",69,73,9
"3272","198109060chi","Chicago Bears",9,"Green Bay Packers",16,25,-7,FALSE,"9/6/1981",1981,"September","1980s",63,84,8
"3273","198109060nyg","New York Giants",10,"Philadelphia Eagles",24,34,-14,FALSE,"9/6/1981",1981,"September","1980s",70,64,11
"3274","198109060cin","Cincinnati Bengals",27,"Seattle Seahawks",21,48,6,TRUE,"9/6/1981",1981,"September","1980s",69,71,8
"3275","198109060nwe","New England Patriots",28,"Baltimore Colts",29,57,-1,FALSE,"9/6/1981",1981,"September","1980s",62,79,10
"3276","198109060den","Denver Broncos",9,"Oakland Raiders",7,16,2,TRUE,"9/6/1981",1981,"September","1980s",67,58,9
"3277","198109060crd","St. Louis Cardinals",7,"Miami Dolphins",20,27,-13,FALSE,"9/6/1981",1981,"September","1980s",71,71,4
"3278","198109060was","Washington Redskins",10,"Dallas Cowboys",26,36,-16,FALSE,"9/6/1981",1981,"September","1980s",75,80,8
"3279","198109060pit","Pittsburgh Steelers",33,"Kansas City Chiefs",37,70,-4,FALSE,"9/6/1981",1981,"September","1980s",67,81,4
"3280","198109060det","Detroit Lions",24,"San Francisco 49ers",17,41,7,TRUE,"9/6/1981",1981,"September","1980s",72,NA,NA
"3281","198109060buf","Buffalo Bills",31,"New York Jets",0,31,31,TRUE,"9/6/1981",1981,"September","1980s",66,94,8
"3282","198109070cle","Cleveland Browns",14,"San Diego Chargers",44,58,-30,FALSE,"9/7/1981",1981,"September","1980s",66,80,6
"3283","198109100mia","Miami Dolphins",30,"Pittsburgh Steelers",10,40,20,TRUE,"9/10/1981",1981,"September","1980s",81,80,10
"3284","198109130phi","Philadelphia Eagles",13,"New England Patriots",3,16,10,TRUE,"9/13/1981",1981,"September","1980s",74,68,6
"3285","198109130sea","Seattle Seahawks",13,"Denver Broncos",10,23,3,TRUE,"9/13/1981",1981,"September","1980s",72,NA,NA
"3286","198109130was","Washington Redskins",7,"New York Giants",17,24,-10,FALSE,"9/13/1981",1981,"September","1980s",81,63,7
"3287","198109130nor","New Orleans Saints",23,"Los Angeles Rams",17,40,6,TRUE,"9/13/1981",1981,"September","1980s",72,NA,NA
"3288","198109130dal","Dallas Cowboys",30,"St. Louis Cardinals",17,47,13,TRUE,"9/13/1981",1981,"September","1980s",82,62,9
"3289","198109130sfo","San Francisco 49ers",28,"Chicago Bears",17,45,11,TRUE,"9/13/1981",1981,"September","1980s",62,70,12
"3290","198109130kan","Kansas City Chiefs",19,"Tampa Bay Buccaneers",10,29,9,TRUE,"9/13/1981",1981,"September","1980s",74,66,4
"3291","198109130nyj","New York Jets",30,"Cincinnati Bengals",31,61,-1,FALSE,"9/13/1981",1981,"September","1980s",75,50,16
"3292","198109130sdg","San Diego Chargers",28,"Detroit Lions",23,51,5,TRUE,"9/13/1981",1981,"September","1980s",73,81,11
"3293","198109130cle","Cleveland Browns",3,"Houston Oilers",9,12,-6,FALSE,"9/13/1981",1981,"September","1980s",72,73,8
"3294","198109130clt","Baltimore Colts",3,"Buffalo Bills",35,38,-32,FALSE,"9/13/1981",1981,"September","1980s",78,61,7
"3295","198109130gnb","Green Bay Packers",17,"Atlanta Falcons",31,48,-14,FALSE,"9/13/1981",1981,"September","1980s",65,73,8
"3296","198109140min","Minnesota Vikings",10,"Oakland Raiders",36,46,-26,FALSE,"9/14/1981",1981,"September","1980s",66,48,13
"3297","198109170buf","Buffalo Bills",14,"Philadelphia Eagles",20,34,-6,FALSE,"9/17/1981",1981,"September","1980s",55,83,8
"3298","198109200chi","Chicago Bears",28,"Tampa Bay Buccaneers",17,45,11,TRUE,"9/20/1981",1981,"September","1980s",58,68,8
"3299","198109200crd","St. Louis Cardinals",40,"Washington Redskins",30,70,10,TRUE,"9/20/1981",1981,"September","1980s",68,58,9
"3300","198109200cin","Cincinnati Bengals",17,"Cleveland Browns",20,37,-3,FALSE,"9/20/1981",1981,"September","1980s",63,59,14
"3301","198109200atl","Atlanta Falcons",34,"San Francisco 49ers",17,51,17,TRUE,"9/20/1981",1981,"September","1980s",61,65,8
"3302","198109200min","Minnesota Vikings",26,"Detroit Lions",24,50,2,TRUE,"9/20/1981",1981,"September","1980s",58,58,5
"3303","198109200kan","Kansas City Chiefs",31,"San Diego Chargers",42,73,-11,FALSE,"9/20/1981",1981,"September","1980s",68,54,14
"3304","198109200oti","Houston Oilers",10,"Miami Dolphins",16,26,-6,FALSE,"9/20/1981",1981,"September","1980s",72,NA,NA
"3305","198109200pit","Pittsburgh Steelers",38,"New York Jets",10,48,28,TRUE,"9/20/1981",1981,"September","1980s",59,64,17
"3306","198109200ram","Los Angeles Rams",35,"Green Bay Packers",23,58,12,TRUE,"9/20/1981",1981,"September","1980s",69,80,7
"3307","198109200nyg","New York Giants",20,"New Orleans Saints",7,27,13,TRUE,"9/20/1981",1981,"September","1980s",61,59,20
"3308","198109200den","Denver Broncos",28,"Baltimore Colts",10,38,18,TRUE,"9/20/1981",1981,"September","1980s",70,25,10
"3309","198109200rai","Oakland Raiders",20,"Seattle Seahawks",10,30,10,TRUE,"9/20/1981",1981,"September","1980s",64,74,10
"3310","198109210nwe","New England Patriots",21,"Dallas Cowboys",35,56,-14,FALSE,"9/21/1981",1981,"September","1980s",62,50,13
"3311","198109270pit","Pittsburgh Steelers",27,"New England Patriots",21,48,6,TRUE,"9/27/1981",1981,"September","1980s",68,67,17
"3312","198109270clt","Baltimore Colts",28,"Miami Dolphins",31,59,-3,FALSE,"9/27/1981",1981,"September","1980s",67,65,8
"3313","198109270tam","Tampa Bay Buccaneers",20,"St. Louis Cardinals",10,30,10,TRUE,"9/27/1981",1981,"September","1980s",77,68,8
"3314","198109270sfo","San Francisco 49ers",21,"New Orleans Saints",14,35,7,TRUE,"9/27/1981",1981,"September","1980s",64,79,12
"3315","198109270sea","Seattle Seahawks",14,"Kansas City Chiefs",20,34,-6,FALSE,"9/27/1981",1981,"September","1980s",72,NA,NA
"3316","198109270cle","Cleveland Browns",28,"Atlanta Falcons",17,45,11,TRUE,"9/27/1981",1981,"September","1980s",70,56,17
"3317","198109270gnb","Green Bay Packers",13,"Minnesota Vikings",30,43,-17,FALSE,"9/27/1981",1981,"September","1980s",58,67,24
"3318","198109270den","Denver Broncos",42,"San Diego Chargers",24,66,18,TRUE,"9/27/1981",1981,"September","1980s",63,28,6
"3319","198109270dal","Dallas Cowboys",18,"New York Giants",10,28,8,TRUE,"9/27/1981",1981,"September","1980s",82,59,10
"3320","198109270nyj","New York Jets",33,"Houston Oilers",17,50,16,TRUE,"9/27/1981",1981,"September","1980s",69,68,15
"3321","198109270cin","Cincinnati Bengals",27,"Buffalo Bills",24,51,3,TRUE,"9/27/1981",1981,"September","1980s",73,55,13
"3322","198109270det","Detroit Lions",16,"Oakland Raiders",0,16,16,TRUE,"9/27/1981",1981,"September","1980s",72,NA,NA
"3323","198109270phi","Philadelphia Eagles",36,"Washington Redskins",13,49,23,TRUE,"9/27/1981",1981,"September","1980s",68,66,9
"3324","198109280chi","Chicago Bears",7,"Los Angeles Rams",24,31,-17,FALSE,"9/28/1981",1981,"September","1980s",53,59,10
"3325","198110040nor","New Orleans Saints",6,"Pittsburgh Steelers",20,26,-14,FALSE,"10/4/1981",1981,"October","1980s",72,NA,NA
"3326","198110040ram","Los Angeles Rams",27,"Cleveland Browns",16,43,11,TRUE,"10/4/1981",1981,"October","1980s",64,71,10
"3327","198110040mia","Miami Dolphins",28,"New York Jets",28,56,0,FALSE,"10/4/1981",1981,"October","1980s",82,69,10
"3328","198110040buf","Buffalo Bills",23,"Baltimore Colts",17,40,6,TRUE,"10/4/1981",1981,"October","1980s",47,70,11
"3329","198110040rai","Oakland Raiders",0,"Denver Broncos",17,17,-17,FALSE,"10/4/1981",1981,"October","1980s",58,76,11
"3330","198110040tam","Tampa Bay Buccaneers",28,"Detroit Lions",10,38,18,TRUE,"10/4/1981",1981,"October","1980s",76,76,9
"3331","198110040was","Washington Redskins",17,"San Francisco 49ers",30,47,-13,FALSE,"10/4/1981",1981,"October","1980s",58,59,10
"3332","198110040nwe","New England Patriots",33,"Kansas City Chiefs",17,50,16,TRUE,"10/4/1981",1981,"October","1980s",52,58,16
"3333","198110040nyg","New York Giants",14,"Green Bay Packers",27,41,-13,FALSE,"10/4/1981",1981,"October","1980s",53,56,17
"3334","198110040sdg","San Diego Chargers",24,"Seattle Seahawks",10,34,14,TRUE,"10/4/1981",1981,"October","1980s",69,68,8
"3335","198110040min","Minnesota Vikings",24,"Chicago Bears",21,45,3,TRUE,"10/4/1981",1981,"October","1980s",50,82,13
"3336","198110040crd","St. Louis Cardinals",20,"Dallas Cowboys",17,37,3,TRUE,"10/4/1981",1981,"October","1980s",64,54,13
"3337","198110040oti","Houston Oilers",17,"Cincinnati Bengals",10,27,7,TRUE,"10/4/1981",1981,"October","1980s",72,NA,NA
"3338","198110050phi","Philadelphia Eagles",16,"Atlanta Falcons",13,29,3,TRUE,"10/5/1981",1981,"October","1980s",62,66,7
"3339","198110110nyg","New York Giants",34,"St. Louis Cardinals",14,48,20,TRUE,"10/11/1981",1981,"October","1980s",52,54,11
"3340","198110110sfo","San Francisco 49ers",45,"Dallas Cowboys",14,59,31,TRUE,"10/11/1981",1981,"October","1980s",58,67,18
"3341","198110110den","Denver Broncos",27,"Detroit Lions",21,48,6,TRUE,"10/11/1981",1981,"October","1980s",64,33,14
"3342","198110110gnb","Green Bay Packers",10,"Tampa Bay Buccaneers",21,31,-11,FALSE,"10/11/1981",1981,"October","1980s",49,85,7
"3343","198110110kan","Kansas City Chiefs",27,"Oakland Raiders",0,27,27,TRUE,"10/11/1981",1981,"October","1980s",57,75,12
"3344","198110110atl","Atlanta Falcons",35,"Los Angeles Rams",37,72,-2,FALSE,"10/11/1981",1981,"October","1980s",60,88,11
"3345","198110110clt","Baltimore Colts",19,"Cincinnati Bengals",41,60,-22,FALSE,"10/11/1981",1981,"October","1980s",52,67,4
"3346","198110110pit","Pittsburgh Steelers",13,"Cleveland Browns",7,20,6,TRUE,"10/11/1981",1981,"October","1980s",51,68,6
"3347","198110110sdg","San Diego Chargers",31,"Minnesota Vikings",33,64,-2,FALSE,"10/11/1981",1981,"October","1980s",68,69,13
"3348","198110110chi","Chicago Bears",7,"Washington Redskins",24,31,-17,FALSE,"10/11/1981",1981,"October","1980s",48,78,8
"3349","198110110nyj","New York Jets",28,"New England Patriots",24,52,4,TRUE,"10/11/1981",1981,"October","1980s",52,54,11
"3350","198110110nor","New Orleans Saints",14,"Philadelphia Eagles",31,45,-17,FALSE,"10/11/1981",1981,"October","1980s",72,NA,NA
"3351","198110110oti","Houston Oilers",35,"Seattle Seahawks",17,52,18,TRUE,"10/11/1981",1981,"October","1980s",72,NA,NA
"3352","198110120buf","Buffalo Bills",31,"Miami Dolphins",21,52,10,TRUE,"10/12/1981",1981,"October","1980s",44,63,8
"3353","198110180cin","Cincinnati Bengals",34,"Pittsburgh Steelers",7,41,27,TRUE,"10/18/1981",1981,"October","1980s",57,69,20
"3354","198110180min","Minnesota Vikings",35,"Philadelphia Eagles",23,58,12,TRUE,"10/18/1981",1981,"October","1980s",44,61,27
"3355","198110180sea","Seattle Seahawks",0,"New York Giants",32,32,-32,FALSE,"10/18/1981",1981,"October","1980s",72,NA,NA
"3356","198110180kan","Kansas City Chiefs",28,"Denver Broncos",14,42,14,TRUE,"10/18/1981",1981,"October","1980s",49,53,23
"3357","198110180dal","Dallas Cowboys",29,"Los Angeles Rams",17,46,12,TRUE,"10/18/1981",1981,"October","1980s",64,55,15
"3358","198110180rai","Oakland Raiders",18,"Tampa Bay Buccaneers",16,34,2,TRUE,"10/18/1981",1981,"October","1980s",59,81,8
"3359","198110180nwe","New England Patriots",38,"Houston Oilers",10,48,28,TRUE,"10/18/1981",1981,"October","1980s",51,77,14
"3360","198110180gnb","Green Bay Packers",3,"San Francisco 49ers",13,16,-10,FALSE,"10/18/1981",1981,"October","1980s",47,78,21
"3361","198110180clt","Baltimore Colts",14,"San Diego Chargers",43,57,-29,FALSE,"10/18/1981",1981,"October","1980s",53,73,10
"3362","198110180atl","Atlanta Falcons",41,"St. Louis Cardinals",20,61,21,TRUE,"10/18/1981",1981,"October","1980s",68,71,16
"3363","198110180mia","Miami Dolphins",13,"Washington Redskins",10,23,3,TRUE,"10/18/1981",1981,"October","1980s",76,66,7
"3364","198110180cle","Cleveland Browns",20,"New Orleans Saints",17,37,3,TRUE,"10/18/1981",1981,"October","1980s",57,53,27
"3365","198110180nyj","New York Jets",33,"Buffalo Bills",14,47,19,TRUE,"10/18/1981",1981,"October","1980s",55,70,17
"3366","198110190det","Detroit Lions",48,"Chicago Bears",17,65,31,TRUE,"10/19/1981",1981,"October","1980s",72,NA,NA
"3367","198110250nyj","New York Jets",3,"Seattle Seahawks",19,22,-16,FALSE,"10/25/1981",1981,"October","1980s",48,64,13
"3368","198110250dal","Dallas Cowboys",28,"Miami Dolphins",27,55,1,TRUE,"10/25/1981",1981,"October","1980s",54,74,12
"3369","198110250phi","Philadelphia Eagles",20,"Tampa Bay Buccaneers",10,30,10,TRUE,"10/25/1981",1981,"October","1980s",45,73,9
"3370","198110250det","Detroit Lions",31,"Green Bay Packers",27,58,4,TRUE,"10/25/1981",1981,"October","1980s",72,NA,NA
"3371","198110250cle","Cleveland Browns",42,"Baltimore Colts",28,70,14,TRUE,"10/25/1981",1981,"October","1980s",40,53,10
"3372","198110250nor","New Orleans Saints",17,"Cincinnati Bengals",7,24,10,TRUE,"10/25/1981",1981,"October","1980s",72,NA,NA
"3373","198110250crd","St. Louis Cardinals",30,"Minnesota Vikings",17,47,13,TRUE,"10/25/1981",1981,"October","1980s",45,52,9
"3374","198110250sfo","San Francisco 49ers",20,"Los Angeles Rams",17,37,3,TRUE,"10/25/1981",1981,"October","1980s",56,78,11
"3375","198110250atl","Atlanta Falcons",24,"New York Giants",27,51,-3,FALSE,"10/25/1981",1981,"October","1980s",44,94,16
"3376","198110250was","Washington Redskins",24,"New England Patriots",22,46,2,TRUE,"10/25/1981",1981,"October","1980s",49,79,9
"3377","198110250rai","Oakland Raiders",17,"Kansas City Chiefs",28,45,-11,FALSE,"10/25/1981",1981,"October","1980s",58,85,10
"3378","198110250buf","Buffalo Bills",9,"Denver Broncos",7,16,2,TRUE,"10/25/1981",1981,"October","1980s",41,56,10
"3379","198110250chi","Chicago Bears",20,"San Diego Chargers",17,37,3,TRUE,"10/25/1981",1981,"October","1980s",39,55,9
"3380","198110260pit","Pittsburgh Steelers",26,"Houston Oilers",13,39,13,TRUE,"10/26/1981",1981,"October","1980s",53,90,10
"3381","198111010pit","Pittsburgh Steelers",14,"San Francisco 49ers",17,31,-3,FALSE,"11/1/1981",1981,"November","1980s",50,67,8
"3382","198111010buf","Buffalo Bills",22,"Cleveland Browns",13,35,9,TRUE,"11/1/1981",1981,"November","1980s",51,67,8
"3383","198111010ram","Los Angeles Rams",20,"Detroit Lions",13,33,7,TRUE,"11/1/1981",1981,"November","1980s",70,25,8
"3384","198111010gnb","Green Bay Packers",34,"Seattle Seahawks",24,58,10,TRUE,"11/1/1981",1981,"November","1980s",50,75,5
"3385","198111010mia","Miami Dolphins",27,"Baltimore Colts",10,37,17,TRUE,"11/1/1981",1981,"November","1980s",78,66,22
"3386","198111010nor","New Orleans Saints",10,"Atlanta Falcons",41,51,-31,FALSE,"11/1/1981",1981,"November","1980s",72,NA,NA
"3387","198111010cin","Cincinnati Bengals",34,"Houston Oilers",21,55,13,TRUE,"11/1/1981",1981,"November","1980s",60,72,5
"3388","198111010sdg","San Diego Chargers",22,"Kansas City Chiefs",20,42,2,TRUE,"11/1/1981",1981,"November","1980s",68,32,6
"3389","198111010rai","Oakland Raiders",27,"New England Patriots",17,44,10,TRUE,"11/1/1981",1981,"November","1980s",59,73,6
"3390","198111010nyg","New York Giants",7,"New York Jets",26,33,-19,FALSE,"11/1/1981",1981,"November","1980s",52,71,11
"3391","198111010phi","Philadelphia Eagles",14,"Dallas Cowboys",17,31,-3,FALSE,"11/1/1981",1981,"November","1980s",53,73,6
"3392","198111010was","Washington Redskins",42,"St. Louis Cardinals",21,63,21,TRUE,"11/1/1981",1981,"November","1980s",59,77,8
"3393","198111010tam","Tampa Bay Buccaneers",20,"Chicago Bears",10,30,10,TRUE,"11/1/1981",1981,"November","1980s",72,81,13
"3394","198111020den","Denver Broncos",19,"Minnesota Vikings",17,36,2,TRUE,"11/2/1981",1981,"November","1980s",51,42,10
"3395","198111080ram","Los Angeles Rams",13,"New Orleans Saints",21,34,-8,FALSE,"11/8/1981",1981,"November","1980s",64,63,7
"3396","198111080sdg","San Diego Chargers",17,"Cincinnati Bengals",40,57,-23,FALSE,"11/8/1981",1981,"November","1980s",65,73,9
"3397","198111080nwe","New England Patriots",27,"Miami Dolphins",30,57,-3,FALSE,"11/8/1981",1981,"November","1980s",44,42,15
"3398","198111080sea","Seattle Seahawks",24,"Pittsburgh Steelers",21,45,3,TRUE,"11/8/1981",1981,"November","1980s",72,NA,NA
"3399","198111080oti","Houston Oilers",17,"Oakland Raiders",16,33,1,TRUE,"11/8/1981",1981,"November","1980s",72,NA,NA
"3400","198111080min","Minnesota Vikings",25,"Tampa Bay Buccaneers",10,35,15,TRUE,"11/8/1981",1981,"November","1980s",47,46,19
"3401","198111080was","Washington Redskins",33,"Detroit Lions",31,64,2,TRUE,"11/8/1981",1981,"November","1980s",55,41,11
"3402","198111080crd","St. Louis Cardinals",10,"Philadelphia Eagles",52,62,-42,FALSE,"11/8/1981",1981,"November","1980s",57,54,8
"3403","198111080gnb","Green Bay Packers",26,"New York Giants",24,50,2,TRUE,"11/8/1981",1981,"November","1980s",46,59,13
"3404","198111080clt","Baltimore Colts",14,"New York Jets",41,55,-27,FALSE,"11/8/1981",1981,"November","1980s",49,43,12
"3405","198111080den","Denver Broncos",23,"Cleveland Browns",20,43,3,TRUE,"11/8/1981",1981,"November","1980s",48,36,10
"3406","198111080sfo","San Francisco 49ers",17,"Atlanta Falcons",14,31,3,TRUE,"11/8/1981",1981,"November","1980s",54,82,10
"3407","198111080kan","Kansas City Chiefs",13,"Chicago Bears",16,29,-3,FALSE,"11/8/1981",1981,"November","1980s",53,65,13
"3408","198111090dal","Dallas Cowboys",27,"Buffalo Bills",14,41,13,TRUE,"11/9/1981",1981,"November","1980s",50,80,20
"3409","198111150crd","St. Louis Cardinals",24,"Buffalo Bills",0,24,24,TRUE,"11/15/1981",1981,"November","1980s",51,70,6
"3410","198111150phi","Philadelphia Eagles",38,"Baltimore Colts",13,51,25,TRUE,"11/15/1981",1981,"November","1980s",51,61,17
"3411","198111150mia","Miami Dolphins",17,"Oakland Raiders",33,50,-16,FALSE,"11/15/1981",1981,"November","1980s",69,61,8
"3412","198111150kan","Kansas City Chiefs",23,"Houston Oilers",10,33,13,TRUE,"11/15/1981",1981,"November","1980s",56,59,10
"3413","198111150nyg","New York Giants",27,"Washington Redskins",30,57,-3,FALSE,"11/15/1981",1981,"November","1980s",49,68,20
"3414","198111150gnb","Green Bay Packers",21,"Chicago Bears",17,38,4,TRUE,"11/15/1981",1981,"November","1980s",44,74,7
"3415","198111150min","Minnesota Vikings",20,"New Orleans Saints",10,30,10,TRUE,"11/15/1981",1981,"November","1980s",53,73,12
"3416","198111150sfo","San Francisco 49ers",12,"Cleveland Browns",15,27,-3,FALSE,"11/15/1981",1981,"November","1980s",60,79,15
"3417","198111150nwe","New England Patriots",6,"New York Jets",17,23,-11,FALSE,"11/15/1981",1981,"November","1980s",45,92,20
"3418","198111150cin","Cincinnati Bengals",24,"Los Angeles Rams",10,34,14,TRUE,"11/15/1981",1981,"November","1980s",42,48,3
"3419","198111150det","Detroit Lions",27,"Dallas Cowboys",24,51,3,TRUE,"11/15/1981",1981,"November","1980s",72,NA,NA
"3420","198111150atl","Atlanta Falcons",20,"Pittsburgh Steelers",34,54,-14,FALSE,"11/15/1981",1981,"November","1980s",53,49,11
"3421","198111150tam","Tampa Bay Buccaneers",7,"Denver Broncos",24,31,-17,FALSE,"11/15/1981",1981,"November","1980s",56,58,7
"3422","198111160sea","Seattle Seahawks",44,"San Diego Chargers",23,67,21,TRUE,"11/16/1981",1981,"November","1980s",72,NA,NA
"3423","198111220nyj","New York Jets",16,"Miami Dolphins",15,31,1,TRUE,"11/22/1981",1981,"November","1980s",41,51,20
"3424","198111220phi","Philadelphia Eagles",10,"New York Giants",20,30,-10,FALSE,"11/22/1981",1981,"November","1980s",39,52,16
"3425","198111220rai","Oakland Raiders",21,"San Diego Chargers",55,76,-34,FALSE,"11/22/1981",1981,"November","1980s",60,96,9
"3426","198111220cle","Cleveland Browns",10,"Pittsburgh Steelers",32,42,-22,FALSE,"11/22/1981",1981,"November","1980s",30,72,15
"3427","198111220dal","Dallas Cowboys",24,"Washington Redskins",10,34,14,TRUE,"11/22/1981",1981,"November","1980s",51,60,7
"3428","198111220ram","Los Angeles Rams",31,"San Francisco 49ers",33,64,-2,FALSE,"11/22/1981",1981,"November","1980s",60,79,8
"3429","198111220chi","Chicago Bears",7,"Detroit Lions",23,30,-16,FALSE,"11/22/1981",1981,"November","1980s",21,81,6
"3430","198111220cin","Cincinnati Bengals",38,"Denver Broncos",21,59,17,TRUE,"11/22/1981",1981,"November","1980s",30,60,9
"3431","198111220oti","Houston Oilers",24,"New Orleans Saints",27,51,-3,FALSE,"11/22/1981",1981,"November","1980s",72,NA,NA
"3432","198111220clt","Baltimore Colts",24,"St. Louis Cardinals",35,59,-11,FALSE,"11/22/1981",1981,"November","1980s",39,48,16
"3433","198111220tam","Tampa Bay Buccaneers",37,"Green Bay Packers",3,40,34,TRUE,"11/22/1981",1981,"November","1980s",49,61,6
"3434","198111220kan","Kansas City Chiefs",40,"Seattle Seahawks",13,53,27,TRUE,"11/22/1981",1981,"November","1980s",37,62,9
"3435","198111220buf","Buffalo Bills",20,"New England Patriots",17,37,3,TRUE,"11/22/1981",1981,"November","1980s",31,82,19
"3436","198111230atl","Atlanta Falcons",31,"Minnesota Vikings",30,61,1,TRUE,"11/23/1981",1981,"November","1980s",45,47,5
"3437","198111260det","Detroit Lions",27,"Kansas City Chiefs",10,37,17,TRUE,"11/26/1981",1981,"November","1980s",72,NA,NA
"3438","198111260dal","Dallas Cowboys",10,"Chicago Bears",9,19,1,TRUE,"11/26/1981",1981,"November","1980s",68,62,22
"3439","198111290buf","Buffalo Bills",21,"Washington Redskins",14,35,7,TRUE,"11/29/1981",1981,"November","1980s",34,77,16
"3440","198111290nwe","New England Patriots",20,"St. Louis Cardinals",27,47,-7,FALSE,"11/29/1981",1981,"November","1980s",37,50,18
"3441","198111290nyj","New York Jets",25,"Baltimore Colts",0,25,25,TRUE,"11/29/1981",1981,"November","1980s",42,48,23
"3442","198111290pit","Pittsburgh Steelers",24,"Los Angeles Rams",0,24,24,TRUE,"11/29/1981",1981,"November","1980s",33,58,12
"3443","198111290nor","New Orleans Saints",14,"Tampa Bay Buccaneers",31,45,-17,FALSE,"11/29/1981",1981,"November","1980s",72,NA,NA
"3444","198111290cle","Cleveland Browns",21,"Cincinnati Bengals",41,62,-20,FALSE,"11/29/1981",1981,"November","1980s",36,53,10
"3445","198111290sdg","San Diego Chargers",34,"Denver Broncos",17,51,17,TRUE,"11/29/1981",1981,"November","1980s",57,86,7
"3446","198111290min","Minnesota Vikings",23,"Green Bay Packers",35,58,-12,FALSE,"11/29/1981",1981,"November","1980s",30,77,9
"3447","198111290sea","Seattle Seahawks",31,"Oakland Raiders",32,63,-1,FALSE,"11/29/1981",1981,"November","1980s",72,NA,NA
"3448","198111290sfo","San Francisco 49ers",17,"New York Giants",10,27,7,TRUE,"11/29/1981",1981,"November","1980s",49,77,10
"3449","198111290oti","Houston Oilers",27,"Atlanta Falcons",31,58,-4,FALSE,"11/29/1981",1981,"November","1980s",72,NA,NA
"3450","198111300mia","Miami Dolphins",13,"Philadelphia Eagles",10,23,3,TRUE,"11/30/1981",1981,"November","1980s",73,74,8
"3451","198112030oti","Houston Oilers",17,"Cleveland Browns",13,30,4,TRUE,"12/3/1981",1981,"December","1980s",72,NA,NA
"3452","198112060was","Washington Redskins",15,"Philadelphia Eagles",13,28,2,TRUE,"12/6/1981",1981,"December","1980s",43,45,21
"3453","198112060tam","Tampa Bay Buccaneers",24,"Atlanta Falcons",23,47,1,TRUE,"12/6/1981",1981,"December","1980s",48,62,6
"3454","198112060sdg","San Diego Chargers",27,"Buffalo Bills",28,55,-1,FALSE,"12/6/1981",1981,"December","1980s",59,81,9
"3455","198112060nyg","New York Giants",10,"Los Angeles Rams",7,17,3,TRUE,"12/6/1981",1981,"December","1980s",36,50,28
"3456","198112060sea","Seattle Seahawks",27,"New York Jets",23,50,4,TRUE,"12/6/1981",1981,"December","1980s",72,NA,NA
"3457","198112060chi","Chicago Bears",10,"Minnesota Vikings",9,19,1,TRUE,"12/6/1981",1981,"December","1980s",33,76,12
"3458","198112060mia","Miami Dolphins",24,"New England Patriots",14,38,10,TRUE,"12/6/1981",1981,"December","1980s",60,65,13
"3459","198112060crd","St. Louis Cardinals",30,"New Orleans Saints",3,33,27,TRUE,"12/6/1981",1981,"December","1980s",43,68,10
"3460","198112060clt","Baltimore Colts",13,"Dallas Cowboys",37,50,-24,FALSE,"12/6/1981",1981,"December","1980s",39,43,20
"3461","198112060gnb","Green Bay Packers",31,"Detroit Lions",17,48,14,TRUE,"12/6/1981",1981,"December","1980s",31,83,12
"3462","198112060den","Denver Broncos",16,"Kansas City Chiefs",13,29,3,TRUE,"12/6/1981",1981,"December","1980s",49,27,8
"3463","198112060cin","Cincinnati Bengals",3,"San Francisco 49ers",21,24,-18,FALSE,"12/6/1981",1981,"December","1980s",28,65,7
"3464","198112070rai","Oakland Raiders",30,"Pittsburgh Steelers",27,57,3,TRUE,"12/7/1981",1981,"December","1980s",56,92,7
"3465","198112120cle","Cleveland Browns",13,"New York Jets",14,27,-1,FALSE,"12/12/1981",1981,"December","1980s",32,67,6
"3466","198112120det","Detroit Lions",45,"Minnesota Vikings",7,52,38,TRUE,"12/12/1981",1981,"December","1980s",72,NA,NA
"3467","198112130crd","St. Louis Cardinals",10,"New York Giants",20,30,-10,FALSE,"12/13/1981",1981,"December","1980s",32,73,6
"3468","198112130den","Denver Broncos",23,"Seattle Seahawks",13,36,10,TRUE,"12/13/1981",1981,"December","1980s",36,62,8
"3469","198112130kan","Kansas City Chiefs",7,"Miami Dolphins",17,24,-10,FALSE,"12/13/1981",1981,"December","1980s",38,63,6
"3470","198112130dal","Dallas Cowboys",21,"Philadelphia Eagles",10,31,11,TRUE,"12/13/1981",1981,"December","1980s",44,83,9
"3471","198112130sfo","San Francisco 49ers",28,"Houston Oilers",6,34,22,TRUE,"12/13/1981",1981,"December","1980s",54,87,7
"3472","198112130nor","New Orleans Saints",7,"Green Bay Packers",35,42,-28,FALSE,"12/13/1981",1981,"December","1980s",72,NA,NA
"3473","198112130nwe","New England Patriots",10,"Buffalo Bills",19,29,-9,FALSE,"12/13/1981",1981,"December","1980s",30,60,11
"3474","198112130tam","Tampa Bay Buccaneers",23,"San Diego Chargers",24,47,-1,FALSE,"12/13/1981",1981,"December","1980s",58,55,8
"3475","198112130rai","Oakland Raiders",6,"Chicago Bears",23,29,-17,FALSE,"12/13/1981",1981,"December","1980s",56,94,7
"3476","198112130pit","Pittsburgh Steelers",10,"Cincinnati Bengals",17,27,-7,FALSE,"12/13/1981",1981,"December","1980s",27,71,5
"3477","198112130was","Washington Redskins",38,"Baltimore Colts",14,52,24,TRUE,"12/13/1981",1981,"December","1980s",35,63,8
"3478","198112140ram","Los Angeles Rams",21,"Atlanta Falcons",16,37,5,TRUE,"12/14/1981",1981,"December","1980s",59,74,7
"3479","198112190mia","Miami Dolphins",16,"Buffalo Bills",6,22,10,TRUE,"12/19/1981",1981,"December","1980s",55,62,20
"3480","198112190nyg","New York Giants",13,"Dallas Cowboys",10,23,3,TRUE,"12/19/1981",1981,"December","1980s",26,51,20
"3481","198112200sea","Seattle Seahawks",42,"Cleveland Browns",21,63,21,TRUE,"12/20/1981",1981,"December","1980s",72,NA,NA
"3482","198112200det","Detroit Lions",17,"Tampa Bay Buccaneers",20,37,-3,FALSE,"12/20/1981",1981,"December","1980s",72,NA,NA
"3483","198112200nor","New Orleans Saints",17,"San Francisco 49ers",21,38,-4,FALSE,"12/20/1981",1981,"December","1980s",72,NA,NA
"3484","198112200clt","Baltimore Colts",23,"New England Patriots",21,44,2,TRUE,"12/20/1981",1981,"December","1980s",21,56,13
"3485","198112200ram","Los Angeles Rams",7,"Washington Redskins",30,37,-23,FALSE,"12/20/1981",1981,"December","1980s",59,80,8
"3486","198112200nyj","New York Jets",28,"Green Bay Packers",3,31,25,TRUE,"12/20/1981",1981,"December","1980s",24,48,21
"3487","198112200min","Minnesota Vikings",6,"Kansas City Chiefs",10,16,-4,FALSE,"12/20/1981",1981,"December","1980s",10,67,17
"3488","198112200chi","Chicago Bears",35,"Denver Broncos",24,59,11,TRUE,"12/20/1981",1981,"December","1980s",6,68,11
"3489","198112200atl","Atlanta Falcons",28,"Cincinnati Bengals",30,58,-2,FALSE,"12/20/1981",1981,"December","1980s",21,46,10
"3490","198112200phi","Philadelphia Eagles",38,"St. Louis Cardinals",0,38,38,TRUE,"12/20/1981",1981,"December","1980s",22,58,13
"3491","198112200oti","Houston Oilers",21,"Pittsburgh Steelers",20,41,1,TRUE,"12/20/1981",1981,"December","1980s",72,NA,NA
"3492","198112210sdg","San Diego Chargers",23,"Oakland Raiders",10,33,13,TRUE,"12/21/1981",1981,"December","1980s",63,74,13
"3493","198112270nyj","New York Jets",27,"Buffalo Bills",31,58,-4,FALSE,"12/27/1981",1981,"December","1980s",37,78,17
"3494","198112270phi","Philadelphia Eagles",21,"New York Giants",27,48,-6,FALSE,"12/27/1981",1981,"December","1980s",38,82,10
"3495","198201020dal","Dallas Cowboys",38,"Tampa Bay Buccaneers",0,38,38,TRUE,"1/2/1982",1982,"January","1980s",57,73,15
"3496","198201020mia","Miami Dolphins",38,"San Diego Chargers",41,79,-3,FALSE,"1/2/1982",1982,"January","1980s",76,80,10
"3497","198201030cin","Cincinnati Bengals",28,"Buffalo Bills",21,49,7,TRUE,"1/3/1982",1982,"January","1980s",45,91,14
"3498","198201030sfo","San Francisco 49ers",38,"New York Giants",24,62,14,TRUE,"1/3/1982",1982,"January","1980s",42,71,11
"3499","198201100sfo","San Francisco 49ers",28,"Dallas Cowboys",27,55,1,TRUE,"1/10/1982",1982,"January","1980s",43,73,4
"3500","198201100cin","Cincinnati Bengals",27,"San Diego Chargers",7,34,20,TRUE,"1/10/1982",1982,"January","1980s",-6,51,24
"3501","198201240cin","Cincinnati Bengals",21,"San Francisco 49ers",26,47,-5,FALSE,"1/24/1982",1982,"January","1980s",72,NA,NA
"3502","198209120nyg","New York Giants",14,"Atlanta Falcons",16,30,-2,FALSE,"9/12/1982",1982,"September","1980s",75,58,9
"3503","198209120den","Denver Broncos",3,"San Diego Chargers",23,26,-20,FALSE,"9/12/1982",1982,"September","1980s",48,82,10
"3504","198209120min","Minnesota Vikings",17,"Tampa Bay Buccaneers",10,27,7,TRUE,"9/12/1982",1982,"September","1980s",72,NA,NA
"3505","198209120det","Detroit Lions",17,"Chicago Bears",10,27,7,TRUE,"9/12/1982",1982,"September","1980s",72,NA,NA
"3506","198209120nor","New Orleans Saints",7,"St. Louis Cardinals",21,28,-14,FALSE,"9/12/1982",1982,"September","1980s",72,NA,NA
"3507","198209120sfo","San Francisco 49ers",17,"Los Angeles Raiders",23,40,-6,FALSE,"9/12/1982",1982,"September","1980s",65,46,13
"3508","198209120cin","Cincinnati Bengals",27,"Houston Oilers",6,33,21,TRUE,"9/12/1982",1982,"September","1980s",75,70,7
"3509","198209120clt","Baltimore Colts",13,"New England Patriots",24,37,-11,FALSE,"9/12/1982",1982,"September","1980s",72,66,6
"3510","198209120phi","Philadelphia Eagles",34,"Washington Redskins",37,71,-3,FALSE,"9/12/1982",1982,"September","1980s",74,65,6
"3511","198209120buf","Buffalo Bills",14,"Kansas City Chiefs",9,23,5,TRUE,"9/12/1982",1982,"September","1980s",73,69,6
"3512","198209120sea","Seattle Seahawks",7,"Cleveland Browns",21,28,-14,FALSE,"9/12/1982",1982,"September","1980s",72,NA,NA
"3513","198209120gnb","Green Bay Packers",35,"Los Angeles Rams",23,58,12,TRUE,"9/12/1982",1982,"September","1980s",73,80,11
"3514","198209120nyj","New York Jets",28,"Miami Dolphins",45,73,-17,FALSE,"9/12/1982",1982,"September","1980s",75,58,9
"3515","198209130dal","Dallas Cowboys",28,"Pittsburgh Steelers",36,64,-8,FALSE,"9/13/1982",1982,"September","1980s",84,57,15
"3516","198209160buf","Buffalo Bills",23,"Minnesota Vikings",22,45,1,TRUE,"9/16/1982",1982,"September","1980s",60,81,11
"3517","198209190oti","Houston Oilers",23,"Seattle Seahawks",21,44,2,TRUE,"9/19/1982",1982,"September","1980s",72,NA,NA
"3518","198209190cle","Cleveland Browns",21,"Philadelphia Eagles",24,45,-3,FALSE,"9/19/1982",1982,"September","1980s",56,64,10
"3519","198209190atl","Atlanta Falcons",14,"Los Angeles Raiders",38,52,-24,FALSE,"9/19/1982",1982,"September","1980s",76,70,8
"3520","198209190kan","Kansas City Chiefs",19,"San Diego Chargers",12,31,7,TRUE,"9/19/1982",1982,"September","1980s",60,72,10
"3521","198209190crd","St. Louis Cardinals",7,"Dallas Cowboys",24,31,-17,FALSE,"9/19/1982",1982,"September","1980s",62,78,8
"3522","198209190pit","Pittsburgh Steelers",26,"Cincinnati Bengals",20,46,6,TRUE,"9/19/1982",1982,"September","1980s",55,56,6
"3523","198209190chi","Chicago Bears",0,"New Orleans Saints",10,10,-10,FALSE,"9/19/1982",1982,"September","1980s",56,67,10
"3524","198209190mia","Miami Dolphins",24,"Baltimore Colts",20,44,4,TRUE,"9/19/1982",1982,"September","1980s",82,70,5
"3525","198209190den","Denver Broncos",24,"San Francisco 49ers",21,45,3,TRUE,"9/19/1982",1982,"September","1980s",58,56,8
"3526","198209190ram","Los Angeles Rams",14,"Detroit Lions",19,33,-5,FALSE,"9/19/1982",1982,"September","1980s",70,68,10
"3527","198209190tam","Tampa Bay Buccaneers",13,"Washington Redskins",21,34,-8,FALSE,"9/19/1982",1982,"September","1980s",80,80,8
"3528","198209190nwe","New England Patriots",7,"New York Jets",31,38,-24,FALSE,"9/19/1982",1982,"September","1980s",62,60,14
"3529","198209200nyg","New York Giants",19,"Green Bay Packers",27,46,-8,FALSE,"9/20/1982",1982,"September","1980s",60,76,13
"3530","198211210gnb","Green Bay Packers",26,"Minnesota Vikings",7,33,19,TRUE,"11/21/1982",1982,"November","1980s",45,65,10
"3531","198211210nyg","New York Giants",17,"Washington Redskins",27,44,-10,FALSE,"11/21/1982",1982,"November","1980s",50,90,9
"3532","198211210crd","St. Louis Cardinals",20,"San Francisco 49ers",31,51,-11,FALSE,"11/21/1982",1982,"November","1980s",53,83,10
"3533","198211210cle","Cleveland Browns",10,"New England Patriots",7,17,3,TRUE,"11/21/1982",1982,"November","1980s",57,78,18
"3534","198211210oti","Houston Oilers",10,"Pittsburgh Steelers",24,34,-14,FALSE,"11/21/1982",1982,"November","1980s",72,NA,NA
"3535","198211210dal","Dallas Cowboys",14,"Tampa Bay Buccaneers",9,23,5,TRUE,"11/21/1982",1982,"November","1980s",61,49,8
"3536","198211210nor","New Orleans Saints",27,"Kansas City Chiefs",17,44,10,TRUE,"11/21/1982",1982,"November","1980s",72,NA,NA
"3537","198211210buf","Buffalo Bills",7,"Miami Dolphins",9,16,-2,FALSE,"11/21/1982",1982,"November","1980s",55,85,14
"3538","198211210nyj","New York Jets",37,"Baltimore Colts",0,37,37,TRUE,"11/21/1982",1982,"November","1980s",50,90,9
"3539","198211210den","Denver Broncos",10,"Seattle Seahawks",17,27,-7,FALSE,"11/21/1982",1982,"November","1980s",33,48,10
"3540","198211210phi","Philadelphia Eagles",14,"Cincinnati Bengals",18,32,-4,FALSE,"11/21/1982",1982,"November","1980s",55,82,8
"3541","198211210atl","Atlanta Falcons",34,"Los Angeles Rams",17,51,17,TRUE,"11/21/1982",1982,"November","1980s",57,96,11
"3542","198211210chi","Chicago Bears",20,"Detroit Lions",17,37,3,TRUE,"11/21/1982",1982,"November","1980s",46,72,9
"3543","198211220rai","Los Angeles Raiders",28,"San Diego Chargers",24,52,4,TRUE,"11/22/1982",1982,"November","1980s",57,70,7
"3544","198211250det","Detroit Lions",6,"New York Giants",13,19,-7,FALSE,"11/25/1982",1982,"November","1980s",72,NA,NA
"3545","198211250dal","Dallas Cowboys",31,"Cleveland Browns",14,45,17,TRUE,"11/25/1982",1982,"November","1980s",40,59,11
"3546","198211280nyj","New York Jets",15,"Green Bay Packers",13,28,2,TRUE,"11/28/1982",1982,"November","1980s",32,56,11
"3547","198211280atl","Atlanta Falcons",20,"St. Louis Cardinals",23,43,-3,FALSE,"11/28/1982",1982,"November","1980s",59,91,14
"3548","198211280min","Minnesota Vikings",35,"Chicago Bears",7,42,28,TRUE,"11/28/1982",1982,"November","1980s",72,NA,NA
"3549","198211280sdg","San Diego Chargers",30,"Denver Broncos",20,50,10,TRUE,"11/28/1982",1982,"November","1980s",61,60,6
"3550","198211280sfo","San Francisco 49ers",20,"New Orleans Saints",23,43,-3,FALSE,"11/28/1982",1982,"November","1980s",56,81,11
"3551","198211280cin","Cincinnati Bengals",31,"Los Angeles Raiders",17,48,14,TRUE,"11/28/1982",1982,"November","1980s",46,76,15
"3552","198211280was","Washington Redskins",13,"Philadelphia Eagles",9,22,4,TRUE,"11/28/1982",1982,"November","1980s",38,67,6
"3553","198211280sea","Seattle Seahawks",16,"Pittsburgh Steelers",0,16,16,TRUE,"11/28/1982",1982,"November","1980s",72,NA,NA
"3554","198211280nwe","New England Patriots",29,"Houston Oilers",21,50,8,TRUE,"11/28/1982",1982,"November","1980s",30,39,14
"3555","198211280buf","Buffalo Bills",20,"Baltimore Colts",0,20,20,TRUE,"11/28/1982",1982,"November","1980s",27,74,7
"3556","198211280ram","Los Angeles Rams",20,"Kansas City Chiefs",14,34,6,TRUE,"11/28/1982",1982,"November","1980s",60,68,7
"3557","198211290tam","Tampa Bay Buccaneers",23,"Miami Dolphins",17,40,6,TRUE,"11/29/1982",1982,"November","1980s",74,84,10
"3558","198212020ram","Los Angeles Rams",24,"San Francisco 49ers",30,54,-6,FALSE,"12/2/1982",1982,"December","1980s",57,37,16
"3559","198212050nor","New Orleans Saints",10,"Tampa Bay Buccaneers",13,23,-3,FALSE,"12/5/1982",1982,"December","1980s",72,NA,NA
"3560","198212050gnb","Green Bay Packers",33,"Buffalo Bills",21,54,12,TRUE,"12/5/1982",1982,"December","1980s",42,93,12
"3561","198212050was","Washington Redskins",10,"Dallas Cowboys",24,34,-14,FALSE,"12/5/1982",1982,"December","1980s",64,81,9
"3562","198212050rai","Los Angeles Raiders",28,"Seattle Seahawks",23,51,5,TRUE,"12/5/1982",1982,"December","1980s",57,75,8
"3563","198212050clt","Baltimore Colts",17,"Cincinnati Bengals",20,37,-3,FALSE,"12/5/1982",1982,"December","1980s",61,86,9
"3564","198212050cle","Cleveland Browns",13,"San Diego Chargers",30,43,-17,FALSE,"12/5/1982",1982,"December","1980s",60,71,17
"3565","198212050pit","Pittsburgh Steelers",35,"Kansas City Chiefs",14,49,21,TRUE,"12/5/1982",1982,"December","1980s",58,78,8
"3566","198212050den","Denver Broncos",27,"Atlanta Falcons",34,61,-7,FALSE,"12/5/1982",1982,"December","1980s",36,66,6
"3567","198212050nyg","New York Giants",17,"Houston Oilers",14,31,3,TRUE,"12/5/1982",1982,"December","1980s",56,85,11
"3568","198212050chi","Chicago Bears",26,"New England Patriots",13,39,13,TRUE,"12/5/1982",1982,"December","1980s",49,90,16
"3569","198212050mia","Miami Dolphins",22,"Minnesota Vikings",14,36,8,TRUE,"12/5/1982",1982,"December","1980s",78,74,12
"3570","198212050phi","Philadelphia Eagles",20,"St. Louis Cardinals",23,43,-3,FALSE,"12/5/1982",1982,"December","1980s",60,89,8
"3571","198212060det","Detroit Lions",13,"New York Jets",28,41,-15,FALSE,"12/6/1982",1982,"December","1980s",72,NA,NA
"3572","198212110sfo","San Francisco 49ers",37,"San Diego Chargers",41,78,-4,FALSE,"12/11/1982",1982,"December","1980s",47,76,4
"3573","198212110nyg","New York Giants",23,"Philadelphia Eagles",7,30,16,TRUE,"12/11/1982",1982,"December","1980s",35,69,11
"3574","198212120ram","Los Angeles Rams",24,"Denver Broncos",27,51,-3,FALSE,"12/12/1982",1982,"December","1980s",59,72,8
"3575","198212120nwe","New England Patriots",3,"Miami Dolphins",0,3,3,TRUE,"12/12/1982",1982,"December","1980s",26,51,16
"3576","198212120gnb","Green Bay Packers",10,"Detroit Lions",30,40,-20,FALSE,"12/12/1982",1982,"December","1980s",10,59,11
"3577","198212120kan","Kansas City Chiefs",16,"Los Angeles Raiders",21,37,-5,FALSE,"12/12/1982",1982,"December","1980s",17,66,8
"3578","198212120sea","Seattle Seahawks",20,"Chicago Bears",14,34,6,TRUE,"12/12/1982",1982,"December","1980s",72,NA,NA
"3579","198212120min","Minnesota Vikings",13,"Baltimore Colts",10,23,3,TRUE,"12/12/1982",1982,"December","1980s",72,NA,NA
"3580","198212120crd","St. Louis Cardinals",7,"Washington Redskins",12,19,-5,FALSE,"12/12/1982",1982,"December","1980s",19,70,10
"3581","198212120buf","Buffalo Bills",13,"Pittsburgh Steelers",0,13,13,TRUE,"12/12/1982",1982,"December","1980s",20,67,12
"3582","198212120cin","Cincinnati Bengals",23,"Cleveland Browns",10,33,13,TRUE,"12/12/1982",1982,"December","1980s",26,50,12
"3583","198212120atl","Atlanta Falcons",35,"New Orleans Saints",0,35,35,TRUE,"12/12/1982",1982,"December","1980s",38,84,18
"3584","198212120nyj","New York Jets",32,"Tampa Bay Buccaneers",17,49,15,TRUE,"12/12/1982",1982,"December","1980s",27,64,18
"3585","198212130oti","Houston Oilers",7,"Dallas Cowboys",37,44,-30,FALSE,"12/13/1982",1982,"December","1980s",72,NA,NA
"3586","198212180mia","Miami Dolphins",20,"New York Jets",19,39,1,TRUE,"12/18/1982",1982,"December","1980s",56,64,10
"3587","198212180rai","Los Angeles Raiders",37,"Los Angeles Rams",31,68,6,TRUE,"12/18/1982",1982,"December","1980s",56,66,7
"3588","198212190was","Washington Redskins",15,"New York Giants",14,29,1,TRUE,"12/19/1982",1982,"December","1980s",32,73,6
"3589","198212190cle","Cleveland Browns",10,"Pittsburgh Steelers",9,19,1,TRUE,"12/19/1982",1982,"December","1980s",35,82,15
"3590","198212190clt","Baltimore Colts",20,"Green Bay Packers",20,40,0,FALSE,"12/19/1982",1982,"December","1980s",29,80,6
"3591","198212190phi","Philadelphia Eagles",35,"Houston Oilers",14,49,21,TRUE,"12/19/1982",1982,"December","1980s",31,68,10
"3592","198212190sfo","San Francisco 49ers",7,"Atlanta Falcons",17,24,-10,FALSE,"12/19/1982",1982,"December","1980s",46,76,7
"3593","198212190chi","Chicago Bears",7,"St. Louis Cardinals",10,17,-3,FALSE,"12/19/1982",1982,"December","1980s",34,88,12
"3594","198212190sea","Seattle Seahawks",0,"New England Patriots",16,16,-16,FALSE,"12/19/1982",1982,"December","1980s",72,NA,NA
"3595","198212190dal","Dallas Cowboys",21,"New Orleans Saints",7,28,14,TRUE,"12/19/1982",1982,"December","1980s",56,46,12
"3596","198212190tam","Tampa Bay Buccaneers",24,"Buffalo Bills",23,47,1,TRUE,"12/19/1982",1982,"December","1980s",50,81,9
"3597","198212190den","Denver Broncos",16,"Kansas City Chiefs",37,53,-21,FALSE,"12/19/1982",1982,"December","1980s",35,28,11
"3598","198212190det","Detroit Lions",31,"Minnesota Vikings",34,65,-3,FALSE,"12/19/1982",1982,"December","1980s",72,NA,NA
"3599","198212200sdg","San Diego Chargers",50,"Cincinnati Bengals",34,84,16,TRUE,"12/20/1982",1982,"December","1980s",56,79,6
"3600","198212260crd","St. Louis Cardinals",24,"New York Giants",21,45,3,TRUE,"12/26/1982",1982,"December","1980s",37,87,13
"3601","198212260pit","Pittsburgh Steelers",37,"New England Patriots",14,51,23,TRUE,"12/26/1982",1982,"December","1980s",51,75,15
"3602","198212260dal","Dallas Cowboys",20,"Philadelphia Eagles",24,44,-4,FALSE,"12/26/1982",1982,"December","1980s",38,71,19
"3603","198212260nor","New Orleans Saints",10,"Washington Redskins",27,37,-17,FALSE,"12/26/1982",1982,"December","1980s",72,NA,NA
"3604","198212260oti","Houston Oilers",14,"Cleveland Browns",20,34,-6,FALSE,"12/26/1982",1982,"December","1980s",72,NA,NA
"3605","198212260cin","Cincinnati Bengals",24,"Seattle Seahawks",10,34,14,TRUE,"12/26/1982",1982,"December","1980s",51,79,14
"3606","198212260min","Minnesota Vikings",14,"New York Jets",42,56,-28,FALSE,"12/26/1982",1982,"December","1980s",72,NA,NA
"3607","198212260kan","Kansas City Chiefs",13,"San Francisco 49ers",26,39,-13,FALSE,"12/26/1982",1982,"December","1980s",27,77,10
"3608","198212260sdg","San Diego Chargers",44,"Baltimore Colts",26,70,18,TRUE,"12/26/1982",1982,"December","1980s",55,29,10
"3609","198212260atl","Atlanta Falcons",7,"Green Bay Packers",38,45,-31,FALSE,"12/26/1982",1982,"December","1980s",64,81,10
"3610","198212260tam","Tampa Bay Buccaneers",23,"Detroit Lions",21,44,2,TRUE,"12/26/1982",1982,"December","1980s",73,72,11
"3611","198212260rai","Los Angeles Raiders",27,"Denver Broncos",10,37,17,TRUE,"12/26/1982",1982,"December","1980s",52,38,8
"3612","198212260ram","Los Angeles Rams",26,"Chicago Bears",34,60,-8,FALSE,"12/26/1982",1982,"December","1980s",52,38,8
"3613","198212270mia","Miami Dolphins",27,"Buffalo Bills",10,37,17,TRUE,"12/27/1982",1982,"December","1980s",76,70,16
"3614","198301020nwe","New England Patriots",30,"Buffalo Bills",19,49,11,TRUE,"1/2/1983",1983,"January","1980s",38,46,15
"3615","198301020sfo","San Francisco 49ers",20,"Los Angeles Rams",21,41,-1,FALSE,"1/2/1983",1983,"January","1980s",41,76,6
"3616","198301020phi","Philadelphia Eagles",24,"New York Giants",26,50,-2,FALSE,"1/2/1983",1983,"January","1980s",38,67,8
"3617","198301020pit","Pittsburgh Steelers",37,"Cleveland Browns",21,58,16,TRUE,"1/2/1983",1983,"January","1980s",31,67,8
"3618","198301020nor","New Orleans Saints",35,"Atlanta Falcons",6,41,29,TRUE,"1/2/1983",1983,"January","1980s",72,NA,NA
"3619","198301020sdg","San Diego Chargers",34,"Los Angeles Raiders",41,75,-7,FALSE,"1/2/1983",1983,"January","1980s",53,43,7
"3620","198301020oti","Houston Oilers",27,"Cincinnati Bengals",35,62,-8,FALSE,"1/2/1983",1983,"January","1980s",72,NA,NA
"3621","198301020tam","Tampa Bay Buccaneers",26,"Chicago Bears",23,49,3,TRUE,"1/2/1983",1983,"January","1980s",72,89,10
"3622","198301020clt","Baltimore Colts",7,"Miami Dolphins",34,41,-27,FALSE,"1/2/1983",1983,"January","1980s",37,72,5
"3623","198301020kan","Kansas City Chiefs",37,"New York Jets",13,50,24,TRUE,"1/2/1983",1983,"January","1980s",28,83,12
"3624","198301020was","Washington Redskins",28,"St. Louis Cardinals",0,28,28,TRUE,"1/2/1983",1983,"January","1980s",41,72,4
"3625","198301020sea","Seattle Seahawks",13,"Denver Broncos",11,24,2,TRUE,"1/2/1983",1983,"January","1980s",72,NA,NA
"3626","198301020det","Detroit Lions",27,"Green Bay Packers",24,51,3,TRUE,"1/2/1983",1983,"January","1980s",72,NA,NA
"3627","198301030min","Minnesota Vikings",31,"Dallas Cowboys",27,58,4,TRUE,"1/3/1983",1983,"January","1980s",72,NA,NA
"3628","198301080mia","Miami Dolphins",28,"New England Patriots",13,41,15,TRUE,"1/8/1983",1983,"January","1980s",70,91,8
"3629","198301080gnb","Green Bay Packers",41,"St. Louis Cardinals",16,57,25,TRUE,"1/8/1983",1983,"January","1980s",20,81,9
"3630","198301080was","Washington Redskins",31,"Detroit Lions",7,38,24,TRUE,"1/8/1983",1983,"January","1980s",44,43,11
"3631","198301080rai","Los Angeles Raiders",27,"Cleveland Browns",10,37,17,TRUE,"1/8/1983",1983,"January","1980s",59,71,7
"3632","198301090dal","Dallas Cowboys",30,"Tampa Bay Buccaneers",17,47,13,TRUE,"1/9/1983",1983,"January","1980s",49,77,12
"3633","198301090pit","Pittsburgh Steelers",28,"San Diego Chargers",31,59,-3,FALSE,"1/9/1983",1983,"January","1980s",32,70,10
"3634","198301090min","Minnesota Vikings",30,"Atlanta Falcons",24,54,6,TRUE,"1/9/1983",1983,"January","1980s",72,NA,NA
"3635","198301090cin","Cincinnati Bengals",17,"New York Jets",44,61,-27,FALSE,"1/9/1983",1983,"January","1980s",33,74,11
"3636","198301150was","Washington Redskins",21,"Minnesota Vikings",7,28,14,TRUE,"1/15/1983",1983,"January","1980s",40,58,12
"3637","198301150rai","Los Angeles Raiders",14,"New York Jets",17,31,-3,FALSE,"1/15/1983",1983,"January","1980s",66,34,6
"3638","198301160mia","Miami Dolphins",34,"San Diego Chargers",13,47,21,TRUE,"1/16/1983",1983,"January","1980s",58,62,10
"3639","198301160dal","Dallas Cowboys",37,"Green Bay Packers",26,63,11,TRUE,"1/16/1983",1983,"January","1980s",38,56,7
"3640","198301220was","Washington Redskins",31,"Dallas Cowboys",17,48,14,TRUE,"1/22/1983",1983,"January","1980s",35,52,8
"3641","198301230mia","Miami Dolphins",14,"New York Jets",0,14,14,TRUE,"1/23/1983",1983,"January","1980s",69,97,10
"3642","198301300mia","Miami Dolphins",17,"Washington Redskins",27,44,-10,FALSE,"1/30/1983",1983,"January","1980s",54,64,9
"3643","198309030sfo","San Francisco 49ers",17,"Philadelphia Eagles",22,39,-5,FALSE,"9/3/1983",1983,"September","1980s",68,63,14
"3644","198309040chi","Chicago Bears",17,"Atlanta Falcons",20,37,-3,FALSE,"9/4/1983",1983,"September","1980s",80,49,12
"3645","198309040sdg","San Diego Chargers",29,"New York Jets",41,70,-12,FALSE,"9/4/1983",1983,"September","1980s",75,73,9
"3646","198309040tam","Tampa Bay Buccaneers",0,"Detroit Lions",11,11,-11,FALSE,"9/4/1983",1983,"September","1980s",82,83,7
"3647","198309040buf","Buffalo Bills",0,"Miami Dolphins",12,12,-12,FALSE,"9/4/1983",1983,"September","1980s",72,60,12
"3648","198309040pit","Pittsburgh Steelers",10,"Denver Broncos",14,24,-4,FALSE,"9/4/1983",1983,"September","1980s",73,64,5
"3649","198309040cin","Cincinnati Bengals",10,"Los Angeles Raiders",20,30,-10,FALSE,"9/4/1983",1983,"September","1980s",75,67,9
"3650","198309040nor","New Orleans Saints",28,"St. Louis Cardinals",17,45,11,TRUE,"9/4/1983",1983,"September","1980s",72,NA,NA
"3651","198309040nwe","New England Patriots",23,"Baltimore Colts",29,52,-6,FALSE,"9/4/1983",1983,"September","1980s",78,62,10
"3652","198309040cle","Cleveland Browns",21,"Minnesota Vikings",27,48,-6,FALSE,"9/4/1983",1983,"September","1980s",76,63,10
"3653","198309040oti","Houston Oilers",38,"Green Bay Packers",41,79,-3,FALSE,"9/4/1983",1983,"September","1980s",72,NA,NA
"3654","198309040nyg","New York Giants",6,"Los Angeles Rams",16,22,-10,FALSE,"9/4/1983",1983,"September","1980s",78,63,9
"3655","198309040kan","Kansas City Chiefs",17,"Seattle Seahawks",13,30,4,TRUE,"9/4/1983",1983,"September","1980s",82,45,16
"3656","198309050was","Washington Redskins",30,"Dallas Cowboys",31,61,-1,FALSE,"9/5/1983",1983,"September","1980s",84,66,6
"3657","198309080min","Minnesota Vikings",17,"San Francisco 49ers",48,65,-31,FALSE,"9/8/1983",1983,"September","1980s",72,NA,NA
"3658","198309110ram","Los Angeles Rams",30,"New Orleans Saints",27,57,3,TRUE,"9/11/1983",1983,"September","1980s",77,59,8
"3659","198309110chi","Chicago Bears",17,"Tampa Bay Buccaneers",10,27,7,TRUE,"9/11/1983",1983,"September","1980s",68,63,11
"3660","198309110det","Detroit Lions",26,"Cleveland Browns",31,57,-5,FALSE,"9/11/1983",1983,"September","1980s",72,NA,NA
"3661","198309110crd","St. Louis Cardinals",17,"Dallas Cowboys",34,51,-17,FALSE,"9/11/1983",1983,"September","1980s",79,71,10
"3662","198309110phi","Philadelphia Eagles",13,"Washington Redskins",23,36,-10,FALSE,"9/11/1983",1983,"September","1980s",83,57,10
"3663","198309110gnb","Green Bay Packers",21,"Pittsburgh Steelers",25,46,-4,FALSE,"9/11/1983",1983,"September","1980s",60,68,11
"3664","198309110atl","Atlanta Falcons",13,"New York Giants",16,29,-3,FALSE,"9/11/1983",1983,"September","1980s",82,66,7
"3665","198309110clt","Baltimore Colts",10,"Denver Broncos",17,27,-7,FALSE,"9/11/1983",1983,"September","1980s",84,47,10
"3666","198309110cin","Cincinnati Bengals",6,"Buffalo Bills",10,16,-4,FALSE,"9/11/1983",1983,"September","1980s",77,65,13
"3667","198309110rai","Los Angeles Raiders",20,"Houston Oilers",6,26,14,TRUE,"9/11/1983",1983,"September","1980s",77,59,8
"3668","198309110mia","Miami Dolphins",34,"New England Patriots",24,58,10,TRUE,"9/11/1983",1983,"September","1980s",83,73,8
"3669","198309110nyj","New York Jets",10,"Seattle Seahawks",17,27,-7,FALSE,"9/11/1983",1983,"September","1980s",88,46,13
"3670","198309120kan","Kansas City Chiefs",14,"San Diego Chargers",17,31,-3,FALSE,"9/12/1983",1983,"September","1980s",69,75,12
"3671","198309150cle","Cleveland Browns",17,"Cincinnati Bengals",7,24,10,TRUE,"9/15/1983",1983,"September","1980s",56,62,9
"3672","198309180gnb","Green Bay Packers",27,"Los Angeles Rams",24,51,3,TRUE,"9/18/1983",1983,"September","1980s",71,74,18
"3673","198309180oti","Houston Oilers",28,"Pittsburgh Steelers",40,68,-12,FALSE,"9/18/1983",1983,"September","1980s",72,NA,NA
"3674","198309180was","Washington Redskins",27,"Kansas City Chiefs",12,39,15,TRUE,"9/18/1983",1983,"September","1980s",72,58,6
"3675","198309180dal","Dallas Cowboys",28,"New York Giants",13,41,15,TRUE,"9/18/1983",1983,"September","1980s",82,67,15
"3676","198309180tam","Tampa Bay Buccaneers",16,"Minnesota Vikings",19,35,-3,FALSE,"9/18/1983",1983,"September","1980s",76,92,8
"3677","198309180den","Denver Broncos",10,"Philadelphia Eagles",13,23,-3,FALSE,"9/18/1983",1983,"September","1980s",66,35,10
"3678","198309180crd","St. Louis Cardinals",27,"San Francisco 49ers",42,69,-15,FALSE,"9/18/1983",1983,"September","1980s",84,55,15
"3679","198309180nwe","New England Patriots",23,"New York Jets",13,36,10,TRUE,"9/18/1983",1983,"September","1980s",67,79,10
"3680","198309180sea","Seattle Seahawks",34,"San Diego Chargers",31,65,3,TRUE,"9/18/1983",1983,"September","1980s",72,NA,NA
"3681","198309180det","Detroit Lions",14,"Atlanta Falcons",30,44,-16,FALSE,"9/18/1983",1983,"September","1980s",72,NA,NA
"3682","198309180buf","Buffalo Bills",28,"Baltimore Colts",23,51,5,TRUE,"9/18/1983",1983,"September","1980s",60,76,11
"3683","198309180nor","New Orleans Saints",34,"Chicago Bears",31,65,3,TRUE,"9/18/1983",1983,"September","1980s",72,NA,NA
"3684","198309190rai","Los Angeles Raiders",27,"Miami Dolphins",14,41,13,TRUE,"9/19/1983",1983,"September","1980s",74,73,7
"3685","198309250sfo","San Francisco 49ers",24,"Atlanta Falcons",20,44,4,TRUE,"9/25/1983",1983,"September","1980s",63,77,16
"3686","198309250clt","Baltimore Colts",22,"Chicago Bears",19,41,3,TRUE,"9/25/1983",1983,"September","1980s",54,58,7
"3687","198309250den","Denver Broncos",7,"Los Angeles Raiders",22,29,-15,FALSE,"9/25/1983",1983,"September","1980s",64,44,8
"3688","198309250sea","Seattle Seahawks",17,"Washington Redskins",27,44,-10,FALSE,"9/25/1983",1983,"September","1980s",72,NA,NA
"3689","198309250buf","Buffalo Bills",30,"Houston Oilers",13,43,17,TRUE,"9/25/1983",1983,"September","1980s",53,59,9
"3690","198309250sdg","San Diego Chargers",24,"Cleveland Browns",30,54,-6,FALSE,"9/25/1983",1983,"September","1980s",73,69,9
"3691","198309250min","Minnesota Vikings",20,"Detroit Lions",17,37,3,TRUE,"9/25/1983",1983,"September","1980s",72,NA,NA
"3692","198309250tam","Tampa Bay Buccaneers",17,"Cincinnati Bengals",23,40,-6,FALSE,"9/25/1983",1983,"September","1980s",75,75,12
"3693","198309250pit","Pittsburgh Steelers",23,"New England Patriots",28,51,-5,FALSE,"9/25/1983",1983,"September","1980s",52,54,6
"3694","198309250phi","Philadelphia Eagles",11,"St. Louis Cardinals",14,25,-3,FALSE,"9/25/1983",1983,"September","1980s",56,56,5
"3695","198309250nyj","New York Jets",27,"Los Angeles Rams",24,51,3,TRUE,"9/25/1983",1983,"September","1980s",60,53,10
"3696","198309250dal","Dallas Cowboys",21,"New Orleans Saints",20,41,1,TRUE,"9/25/1983",1983,"September","1980s",71,51,12
"3697","198309250mia","Miami Dolphins",14,"Kansas City Chiefs",6,20,8,TRUE,"9/25/1983",1983,"September","1980s",79,56,19
"3698","198309260nyg","New York Giants",27,"Green Bay Packers",3,30,24,TRUE,"9/26/1983",1983,"September","1980s",61,59,8
"3699","198310020atl","Atlanta Falcons",24,"Philadelphia Eagles",28,52,-4,FALSE,"10/2/1983",1983,"October","1980s",68,59,6
"3700","198310020min","Minnesota Vikings",24,"Dallas Cowboys",37,61,-13,FALSE,"10/2/1983",1983,"October","1980s",72,NA,NA
"3701","198310020chi","Chicago Bears",31,"Denver Broncos",14,45,17,TRUE,"10/2/1983",1983,"October","1980s",68,55,13
"3702","198310020nyg","New York Giants",34,"San Diego Chargers",41,75,-7,FALSE,"10/2/1983",1983,"October","1980s",66,86,8
"3703","198310020was","Washington Redskins",37,"Los Angeles Raiders",35,72,2,TRUE,"10/2/1983",1983,"October","1980s",65,81,4
"3704","198310020kan","Kansas City Chiefs",38,"St. Louis Cardinals",14,52,24,TRUE,"10/2/1983",1983,"October","1980s",76,50,18
"3705","198310020pit","Pittsburgh Steelers",17,"Houston Oilers",10,27,7,TRUE,"10/2/1983",1983,"October","1980s",60,70,6
"3706","198310020gnb","Green Bay Packers",55,"Tampa Bay Buccaneers",14,69,41,TRUE,"10/2/1983",1983,"October","1980s",66,75,13
"3707","198310020nor","New Orleans Saints",17,"Miami Dolphins",7,24,10,TRUE,"10/2/1983",1983,"October","1980s",72,NA,NA
"3708","198310020nwe","New England Patriots",13,"San Francisco 49ers",33,46,-20,FALSE,"10/2/1983",1983,"October","1980s",64,96,6
"3709","198310020ram","Los Angeles Rams",21,"Detroit Lions",10,31,11,TRUE,"10/2/1983",1983,"October","1980s",67,68,8
"3710","198310020cle","Cleveland Browns",9,"Seattle Seahawks",24,33,-15,FALSE,"10/2/1983",1983,"October","1980s",60,75,10
"3711","198310020cin","Cincinnati Bengals",31,"Baltimore Colts",34,65,-3,FALSE,"10/2/1983",1983,"October","1980s",64,61,7
"3712","198310030buf","Buffalo Bills",10,"New York Jets",34,44,-24,FALSE,"10/3/1983",1983,"October","1980s",68,58,18
"3713","198310090clt","Baltimore Colts",12,"New England Patriots",7,19,5,TRUE,"10/9/1983",1983,"October","1980s",61,68,7
"3714","198310090atl","Atlanta Falcons",17,"New Orleans Saints",19,36,-2,FALSE,"10/9/1983",1983,"October","1980s",66,59,9
"3715","198310090dal","Dallas Cowboys",27,"Tampa Bay Buccaneers",24,51,3,TRUE,"10/9/1983",1983,"October","1980s",70,69,6
"3716","198310090cle","Cleveland Browns",10,"New York Jets",7,17,3,TRUE,"10/9/1983",1983,"October","1980s",54,60,16
"3717","198310090crd","St. Louis Cardinals",14,"Washington Redskins",38,52,-24,FALSE,"10/9/1983",1983,"October","1980s",56,76,10
"3718","198310090sdg","San Diego Chargers",28,"Seattle Seahawks",21,49,7,TRUE,"10/9/1983",1983,"October","1980s",73,76,12
"3719","198310090det","Detroit Lions",38,"Green Bay Packers",14,52,24,TRUE,"10/9/1983",1983,"October","1980s",72,NA,NA
"3720","198310090mia","Miami Dolphins",35,"Buffalo Bills",38,73,-3,FALSE,"10/9/1983",1983,"October","1980s",79,70,9
"3721","198310090chi","Chicago Bears",14,"Minnesota Vikings",23,37,-9,FALSE,"10/9/1983",1983,"October","1980s",52,55,14
"3722","198310090sfo","San Francisco 49ers",7,"Los Angeles Rams",10,17,-3,FALSE,"10/9/1983",1983,"October","1980s",65,66,10
"3723","198310090nyg","New York Giants",13,"Philadelphia Eagles",17,30,-4,FALSE,"10/9/1983",1983,"October","1980s",62,72,12
"3724","198310090oti","Houston Oilers",14,"Denver Broncos",26,40,-12,FALSE,"10/9/1983",1983,"October","1980s",72,NA,NA
"3725","198310090rai","Los Angeles Raiders",21,"Kansas City Chiefs",20,41,1,TRUE,"10/9/1983",1983,"October","1980s",68,75,9
"3726","198310100cin","Cincinnati Bengals",14,"Pittsburgh Steelers",24,38,-10,FALSE,"10/10/1983",1983,"October","1980s",56,77,10
"3727","198310160dal","Dallas Cowboys",37,"Philadelphia Eagles",7,44,30,TRUE,"10/16/1983",1983,"October","1980s",73,70,13
"3728","198310160kan","Kansas City Chiefs",38,"New York Giants",17,55,21,TRUE,"10/16/1983",1983,"October","1980s",62,68,11
"3729","198310160nor","New Orleans Saints",13,"San Francisco 49ers",32,45,-19,FALSE,"10/16/1983",1983,"October","1980s",72,NA,NA
"3730","198310160nwe","New England Patriots",37,"San Diego Chargers",21,58,16,TRUE,"10/16/1983",1983,"October","1980s",50,50,15
"3731","198310160tam","Tampa Bay Buccaneers",27,"St. Louis Cardinals",34,61,-7,FALSE,"10/16/1983",1983,"October","1980s",78,88,9
"3732","198310160ram","Los Angeles Rams",27,"Atlanta Falcons",21,48,6,TRUE,"10/16/1983",1983,"October","1980s",66,71,9
"3733","198310160det","Detroit Lions",31,"Chicago Bears",17,48,14,TRUE,"10/16/1983",1983,"October","1980s",72,NA,NA
"3734","198310160clt","Baltimore Colts",7,"Buffalo Bills",30,37,-23,FALSE,"10/16/1983",1983,"October","1980s",54,62,7
"3735","198310160pit","Pittsburgh Steelers",44,"Cleveland Browns",17,61,27,TRUE,"10/16/1983",1983,"October","1980s",52,60,6
"3736","198310160den","Denver Broncos",24,"Cincinnati Bengals",17,41,7,TRUE,"10/16/1983",1983,"October","1980s",45,43,8
"3737","198310160nyj","New York Jets",14,"Miami Dolphins",32,46,-18,FALSE,"10/16/1983",1983,"October","1980s",52,55,15
"3738","198310160min","Minnesota Vikings",34,"Houston Oilers",14,48,20,TRUE,"10/16/1983",1983,"October","1980s",72,NA,NA
"3739","198310160sea","Seattle Seahawks",38,"Los Angeles Raiders",36,74,2,TRUE,"10/16/1983",1983,"October","1980s",72,NA,NA
"3740","198310170gnb","Green Bay Packers",48,"Washington Redskins",47,95,1,TRUE,"10/17/1983",1983,"October","1980s",47,67,10
"3741","198310230den","Denver Broncos",14,"San Diego Chargers",6,20,8,TRUE,"10/23/1983",1983,"October","1980s",56,25,6
"3742","198310230was","Washington Redskins",38,"Detroit Lions",17,55,21,TRUE,"10/23/1983",1983,"October","1980s",56,85,8
"3743","198310230dal","Dallas Cowboys",38,"Los Angeles Raiders",40,78,-2,FALSE,"10/23/1983",1983,"October","1980s",58,68,9
"3744","198310230gnb","Green Bay Packers",17,"Minnesota Vikings",20,37,-3,FALSE,"10/23/1983",1983,"October","1980s",48,89,14
"3745","198310230tam","Tampa Bay Buccaneers",21,"New Orleans Saints",24,45,-3,FALSE,"10/23/1983",1983,"October","1980s",76,88,8
"3746","198310230clt","Baltimore Colts",7,"Miami Dolphins",21,28,-14,FALSE,"10/23/1983",1983,"October","1980s",53,88,9
"3747","198310230sea","Seattle Seahawks",21,"Pittsburgh Steelers",27,48,-6,FALSE,"10/23/1983",1983,"October","1980s",72,NA,NA
"3748","198310230cin","Cincinnati Bengals",28,"Cleveland Browns",21,49,7,TRUE,"10/23/1983",1983,"October","1980s",57,95,10
"3749","198310230buf","Buffalo Bills",0,"New England Patriots",31,31,-31,FALSE,"10/23/1983",1983,"October","1980s",48,85,8
"3750","198310230ram","Los Angeles Rams",35,"San Francisco 49ers",45,80,-10,FALSE,"10/23/1983",1983,"October","1980s",67,72,8
"3751","198310230oti","Houston Oilers",10,"Kansas City Chiefs",13,23,-3,FALSE,"10/23/1983",1983,"October","1980s",72,NA,NA
"3752","198310230nyj","New York Jets",21,"Atlanta Falcons",27,48,-6,FALSE,"10/23/1983",1983,"October","1980s",51,70,13
"3753","198310230phi","Philadelphia Eagles",6,"Chicago Bears",7,13,-1,FALSE,"10/23/1983",1983,"October","1980s",50,87,9
"3754","198310240crd","St. Louis Cardinals",20,"New York Giants",20,40,0,FALSE,"10/24/1983",1983,"October","1980s",53,95,10
"3755","198310300sfo","San Francisco 49ers",13,"New York Jets",27,40,-14,FALSE,"10/30/1983",1983,"October","1980s",65,78,11
"3756","198310300cin","Cincinnati Bengals",34,"Green Bay Packers",14,48,20,TRUE,"10/30/1983",1983,"October","1980s",46,56,11
"3757","198310300den","Denver Broncos",27,"Kansas City Chiefs",24,51,3,TRUE,"10/30/1983",1983,"October","1980s",50,39,4
"3758","198310300rai","Los Angeles Raiders",21,"Seattle Seahawks",34,55,-13,FALSE,"10/30/1983",1983,"October","1980s",68,76,7
"3759","198310300chi","Chicago Bears",17,"Detroit Lions",38,55,-21,FALSE,"10/30/1983",1983,"October","1980s",43,61,10
"3760","198310300cle","Cleveland Browns",25,"Houston Oilers",19,44,6,TRUE,"10/30/1983",1983,"October","1980s",41,62,7
"3761","198310300buf","Buffalo Bills",27,"New Orleans Saints",21,48,6,TRUE,"10/30/1983",1983,"October","1980s",36,62,5
"3762","198310300phi","Philadelphia Eagles",21,"Baltimore Colts",22,43,-1,FALSE,"10/30/1983",1983,"October","1980s",41,51,8
"3763","198310300atl","Atlanta Falcons",24,"New England Patriots",13,37,11,TRUE,"10/30/1983",1983,"October","1980s",60,63,15
"3764","198310300mia","Miami Dolphins",30,"Los Angeles Rams",14,44,16,TRUE,"10/30/1983",1983,"October","1980s",76,59,12
"3765","198310300pit","Pittsburgh Steelers",17,"Tampa Bay Buccaneers",12,29,5,TRUE,"10/30/1983",1983,"October","1980s",38,55,6
"3766","198310300crd","St. Louis Cardinals",41,"Minnesota Vikings",31,72,10,TRUE,"10/30/1983",1983,"October","1980s",52,64,11
"3767","198310300nyg","New York Giants",20,"Dallas Cowboys",38,58,-18,FALSE,"10/30/1983",1983,"October","1980s",43,49,14
"3768","198310310sdg","San Diego Chargers",24,"Washington Redskins",27,51,-3,FALSE,"10/31/1983",1983,"October","1980s",71,73,9
"3769","198311060kan","Kansas City Chiefs",20,"Los Angeles Raiders",28,48,-8,FALSE,"11/6/1983",1983,"November","1980s",53,88,8
"3770","198311060nor","New Orleans Saints",27,"Atlanta Falcons",10,37,17,TRUE,"11/6/1983",1983,"November","1980s",72,NA,NA
"3771","198311060min","Minnesota Vikings",12,"Tampa Bay Buccaneers",17,29,-5,FALSE,"11/6/1983",1983,"November","1980s",72,NA,NA
"3772","198311060sfo","San Francisco 49ers",17,"Miami Dolphins",20,37,-3,FALSE,"11/6/1983",1983,"November","1980s",59,73,12
"3773","198311060sea","Seattle Seahawks",27,"Denver Broncos",19,46,8,TRUE,"11/6/1983",1983,"November","1980s",72,NA,NA
"3774","198311060nwe","New England Patriots",21,"Buffalo Bills",7,28,14,TRUE,"11/6/1983",1983,"November","1980s",43,88,10
"3775","198311060oti","Houston Oilers",14,"Cincinnati Bengals",55,69,-41,FALSE,"11/6/1983",1983,"November","1980s",72,NA,NA
"3776","198311060pit","Pittsburgh Steelers",26,"San Diego Chargers",3,29,23,TRUE,"11/6/1983",1983,"November","1980s",43,71,11
"3777","198311060was","Washington Redskins",45,"St. Louis Cardinals",7,52,38,TRUE,"11/6/1983",1983,"November","1980s",43,72,10
"3778","198311060nyj","New York Jets",14,"Baltimore Colts",17,31,-3,FALSE,"11/6/1983",1983,"November","1980s",42,68,14
"3779","198311060gnb","Green Bay Packers",35,"Cleveland Browns",21,56,14,TRUE,"11/6/1983",1983,"November","1980s",40,78,6
"3780","198311060ram","Los Angeles Rams",21,"Chicago Bears",14,35,7,TRUE,"11/6/1983",1983,"November","1980s",66,72,8
"3781","198311060phi","Philadelphia Eagles",20,"Dallas Cowboys",27,47,-7,FALSE,"11/6/1983",1983,"November","1980s",38,74,11
"3782","198311070det","Detroit Lions",15,"New York Giants",9,24,6,TRUE,"11/7/1983",1983,"November","1980s",72,NA,NA
"3783","198311130nyg","New York Giants",17,"Washington Redskins",33,50,-16,FALSE,"11/13/1983",1983,"November","1980s",37,55,19
"3784","198311130sdg","San Diego Chargers",24,"Dallas Cowboys",23,47,1,TRUE,"11/13/1983",1983,"November","1980s",70,82,11
"3785","198311130nwe","New England Patriots",17,"Miami Dolphins",6,23,11,TRUE,"11/13/1983",1983,"November","1980s",38,44,14
"3786","198311130crd","St. Louis Cardinals",33,"Seattle Seahawks",28,61,5,TRUE,"11/13/1983",1983,"November","1980s",37,88,9
"3787","198311130clt","Baltimore Colts",13,"Pittsburgh Steelers",24,37,-11,FALSE,"11/13/1983",1983,"November","1980s",38,55,9
"3788","198311130min","Minnesota Vikings",21,"Green Bay Packers",29,50,-8,FALSE,"11/13/1983",1983,"November","1980s",72,NA,NA
"3789","198311130kan","Kansas City Chiefs",20,"Cincinnati Bengals",15,35,5,TRUE,"11/13/1983",1983,"November","1980s",42,80,12
"3790","198311130cle","Cleveland Browns",20,"Tampa Bay Buccaneers",0,20,20,TRUE,"11/13/1983",1983,"November","1980s",30,76,5
"3791","198311130chi","Chicago Bears",17,"Philadelphia Eagles",14,31,3,TRUE,"11/13/1983",1983,"November","1980s",33,71,8
"3792","198311130rai","Los Angeles Raiders",22,"Denver Broncos",20,42,2,TRUE,"11/13/1983",1983,"November","1980s",63,78,9
"3793","198311130sfo","San Francisco 49ers",27,"New Orleans Saints",0,27,27,TRUE,"11/13/1983",1983,"November","1980s",57,79,18
"3794","198311130oti","Houston Oilers",27,"Detroit Lions",17,44,10,TRUE,"11/13/1983",1983,"November","1980s",72,NA,NA
"3795","198311130nyj","New York Jets",17,"Buffalo Bills",24,41,-7,FALSE,"11/13/1983",1983,"November","1980s",37,55,19
"3796","198311140atl","Atlanta Falcons",13,"Los Angeles Rams",36,49,-23,FALSE,"11/14/1983",1983,"November","1980s",41,77,8
"3797","198311200cin","Cincinnati Bengals",38,"Houston Oilers",10,48,28,TRUE,"11/20/1983",1983,"November","1980s",56,72,19
"3798","198311200tam","Tampa Bay Buccaneers",0,"Chicago Bears",27,27,-27,FALSE,"11/20/1983",1983,"November","1980s",69,90,12
"3799","198311200nwe","New England Patriots",0,"Cleveland Browns",30,30,-30,FALSE,"11/20/1983",1983,"November","1980s",44,44,8
"3800","198311200ram","Los Angeles Rams",20,"Washington Redskins",42,62,-22,FALSE,"11/20/1983",1983,"November","1980s",59,68,15
"3801","198311200pit","Pittsburgh Steelers",14,"Minnesota Vikings",17,31,-3,FALSE,"11/20/1983",1983,"November","1980s",53,70,16
"3802","198311200mia","Miami Dolphins",37,"Baltimore Colts",0,37,37,TRUE,"11/20/1983",1983,"November","1980s",78,76,11
"3803","198311200atl","Atlanta Falcons",28,"San Francisco 49ers",24,52,4,TRUE,"11/20/1983",1983,"November","1980s",60,80,17
"3804","198311200phi","Philadelphia Eagles",0,"New York Giants",23,23,-23,FALSE,"11/20/1983",1983,"November","1980s",50,80,6
"3805","198311200buf","Buffalo Bills",24,"Los Angeles Raiders",27,51,-3,FALSE,"11/20/1983",1983,"November","1980s",52,70,12
"3806","198311200den","Denver Broncos",38,"Seattle Seahawks",27,65,11,TRUE,"11/20/1983",1983,"November","1980s",34,49,10
"3807","198311200gnb","Green Bay Packers",20,"Detroit Lions",23,43,-3,FALSE,"11/20/1983",1983,"November","1980s",50,90,20
"3808","198311200crd","St. Louis Cardinals",44,"San Diego Chargers",14,58,30,TRUE,"11/20/1983",1983,"November","1980s",54,80,21
"3809","198311200dal","Dallas Cowboys",41,"Kansas City Chiefs",21,62,20,TRUE,"11/20/1983",1983,"November","1980s",54,49,18
"3810","198311210nor","New Orleans Saints",28,"New York Jets",31,59,-3,FALSE,"11/21/1983",1983,"November","1980s",72,NA,NA
"3811","198311240det","Detroit Lions",45,"Pittsburgh Steelers",3,48,42,TRUE,"11/24/1983",1983,"November","1980s",72,NA,NA
"3812","198311240dal","Dallas Cowboys",35,"St. Louis Cardinals",17,52,18,TRUE,"11/24/1983",1983,"November","1980s",43,61,8
"3813","198311270chi","Chicago Bears",13,"San Francisco 49ers",3,16,10,TRUE,"11/27/1983",1983,"November","1980s",39,86,18
"3814","198311270rai","Los Angeles Raiders",27,"New York Giants",12,39,15,TRUE,"11/27/1983",1983,"November","1980s",54,41,7
"3815","198311270atl","Atlanta Falcons",47,"Green Bay Packers",41,88,6,TRUE,"11/27/1983",1983,"November","1980s",50,74,10
"3816","198311270sdg","San Diego Chargers",31,"Denver Broncos",7,38,24,TRUE,"11/27/1983",1983,"November","1980s",57,42,6
"3817","198311270ram","Los Angeles Rams",41,"Buffalo Bills",17,58,24,TRUE,"11/27/1983",1983,"November","1980s",54,41,7
"3818","198311270nor","New Orleans Saints",17,"Minnesota Vikings",16,33,1,TRUE,"11/27/1983",1983,"November","1980s",72,NA,NA
"3819","198311270tam","Tampa Bay Buccaneers",33,"Houston Oilers",24,57,9,TRUE,"11/27/1983",1983,"November","1980s",73,80,11
"3820","198311270nyj","New York Jets",26,"New England Patriots",3,29,23,TRUE,"11/27/1983",1983,"November","1980s",51,49,14
"3821","198311270was","Washington Redskins",28,"Philadelphia Eagles",24,52,4,TRUE,"11/27/1983",1983,"November","1980s",50,59,5
"3822","198311270cle","Cleveland Browns",41,"Baltimore Colts",23,64,18,TRUE,"11/27/1983",1983,"November","1980s",45,74,8
"3823","198311270sea","Seattle Seahawks",51,"Kansas City Chiefs",48,99,3,TRUE,"11/27/1983",1983,"November","1980s",72,NA,NA
"3824","198311280mia","Miami Dolphins",38,"Cincinnati Bengals",14,52,24,TRUE,"11/28/1983",1983,"November","1980s",78,68,6
"3825","198312010sdg","San Diego Chargers",10,"Los Angeles Raiders",42,52,-32,FALSE,"12/1/1983",1983,"December","1980s",65,64,12
"3826","198312040sfo","San Francisco 49ers",35,"Tampa Bay Buccaneers",21,56,14,TRUE,"12/4/1983",1983,"December","1980s",51,64,24
"3827","198312040phi","Philadelphia Eagles",13,"Los Angeles Rams",9,22,4,TRUE,"12/4/1983",1983,"December","1980s",40,82,11
"3828","198312040nyg","New York Giants",6,"St. Louis Cardinals",10,16,-4,FALSE,"12/4/1983",1983,"December","1980s",40,72,17
"3829","198312040den","Denver Broncos",27,"Cleveland Browns",6,33,21,TRUE,"12/4/1983",1983,"December","1980s",28,64,10
"3830","198312040pit","Pittsburgh Steelers",10,"Cincinnati Bengals",23,33,-13,FALSE,"12/4/1983",1983,"December","1980s",36,79,16
"3831","198312040gnb","Green Bay Packers",31,"Chicago Bears",28,59,3,TRUE,"12/4/1983",1983,"December","1980s",25,84,6
"3832","198312040kan","Kansas City Chiefs",9,"Buffalo Bills",14,23,-5,FALSE,"12/4/1983",1983,"December","1980s",28,96,8
"3833","198312040clt","Baltimore Colts",6,"New York Jets",10,16,-4,FALSE,"12/4/1983",1983,"December","1980s",41,80,12
"3834","198312040oti","Houston Oilers",17,"Miami Dolphins",24,41,-7,FALSE,"12/4/1983",1983,"December","1980s",72,NA,NA
"3835","198312040sea","Seattle Seahawks",10,"Dallas Cowboys",35,45,-25,FALSE,"12/4/1983",1983,"December","1980s",72,NA,NA
"3836","198312040was","Washington Redskins",37,"Atlanta Falcons",21,58,16,TRUE,"12/4/1983",1983,"December","1980s",43,76,9
"3837","198312040nwe","New England Patriots",7,"New Orleans Saints",0,7,7,TRUE,"12/4/1983",1983,"December","1980s",34,61,20
"3838","198312050det","Detroit Lions",13,"Minnesota Vikings",2,15,11,TRUE,"12/5/1983",1983,"December","1980s",72,NA,NA
"3839","198312100mia","Miami Dolphins",31,"Atlanta Falcons",24,55,7,TRUE,"12/10/1983",1983,"December","1980s",72,74,10
"3840","198312100nyj","New York Jets",7,"Pittsburgh Steelers",34,41,-27,FALSE,"12/10/1983",1983,"December","1980s",45,65,12
"3841","198312110dal","Dallas Cowboys",10,"Washington Redskins",31,41,-21,FALSE,"12/11/1983",1983,"December","1980s",58,47,19
"3842","198312110oti","Houston Oilers",34,"Cleveland Browns",27,61,7,TRUE,"12/11/1983",1983,"December","1980s",72,NA,NA
"3843","198312110den","Denver Broncos",21,"Baltimore Colts",19,40,2,TRUE,"12/11/1983",1983,"December","1980s",40,46,13
"3844","198312110cin","Cincinnati Bengals",17,"Detroit Lions",9,26,8,TRUE,"12/11/1983",1983,"December","1980s",43,88,16
"3845","198312110min","Minnesota Vikings",13,"Chicago Bears",19,32,-6,FALSE,"12/11/1983",1983,"December","1980s",72,NA,NA
"3846","198312110buf","Buffalo Bills",10,"San Francisco 49ers",23,33,-13,FALSE,"12/11/1983",1983,"December","1980s",27,72,14
"3847","198312110sdg","San Diego Chargers",41,"Kansas City Chiefs",38,79,3,TRUE,"12/11/1983",1983,"December","1980s",58,78,6
"3848","198312110rai","Los Angeles Raiders",24,"St. Louis Cardinals",34,58,-10,FALSE,"12/11/1983",1983,"December","1980s",56,70,5
"3849","198312110ram","Los Angeles Rams",7,"New England Patriots",21,28,-14,FALSE,"12/11/1983",1983,"December","1980s",56,70,5
"3850","198312110phi","Philadelphia Eagles",17,"New Orleans Saints",20,37,-3,FALSE,"12/11/1983",1983,"December","1980s",37,75,10
"3851","198312110nyg","New York Giants",12,"Seattle Seahawks",17,29,-5,FALSE,"12/11/1983",1983,"December","1980s",39,65,16
"3852","198312120tam","Tampa Bay Buccaneers",9,"Green Bay Packers",12,21,-3,FALSE,"12/12/1983",1983,"December","1980s",67,87,15
"3853","198312160mia","Miami Dolphins",34,"New York Jets",14,48,20,TRUE,"12/16/1983",1983,"December","1980s",69,76,8
"3854","198312170was","Washington Redskins",31,"New York Giants",22,53,9,TRUE,"12/17/1983",1983,"December","1980s",40,50,8
"3855","198312170min","Minnesota Vikings",20,"Cincinnati Bengals",14,34,6,TRUE,"12/17/1983",1983,"December","1980s",72,NA,NA
"3856","198312180nor","New Orleans Saints",24,"Los Angeles Rams",26,50,-2,FALSE,"12/18/1983",1983,"December","1980s",72,NA,NA
"3857","198312180chi","Chicago Bears",23,"Green Bay Packers",21,44,2,TRUE,"12/18/1983",1983,"December","1980s",0,57,13
"3858","198312180sea","Seattle Seahawks",24,"New England Patriots",6,30,18,TRUE,"12/18/1983",1983,"December","1980s",72,NA,NA
"3859","198312180rai","Los Angeles Raiders",30,"San Diego Chargers",14,44,16,TRUE,"12/18/1983",1983,"December","1980s",56,75,6
"3860","198312180det","Detroit Lions",23,"Tampa Bay Buccaneers",20,43,3,TRUE,"12/18/1983",1983,"December","1980s",72,NA,NA
"3861","198312180atl","Atlanta Falcons",31,"Buffalo Bills",14,45,17,TRUE,"12/18/1983",1983,"December","1980s",43,51,12
"3862","198312180clt","Baltimore Colts",20,"Houston Oilers",10,30,10,TRUE,"12/18/1983",1983,"December","1980s",30,63,6
"3863","198312180crd","St. Louis Cardinals",31,"Philadelphia Eagles",7,38,24,TRUE,"12/18/1983",1983,"December","1980s",12,87,15
"3864","198312180cle","Cleveland Browns",30,"Pittsburgh Steelers",17,47,13,TRUE,"12/18/1983",1983,"December","1980s",18,79,11
"3865","198312180kan","Kansas City Chiefs",48,"Denver Broncos",17,65,31,TRUE,"12/18/1983",1983,"December","1980s",0,72,15
"3866","198312190sfo","San Francisco 49ers",42,"Dallas Cowboys",17,59,25,TRUE,"12/19/1983",1983,"December","1980s",54,78,11
"3867","198312240sea","Seattle Seahawks",31,"Denver Broncos",7,38,24,TRUE,"12/24/1983",1983,"December","1980s",72,NA,NA
"3868","198312260dal","Dallas Cowboys",17,"Los Angeles Rams",24,41,-7,FALSE,"12/26/1983",1983,"December","1980s",20,48,13
"3869","198312310mia","Miami Dolphins",20,"Seattle Seahawks",27,47,-7,FALSE,"12/31/1983",1983,"December","1980s",51,84,18
"3870","198312310sfo","San Francisco 49ers",24,"Detroit Lions",23,47,1,TRUE,"12/31/1983",1983,"December","1980s",56,83,10
"3871","198401010rai","Los Angeles Raiders",38,"Pittsburgh Steelers",10,48,28,TRUE,"1/1/1984",1984,"January","1980s",61,64,6
"3872","198401010was","Washington Redskins",51,"Los Angeles Rams",7,58,44,TRUE,"1/1/1984",1984,"January","1980s",28,50,5
"3873","198401080rai","Los Angeles Raiders",30,"Seattle Seahawks",14,44,16,TRUE,"1/8/1984",1984,"January","1980s",56,81,6
"3874","198401080was","Washington Redskins",24,"San Francisco 49ers",21,45,3,TRUE,"1/8/1984",1984,"January","1980s",32,50,10
"3875","198401220rai","Los Angeles Raiders",38,"Washington Redskins",9,47,29,TRUE,"1/22/1984",1984,"January","1980s",51,63,16
"3876","198409020nor","New Orleans Saints",28,"Atlanta Falcons",36,64,-8,FALSE,"9/2/1984",1984,"September","1980s",72,NA,NA
"3877","198409020buf","Buffalo Bills",17,"New England Patriots",21,38,-4,FALSE,"9/2/1984",1984,"September","1980s",65,80,8
"3878","198409020was","Washington Redskins",17,"Miami Dolphins",35,52,-18,FALSE,"9/2/1984",1984,"September","1980s",76,62,10
"3879","198409020min","Minnesota Vikings",13,"San Diego Chargers",42,55,-29,FALSE,"9/2/1984",1984,"September","1980s",72,NA,NA
"3880","198409020det","Detroit Lions",27,"San Francisco 49ers",30,57,-3,FALSE,"9/2/1984",1984,"September","1980s",72,NA,NA
"3881","198409020oti","Houston Oilers",14,"Los Angeles Raiders",24,38,-10,FALSE,"9/2/1984",1984,"September","1980s",72,NA,NA
"3882","198409020den","Denver Broncos",20,"Cincinnati Bengals",17,37,3,TRUE,"9/2/1984",1984,"September","1980s",63,56,8
"3883","198409020clt","Indianapolis Colts",14,"New York Jets",23,37,-9,FALSE,"9/2/1984",1984,"September","1980s",72,NA,NA
"3884","198409020pit","Pittsburgh Steelers",27,"Kansas City Chiefs",37,64,-10,FALSE,"9/2/1984",1984,"September","1980s",70,57,8
"3885","198409020nyg","New York Giants",28,"Philadelphia Eagles",27,55,1,TRUE,"9/2/1984",1984,"September","1980s",70,52,10
"3886","198409020chi","Chicago Bears",34,"Tampa Bay Buccaneers",14,48,20,TRUE,"9/2/1984",1984,"September","1980s",78,64,12
"3887","198409020gnb","Green Bay Packers",24,"St. Louis Cardinals",23,47,1,TRUE,"9/2/1984",1984,"September","1980s",63,94,9
"3888","198409030sea","Seattle Seahawks",33,"Cleveland Browns",0,33,33,TRUE,"9/3/1984",1984,"September","1980s",72,NA,NA
"3889","198409030ram","Los Angeles Rams",13,"Dallas Cowboys",20,33,-7,FALSE,"9/3/1984",1984,"September","1980s",71,77,10
"3890","198409060nyj","New York Jets",17,"Pittsburgh Steelers",23,40,-6,FALSE,"9/6/1984",1984,"September","1980s",62,55,15
"3891","198409090nyg","New York Giants",28,"Dallas Cowboys",7,35,21,TRUE,"9/9/1984",1984,"September","1980s",66,69,13
"3892","198409090oti","Houston Oilers",21,"Indianapolis Colts",35,56,-14,FALSE,"9/9/1984",1984,"September","1980s",72,NA,NA
"3893","198409090ram","Los Angeles Rams",20,"Cleveland Browns",17,37,3,TRUE,"9/9/1984",1984,"September","1980s",85,45,9
"3894","198409090chi","Chicago Bears",27,"Denver Broncos",0,27,27,TRUE,"9/9/1984",1984,"September","1980s",68,77,10
"3895","198409090atl","Atlanta Falcons",24,"Detroit Lions",27,51,-3,FALSE,"9/9/1984",1984,"September","1980s",70,60,10
"3896","198409090mia","Miami Dolphins",28,"New England Patriots",7,35,21,TRUE,"9/9/1984",1984,"September","1980s",78,65,10
"3897","198409090cin","Cincinnati Bengals",22,"Kansas City Chiefs",27,49,-5,FALSE,"9/9/1984",1984,"September","1980s",69,57,13
"3898","198409090rai","Los Angeles Raiders",28,"Green Bay Packers",7,35,21,TRUE,"9/9/1984",1984,"September","1980s",85,45,9
"3899","198409090nor","New Orleans Saints",17,"Tampa Bay Buccaneers",13,30,4,TRUE,"9/9/1984",1984,"September","1980s",72,NA,NA
"3900","198409090crd","St. Louis Cardinals",37,"Buffalo Bills",7,44,30,TRUE,"9/9/1984",1984,"September","1980s",68,95,11
"3901","198409090phi","Philadelphia Eagles",19,"Minnesota Vikings",17,36,2,TRUE,"9/9/1984",1984,"September","1980s",64,62,5
"3902","198409090sea","Seattle Seahawks",31,"San Diego Chargers",17,48,14,TRUE,"9/9/1984",1984,"September","1980s",72,NA,NA
"3903","198409100sfo","San Francisco 49ers",37,"Washington Redskins",31,68,6,TRUE,"9/10/1984",1984,"September","1980s",68,64,17
"3904","198409160gnb","Green Bay Packers",7,"Chicago Bears",9,16,-2,FALSE,"9/16/1984",1984,"September","1980s",50,66,9
"3905","198409160clt","Indianapolis Colts",33,"St. Louis Cardinals",34,67,-1,FALSE,"9/16/1984",1984,"September","1980s",72,NA,NA
"3906","198409160sdg","San Diego Chargers",31,"Houston Oilers",14,45,17,TRUE,"9/16/1984",1984,"September","1980s",80,77,8
"3907","198409160cle","Cleveland Browns",14,"Denver Broncos",24,38,-10,FALSE,"9/16/1984",1984,"September","1980s",50,70,7
"3908","198409160nyj","New York Jets",43,"Cincinnati Bengals",23,66,20,TRUE,"9/16/1984",1984,"September","1980s",56,66,13
"3909","198409160pit","Pittsburgh Steelers",24,"Los Angeles Rams",14,38,10,TRUE,"9/16/1984",1984,"September","1980s",50,62,7
"3910","198409160sfo","San Francisco 49ers",30,"New Orleans Saints",20,50,10,TRUE,"9/16/1984",1984,"September","1980s",65,68,16
"3911","198409160tam","Tampa Bay Buccaneers",21,"Detroit Lions",17,38,4,TRUE,"9/16/1984",1984,"September","1980s",81,66,7
"3912","198409160nwe","New England Patriots",38,"Seattle Seahawks",23,61,15,TRUE,"9/16/1984",1984,"September","1980s",50,62,13
"3913","198409160dal","Dallas Cowboys",23,"Philadelphia Eagles",17,40,6,TRUE,"9/16/1984",1984,"September","1980s",69,49,13
"3914","198409160was","Washington Redskins",30,"New York Giants",14,44,16,TRUE,"9/16/1984",1984,"September","1980s",60,56,12
"3915","198409160kan","Kansas City Chiefs",20,"Los Angeles Raiders",22,42,-2,FALSE,"9/16/1984",1984,"September","1980s",55,61,9
"3916","198409160min","Minnesota Vikings",27,"Atlanta Falcons",20,47,7,TRUE,"9/16/1984",1984,"September","1980s",72,NA,NA
"3917","198409170buf","Buffalo Bills",17,"Miami Dolphins",21,38,-4,FALSE,"9/17/1984",1984,"September","1980s",54,65,8
"3918","198409230det","Detroit Lions",28,"Minnesota Vikings",29,57,-1,FALSE,"9/23/1984",1984,"September","1980s",72,NA,NA
"3919","198409230cin","Cincinnati Bengals",14,"Los Angeles Rams",24,38,-10,FALSE,"9/23/1984",1984,"September","1980s",69,71,11
"3920","198409230den","Denver Broncos",21,"Kansas City Chiefs",0,21,21,TRUE,"9/23/1984",1984,"September","1980s",64,40,11
"3921","198409230mia","Miami Dolphins",44,"Indianapolis Colts",7,51,37,TRUE,"9/23/1984",1984,"September","1980s",81,63,18
"3922","198409230dal","Dallas Cowboys",20,"Green Bay Packers",6,26,14,TRUE,"9/23/1984",1984,"September","1980s",80,67,11
"3923","198409230nwe","New England Patriots",10,"Washington Redskins",26,36,-16,FALSE,"9/23/1984",1984,"September","1980s",66,67,13
"3924","198409230nor","New Orleans Saints",34,"St. Louis Cardinals",24,58,10,TRUE,"9/23/1984",1984,"September","1980s",72,NA,NA
"3925","198409230nyg","New York Giants",17,"Tampa Bay Buccaneers",14,31,3,TRUE,"9/23/1984",1984,"September","1980s",70,72,14
"3926","198409230cle","Cleveland Browns",20,"Pittsburgh Steelers",10,30,10,TRUE,"9/23/1984",1984,"September","1980s",70,70,12
"3927","198409230atl","Atlanta Falcons",42,"Houston Oilers",10,52,32,TRUE,"9/23/1984",1984,"September","1980s",72,66,10
"3928","198409230phi","Philadelphia Eagles",9,"San Francisco 49ers",21,30,-12,FALSE,"9/23/1984",1984,"September","1980s",68,68,9
"3929","198409230sea","Seattle Seahawks",38,"Chicago Bears",9,47,29,TRUE,"9/23/1984",1984,"September","1980s",72,NA,NA
"3930","198409230buf","Buffalo Bills",26,"New York Jets",28,54,-2,FALSE,"9/23/1984",1984,"September","1980s",70,73,16
"3931","198409240rai","Los Angeles Raiders",33,"San Diego Chargers",30,63,3,TRUE,"9/24/1984",1984,"September","1980s",70,59,10
"3932","198409300den","Denver Broncos",16,"Los Angeles Raiders",13,29,3,TRUE,"9/30/1984",1984,"September","1980s",48,43,6
"3933","198409300oti","Houston Oilers",10,"New Orleans Saints",27,37,-17,FALSE,"9/30/1984",1984,"September","1980s",72,NA,NA
"3934","198409300clt","Indianapolis Colts",31,"Buffalo Bills",17,48,14,TRUE,"9/30/1984",1984,"September","1980s",72,NA,NA
"3935","198409300kan","Kansas City Chiefs",10,"Cleveland Browns",6,16,4,TRUE,"9/30/1984",1984,"September","1980s",46,57,7
"3936","198409300min","Minnesota Vikings",12,"Seattle Seahawks",20,32,-8,FALSE,"9/30/1984",1984,"September","1980s",72,NA,NA
"3937","198409300tam","Tampa Bay Buccaneers",30,"Green Bay Packers",27,57,3,TRUE,"9/30/1984",1984,"September","1980s",74,79,6
"3938","198409300chi","Chicago Bears",14,"Dallas Cowboys",23,37,-9,FALSE,"9/30/1984",1984,"September","1980s",44,64,7
"3939","198409300crd","St. Louis Cardinals",28,"Miami Dolphins",36,64,-8,FALSE,"9/30/1984",1984,"September","1980s",47,65,8
"3940","198409300sfo","San Francisco 49ers",14,"Atlanta Falcons",5,19,9,TRUE,"9/30/1984",1984,"September","1980s",62,73,19
"3941","198409300sdg","San Diego Chargers",27,"Detroit Lions",24,51,3,TRUE,"9/30/1984",1984,"September","1980s",74,83,8
"3942","198409300nyj","New York Jets",21,"New England Patriots",28,49,-7,FALSE,"9/30/1984",1984,"September","1980s",58,64,14
"3943","198409300was","Washington Redskins",20,"Philadelphia Eagles",0,20,20,TRUE,"9/30/1984",1984,"September","1980s",60,68,12
"3944","198409300ram","Los Angeles Rams",33,"New York Giants",12,45,21,TRUE,"9/30/1984",1984,"September","1980s",70,73,10
"3945","198410010pit","Pittsburgh Steelers",38,"Cincinnati Bengals",17,55,21,TRUE,"10/1/1984",1984,"October","1980s",48,82,12
"3946","198410070chi","Chicago Bears",20,"New Orleans Saints",7,27,13,TRUE,"10/7/1984",1984,"October","1980s",62,91,11
"3947","198410070det","Detroit Lions",7,"Denver Broncos",28,35,-21,FALSE,"10/7/1984",1984,"October","1980s",72,NA,NA
"3948","198410070tam","Tampa Bay Buccaneers",35,"Minnesota Vikings",31,66,4,TRUE,"10/7/1984",1984,"October","1980s",75,67,9
"3949","198410070rai","Los Angeles Raiders",28,"Seattle Seahawks",14,42,14,TRUE,"10/7/1984",1984,"October","1980s",68,69,10
"3950","198410070clt","Indianapolis Colts",7,"Washington Redskins",35,42,-28,FALSE,"10/7/1984",1984,"October","1980s",72,NA,NA
"3951","198410070dal","Dallas Cowboys",20,"St. Louis Cardinals",31,51,-11,FALSE,"10/7/1984",1984,"October","1980s",71,82,11
"3952","198410070cin","Cincinnati Bengals",13,"Houston Oilers",3,16,10,TRUE,"10/7/1984",1984,"October","1980s",63,88,8
"3953","198410070pit","Pittsburgh Steelers",7,"Miami Dolphins",31,38,-24,FALSE,"10/7/1984",1984,"October","1980s",57,70,7
"3954","198410070kan","Kansas City Chiefs",16,"New York Jets",17,33,-1,FALSE,"10/7/1984",1984,"October","1980s",64,81,9
"3955","198410070ram","Los Angeles Rams",28,"Atlanta Falcons",30,58,-2,FALSE,"10/7/1984",1984,"October","1980s",68,69,10
"3956","198410070buf","Buffalo Bills",17,"Philadelphia Eagles",27,44,-10,FALSE,"10/7/1984",1984,"October","1980s",52,66,8
"3957","198410070cle","Cleveland Browns",16,"New England Patriots",17,33,-1,FALSE,"10/7/1984",1984,"October","1980s",60,72,10
"3958","198410070gnb","Green Bay Packers",28,"San Diego Chargers",34,62,-6,FALSE,"10/7/1984",1984,"October","1980s",59,87,9
"3959","198410080nyg","New York Giants",10,"San Francisco 49ers",31,41,-21,FALSE,"10/8/1984",1984,"October","1980s",60,56,12
"3960","198410140was","Washington Redskins",34,"Dallas Cowboys",14,48,20,TRUE,"10/14/1984",1984,"October","1980s",63,61,14
"3961","198410140nor","New Orleans Saints",10,"Los Angeles Rams",28,38,-18,FALSE,"10/14/1984",1984,"October","1980s",72,NA,NA
"3962","198410140sea","Seattle Seahawks",31,"Buffalo Bills",28,59,3,TRUE,"10/14/1984",1984,"October","1980s",72,NA,NA
"3963","198410140rai","Los Angeles Raiders",23,"Minnesota Vikings",20,43,3,TRUE,"10/14/1984",1984,"October","1980s",69,64,10
"3964","198410140nwe","New England Patriots",20,"Cincinnati Bengals",14,34,6,TRUE,"10/14/1984",1984,"October","1980s",51,84,16
"3965","198410140kan","Kansas City Chiefs",31,"San Diego Chargers",13,44,18,TRUE,"10/14/1984",1984,"October","1980s",67,88,11
"3966","198410140mia","Miami Dolphins",28,"Houston Oilers",10,38,18,TRUE,"10/14/1984",1984,"October","1980s",77,62,7
"3967","198410140crd","St. Louis Cardinals",38,"Chicago Bears",21,59,17,TRUE,"10/14/1984",1984,"October","1980s",69,93,9
"3968","198410140cle","Cleveland Browns",20,"New York Jets",24,44,-4,FALSE,"10/14/1984",1984,"October","1980s",56,80,6
"3969","198410140atl","Atlanta Falcons",7,"New York Giants",19,26,-12,FALSE,"10/14/1984",1984,"October","1980s",72,56,6
"3970","198410140det","Detroit Lions",13,"Tampa Bay Buccaneers",7,20,6,TRUE,"10/14/1984",1984,"October","1980s",72,NA,NA
"3971","198410140sfo","San Francisco 49ers",17,"Pittsburgh Steelers",20,37,-3,FALSE,"10/14/1984",1984,"October","1980s",60,66,15
"3972","198410140phi","Philadelphia Eagles",16,"Indianapolis Colts",7,23,9,TRUE,"10/14/1984",1984,"October","1980s",60,61,14
"3973","198410150den","Denver Broncos",17,"Green Bay Packers",14,31,3,TRUE,"10/15/1984",1984,"October","1980s",32,84,4
"3974","198410210min","Minnesota Vikings",14,"Detroit Lions",16,30,-2,FALSE,"10/21/1984",1984,"October","1980s",72,NA,NA
"3975","198410210gnb","Green Bay Packers",24,"Seattle Seahawks",30,54,-6,FALSE,"10/21/1984",1984,"October","1980s",48,80,12
"3976","198410210nyj","New York Jets",28,"Kansas City Chiefs",7,35,21,TRUE,"10/21/1984",1984,"October","1980s",66,69,9
"3977","198410210dal","Dallas Cowboys",30,"New Orleans Saints",27,57,3,TRUE,"10/21/1984",1984,"October","1980s",59,88,13
"3978","198410210nwe","New England Patriots",24,"Miami Dolphins",44,68,-20,FALSE,"10/21/1984",1984,"October","1980s",58,53,10
"3979","198410210buf","Buffalo Bills",7,"Denver Broncos",37,44,-30,FALSE,"10/21/1984",1984,"October","1980s",58,74,16
"3980","198410210oti","Houston Oilers",21,"San Francisco 49ers",34,55,-13,FALSE,"10/21/1984",1984,"October","1980s",72,NA,NA
"3981","198410210phi","Philadelphia Eagles",24,"New York Giants",10,34,14,TRUE,"10/21/1984",1984,"October","1980s",68,78,9
"3982","198410210crd","St. Louis Cardinals",26,"Washington Redskins",24,50,2,TRUE,"10/21/1984",1984,"October","1980s",48,96,12
"3983","198410210cin","Cincinnati Bengals",12,"Cleveland Browns",9,21,3,TRUE,"10/21/1984",1984,"October","1980s",63,89,12
"3984","198410210sdg","San Diego Chargers",37,"Los Angeles Raiders",44,81,-7,FALSE,"10/21/1984",1984,"October","1980s",65,71,8
"3985","198410210clt","Indianapolis Colts",17,"Pittsburgh Steelers",16,33,1,TRUE,"10/21/1984",1984,"October","1980s",72,NA,NA
"3986","198410210tam","Tampa Bay Buccaneers",9,"Chicago Bears",44,53,-35,FALSE,"10/21/1984",1984,"October","1980s",78,73,9
"3987","198410220atl","Atlanta Falcons",10,"Los Angeles Rams",24,34,-14,FALSE,"10/22/1984",1984,"October","1980s",71,79,12
"3988","198410280pit","Pittsburgh Steelers",35,"Atlanta Falcons",10,45,25,TRUE,"10/28/1984",1984,"October","1980s",68,60,11
"3989","198410280dal","Dallas Cowboys",22,"Indianapolis Colts",3,25,19,TRUE,"10/28/1984",1984,"October","1980s",67,71,10
"3990","198410280nyg","New York Giants",37,"Washington Redskins",13,50,24,TRUE,"10/28/1984",1984,"October","1980s",66,88,8
"3991","198410280gnb","Green Bay Packers",41,"Detroit Lions",9,50,32,TRUE,"10/28/1984",1984,"October","1980s",47,72,19
"3992","198410280cle","Cleveland Browns",14,"New Orleans Saints",16,30,-2,FALSE,"10/28/1984",1984,"October","1980s",69,68,14
"3993","198410280ram","Los Angeles Rams",0,"San Francisco 49ers",33,33,-33,FALSE,"10/28/1984",1984,"October","1980s",60,62,7
"3994","198410280rai","Los Angeles Raiders",19,"Denver Broncos",22,41,-3,FALSE,"10/28/1984",1984,"October","1980s",60,62,7
"3995","198410280chi","Chicago Bears",16,"Minnesota Vikings",7,23,9,TRUE,"10/28/1984",1984,"October","1980s",55,76,12
"3996","198410280nwe","New England Patriots",30,"New York Jets",20,50,10,TRUE,"10/28/1984",1984,"October","1980s",59,88,13
"3997","198410280kan","Kansas City Chiefs",24,"Tampa Bay Buccaneers",20,44,4,TRUE,"10/28/1984",1984,"October","1980s",47,73,14
"3998","198410280mia","Miami Dolphins",38,"Buffalo Bills",7,45,31,TRUE,"10/28/1984",1984,"October","1980s",80,74,16
"3999","198410280phi","Philadelphia Eagles",14,"St. Louis Cardinals",34,48,-20,FALSE,"10/28/1984",1984,"October","1980s",68,79,9
"4000","198410280oti","Houston Oilers",13,"Cincinnati Bengals",31,44,-18,FALSE,"10/28/1984",1984,"October","1980s",72,NA,NA
"4001","198410290sdg","San Diego Chargers",0,"Seattle Seahawks",24,24,-24,FALSE,"10/29/1984",1984,"October","1980s",64,76,9
"4002","198411040sfo","San Francisco 49ers",23,"Cincinnati Bengals",17,40,6,TRUE,"11/4/1984",1984,"November","1980s",55,70,11
"4003","198411040det","Detroit Lions",23,"Philadelphia Eagles",23,46,0,FALSE,"11/4/1984",1984,"November","1980s",72,NA,NA
"4004","198411040nor","New Orleans Saints",13,"Green Bay Packers",23,36,-10,FALSE,"11/4/1984",1984,"November","1980s",72,NA,NA
"4005","198411040sea","Seattle Seahawks",45,"Kansas City Chiefs",0,45,45,TRUE,"11/4/1984",1984,"November","1980s",72,NA,NA
"4006","198411040den","Denver Broncos",26,"New England Patriots",19,45,7,TRUE,"11/4/1984",1984,"November","1980s",47,29,21
"4007","198411040pit","Pittsburgh Steelers",35,"Houston Oilers",7,42,28,TRUE,"11/4/1984",1984,"November","1980s",47,64,9
"4008","198411040nyj","New York Jets",17,"Miami Dolphins",31,48,-14,FALSE,"11/4/1984",1984,"November","1980s",49,67,13
"4009","198411040chi","Chicago Bears",17,"Los Angeles Raiders",6,23,11,TRUE,"11/4/1984",1984,"November","1980s",51,71,18
"4010","198411040min","Minnesota Vikings",27,"Tampa Bay Buccaneers",24,51,3,TRUE,"11/4/1984",1984,"November","1980s",72,NA,NA
"4011","198411040crd","St. Louis Cardinals",13,"Los Angeles Rams",16,29,-3,FALSE,"11/4/1984",1984,"November","1980s",53,72,10
"4012","198411040buf","Buffalo Bills",10,"Cleveland Browns",13,23,-3,FALSE,"11/4/1984",1984,"November","1980s",42,68,11
"4013","198411040clt","Indianapolis Colts",10,"San Diego Chargers",38,48,-28,FALSE,"11/4/1984",1984,"November","1980s",72,NA,NA
"4014","198411040dal","Dallas Cowboys",7,"New York Giants",19,26,-12,FALSE,"11/4/1984",1984,"November","1980s",61,78,15
"4015","198411050was","Washington Redskins",27,"Atlanta Falcons",14,41,13,TRUE,"11/5/1984",1984,"November","1980s",60,81,10
"4016","198411110cin","Cincinnati Bengals",22,"Pittsburgh Steelers",20,42,2,TRUE,"11/11/1984",1984,"November","1980s",43,84,17
"4017","198411110kan","Kansas City Chiefs",16,"Houston Oilers",17,33,-1,FALSE,"11/11/1984",1984,"November","1980s",33,69,11
"4018","198411110nwe","New England Patriots",38,"Buffalo Bills",10,48,28,TRUE,"11/11/1984",1984,"November","1980s",60,81,12
"4019","198411110ram","Los Angeles Rams",29,"Chicago Bears",13,42,16,TRUE,"11/11/1984",1984,"November","1980s",61,51,9
"4020","198411110crd","St. Louis Cardinals",17,"Dallas Cowboys",24,41,-7,FALSE,"11/11/1984",1984,"November","1980s",36,84,19
"4021","198411110sdg","San Diego Chargers",13,"Denver Broncos",16,29,-3,FALSE,"11/11/1984",1984,"November","1980s",64,69,9
"4022","198411110was","Washington Redskins",28,"Detroit Lions",14,42,14,TRUE,"11/11/1984",1984,"November","1980s",57,73,13
"4023","198411110mia","Miami Dolphins",24,"Philadelphia Eagles",23,47,1,TRUE,"11/11/1984",1984,"November","1980s",72,74,10
"4024","198411110atl","Atlanta Falcons",13,"New Orleans Saints",17,30,-4,FALSE,"11/11/1984",1984,"November","1980s",48,72,14
"4025","198411110tam","Tampa Bay Buccaneers",20,"New York Giants",17,37,3,TRUE,"11/11/1984",1984,"November","1980s",67,73,10
"4026","198411110cle","Cleveland Browns",7,"San Francisco 49ers",41,48,-34,FALSE,"11/11/1984",1984,"November","1980s",45,81,15
"4027","198411110nyj","New York Jets",5,"Indianapolis Colts",9,14,-4,FALSE,"11/11/1984",1984,"November","1980s",58,90,13
"4028","198411110gnb","Green Bay Packers",45,"Minnesota Vikings",17,62,28,TRUE,"11/11/1984",1984,"November","1980s",34,69,22
"4029","198411120sea","Seattle Seahawks",17,"Los Angeles Raiders",14,31,3,TRUE,"11/12/1984",1984,"November","1980s",72,NA,NA
"4030","198411180phi","Philadelphia Eagles",16,"Washington Redskins",10,26,6,TRUE,"11/18/1984",1984,"November","1980s",40,57,9
"4031","198411180oti","Houston Oilers",31,"New York Jets",20,51,11,TRUE,"11/18/1984",1984,"November","1980s",72,NA,NA
"4032","198411180sfo","San Francisco 49ers",24,"Tampa Bay Buccaneers",17,41,7,TRUE,"11/18/1984",1984,"November","1980s",56,83,14
"4033","198411180sdg","San Diego Chargers",34,"Miami Dolphins",28,62,6,TRUE,"11/18/1984",1984,"November","1980s",61,83,8
"4034","198411180chi","Chicago Bears",16,"Detroit Lions",14,30,2,TRUE,"11/18/1984",1984,"November","1980s",36,71,11
"4035","198411180buf","Buffalo Bills",14,"Dallas Cowboys",3,17,11,TRUE,"11/18/1984",1984,"November","1980s",38,70,17
"4036","198411180cin","Cincinnati Bengals",6,"Seattle Seahawks",26,32,-20,FALSE,"11/18/1984",1984,"November","1980s",36,71,8
"4037","198411180den","Denver Broncos",42,"Minnesota Vikings",21,63,21,TRUE,"11/18/1984",1984,"November","1980s",32,53,7
"4038","198411180gnb","Green Bay Packers",31,"Los Angeles Rams",6,37,25,TRUE,"11/18/1984",1984,"November","1980s",34,72,13
"4039","198411180clt","Indianapolis Colts",17,"New England Patriots",50,67,-33,FALSE,"11/18/1984",1984,"November","1980s",72,NA,NA
"4040","198411180rai","Los Angeles Raiders",17,"Kansas City Chiefs",7,24,10,TRUE,"11/18/1984",1984,"November","1980s",58,73,9
"4041","198411180nyg","New York Giants",16,"St. Louis Cardinals",10,26,6,TRUE,"11/18/1984",1984,"November","1980s",42,49,14
"4042","198411180atl","Atlanta Falcons",7,"Cleveland Browns",23,30,-16,FALSE,"11/18/1984",1984,"November","1980s",55,50,12
"4043","198411190nor","New Orleans Saints",27,"Pittsburgh Steelers",24,51,3,TRUE,"11/19/1984",1984,"November","1980s",72,NA,NA
"4044","198411220dal","Dallas Cowboys",20,"New England Patriots",17,37,3,TRUE,"11/22/1984",1984,"November","1980s",41,68,5
"4045","198411220det","Detroit Lions",31,"Green Bay Packers",28,59,3,TRUE,"11/22/1984",1984,"November","1980s",72,NA,NA
"4046","198411250pit","Pittsburgh Steelers",52,"San Diego Chargers",24,76,28,TRUE,"11/25/1984",1984,"November","1980s",39,65,3
"4047","198411250cle","Cleveland Browns",27,"Houston Oilers",10,37,17,TRUE,"11/25/1984",1984,"November","1980s",39,63,9
"4048","198411250rai","Los Angeles Raiders",21,"Indianapolis Colts",7,28,14,TRUE,"11/25/1984",1984,"November","1980s",54,59,13
"4049","198411250nyg","New York Giants",28,"Kansas City Chiefs",27,55,1,TRUE,"11/25/1984",1984,"November","1980s",45,57,8
"4050","198411250tam","Tampa Bay Buccaneers",33,"Los Angeles Rams",34,67,-1,FALSE,"11/25/1984",1984,"November","1980s",65,74,8
"4051","198411250den","Denver Broncos",24,"Seattle Seahawks",27,51,-3,FALSE,"11/25/1984",1984,"November","1980s",37,56,7
"4052","198411250crd","St. Louis Cardinals",17,"Philadelphia Eagles",16,33,1,TRUE,"11/25/1984",1984,"November","1980s",47,57,12
"4053","198411250was","Washington Redskins",41,"Buffalo Bills",14,55,27,TRUE,"11/25/1984",1984,"November","1980s",42,66,6
"4054","198411250nor","New Orleans Saints",3,"San Francisco 49ers",35,38,-32,FALSE,"11/25/1984",1984,"November","1980s",72,NA,NA
"4055","198411250min","Minnesota Vikings",3,"Chicago Bears",34,37,-31,FALSE,"11/25/1984",1984,"November","1980s",72,NA,NA
"4056","198411250cin","Cincinnati Bengals",35,"Atlanta Falcons",14,49,21,TRUE,"11/25/1984",1984,"November","1980s",40,56,6
"4057","198411260mia","Miami Dolphins",28,"New York Jets",17,45,11,TRUE,"11/26/1984",1984,"November","1980s",73,61,15
"4058","198411290min","Minnesota Vikings",17,"Washington Redskins",31,48,-14,FALSE,"11/29/1984",1984,"November","1980s",72,NA,NA
"4059","198412020nwe","New England Patriots",10,"St. Louis Cardinals",33,43,-23,FALSE,"12/2/1984",1984,"December","1980s",43,46,14
"4060","198412020kan","Kansas City Chiefs",16,"Denver Broncos",13,29,3,TRUE,"12/2/1984",1984,"December","1980s",37,66,15
"4061","198412020atl","Atlanta Falcons",17,"San Francisco 49ers",35,52,-18,FALSE,"12/2/1984",1984,"December","1980s",46,74,9
"4062","198412020nyj","New York Jets",10,"New York Giants",20,30,-10,FALSE,"12/2/1984",1984,"December","1980s",45,56,14
"4063","198412020cle","Cleveland Browns",17,"Cincinnati Bengals",20,37,-3,FALSE,"12/2/1984",1984,"December","1980s",35,71,9
"4064","198412020oti","Houston Oilers",23,"Pittsburgh Steelers",20,43,3,TRUE,"12/2/1984",1984,"December","1980s",72,NA,NA
"4065","198412020buf","Buffalo Bills",21,"Indianapolis Colts",15,36,6,TRUE,"12/2/1984",1984,"December","1980s",35,62,14
"4066","198412020phi","Philadelphia Eagles",10,"Dallas Cowboys",26,36,-16,FALSE,"12/2/1984",1984,"December","1980s",40,61,7
"4067","198412020mia","Miami Dolphins",34,"Los Angeles Raiders",45,79,-11,FALSE,"12/2/1984",1984,"December","1980s",74,83,9
"4068","198412020sea","Seattle Seahawks",38,"Detroit Lions",17,55,21,TRUE,"12/2/1984",1984,"December","1980s",72,NA,NA
"4069","198412020ram","Los Angeles Rams",34,"New Orleans Saints",21,55,13,TRUE,"12/2/1984",1984,"December","1980s",56,71,7
"4070","198412020gnb","Green Bay Packers",27,"Tampa Bay Buccaneers",14,41,13,TRUE,"12/2/1984",1984,"December","1980s",27,89,12
"4071","198412030sdg","San Diego Chargers",20,"Chicago Bears",7,27,13,TRUE,"12/3/1984",1984,"December","1980s",59,89,10
"4072","198412080sfo","San Francisco 49ers",51,"Minnesota Vikings",7,58,44,TRUE,"12/8/1984",1984,"December","1980s",53,79,6
"4073","198412080nyj","New York Jets",21,"Buffalo Bills",17,38,4,TRUE,"12/8/1984",1984,"December","1980s",32,50,18
"4074","198412090ram","Los Angeles Rams",27,"Houston Oilers",16,43,11,TRUE,"12/9/1984",1984,"December","1980s",58,73,7
"4075","198412090den","Denver Broncos",16,"San Diego Chargers",13,29,3,TRUE,"12/9/1984",1984,"December","1980s",48,37,11
"4076","198412090kan","Kansas City Chiefs",34,"Seattle Seahawks",7,41,27,TRUE,"12/9/1984",1984,"December","1980s",46,78,10
"4077","198412090crd","St. Louis Cardinals",31,"New York Giants",21,52,10,TRUE,"12/9/1984",1984,"December","1980s",41,77,12
"4078","198412090nor","New Orleans Saints",21,"Cincinnati Bengals",24,45,-3,FALSE,"12/9/1984",1984,"December","1980s",72,NA,NA
"4079","198412090phi","Philadelphia Eagles",27,"New England Patriots",17,44,10,TRUE,"12/9/1984",1984,"December","1980s",35,59,5
"4080","198412090chi","Chicago Bears",14,"Green Bay Packers",20,34,-6,FALSE,"12/9/1984",1984,"December","1980s",31,87,7
"4081","198412090dal","Dallas Cowboys",28,"Washington Redskins",30,58,-2,FALSE,"12/9/1984",1984,"December","1980s",58,67,13
"4082","198412090clt","Indianapolis Colts",17,"Miami Dolphins",35,52,-18,FALSE,"12/9/1984",1984,"December","1980s",72,NA,NA
"4083","198412090tam","Tampa Bay Buccaneers",23,"Atlanta Falcons",6,29,17,TRUE,"12/9/1984",1984,"December","1980s",50,69,6
"4084","198412090pit","Pittsburgh Steelers",23,"Cleveland Browns",20,43,3,TRUE,"12/9/1984",1984,"December","1980s",31,79,6
"4085","198412100det","Detroit Lions",3,"Los Angeles Raiders",24,27,-21,FALSE,"12/10/1984",1984,"December","1980s",72,NA,NA
"4086","198412140sfo","San Francisco 49ers",19,"Los Angeles Rams",16,35,3,TRUE,"12/14/1984",1984,"December","1980s",51,46,13
"4087","198412150sea","Seattle Seahawks",14,"Denver Broncos",31,45,-17,FALSE,"12/15/1984",1984,"December","1980s",72,NA,NA
"4088","198412150nyg","New York Giants",3,"New Orleans Saints",10,13,-7,FALSE,"12/15/1984",1984,"December","1980s",38,88,15
"4089","198412160atl","Atlanta Falcons",26,"Philadelphia Eagles",10,36,16,TRUE,"12/16/1984",1984,"December","1980s",58,68,7
"4090","198412160oti","Houston Oilers",20,"Cleveland Browns",27,47,-7,FALSE,"12/16/1984",1984,"December","1980s",72,NA,NA
"4091","198412160was","Washington Redskins",29,"St. Louis Cardinals",27,56,2,TRUE,"12/16/1984",1984,"December","1980s",45,93,10
"4092","198412160rai","Los Angeles Raiders",7,"Pittsburgh Steelers",13,20,-6,FALSE,"12/16/1984",1984,"December","1980s",53,63,16
"4093","198412160nwe","New England Patriots",16,"Indianapolis Colts",10,26,6,TRUE,"12/16/1984",1984,"December","1980s",32,86,8
"4094","198412160cin","Cincinnati Bengals",52,"Buffalo Bills",21,73,31,TRUE,"12/16/1984",1984,"December","1980s",59,76,15
"4095","198412160det","Detroit Lions",13,"Chicago Bears",30,43,-17,FALSE,"12/16/1984",1984,"December","1980s",72,NA,NA
"4096","198412160tam","Tampa Bay Buccaneers",41,"New York Jets",21,62,20,TRUE,"12/16/1984",1984,"December","1980s",69,68,7
"4097","198412160min","Minnesota Vikings",14,"Green Bay Packers",38,52,-24,FALSE,"12/16/1984",1984,"December","1980s",72,NA,NA
"4098","198412160sdg","San Diego Chargers",21,"Kansas City Chiefs",42,63,-21,FALSE,"12/16/1984",1984,"December","1980s",56,75,16
"4099","198412170mia","Miami Dolphins",28,"Dallas Cowboys",21,49,7,TRUE,"12/17/1984",1984,"December","1980s",73,68,16
"4100","198412220sea","Seattle Seahawks",13,"Los Angeles Raiders",7,20,6,TRUE,"12/22/1984",1984,"December","1980s",72,NA,NA
"4101","198412230ram","Los Angeles Rams",13,"New York Giants",16,29,-3,FALSE,"12/23/1984",1984,"December","1980s",55,36,9
"4102","198412290mia","Miami Dolphins",31,"Seattle Seahawks",10,41,21,TRUE,"12/29/1984",1984,"December","1980s",74,71,16
"4103","198412290sfo","San Francisco 49ers",21,"New York Giants",10,31,11,TRUE,"12/29/1984",1984,"December","1980s",43,88,9
"4104","198412300den","Denver Broncos",17,"Pittsburgh Steelers",24,41,-7,FALSE,"12/30/1984",1984,"December","1980s",33,58,6
"4105","198412300was","Washington Redskins",19,"Chicago Bears",23,42,-4,FALSE,"12/30/1984",1984,"December","1980s",57,64,13
"4106","198501060mia","Miami Dolphins",45,"Pittsburgh Steelers",28,73,17,TRUE,"1/6/1985",1985,"January","1980s",58,55,13
"4107","198501060sfo","San Francisco 49ers",23,"Chicago Bears",0,23,23,TRUE,"1/6/1985",1985,"January","1980s",48,80,5
"4108","198501200mia","Miami Dolphins",16,"San Francisco 49ers",38,54,-22,FALSE,"1/20/1985",1985,"January","1980s",45,91,8
"4109","198509080atl","Atlanta Falcons",27,"Detroit Lions",28,55,-1,FALSE,"9/8/1985",1985,"September","1980s",79,67,7
"4110","198509080chi","Chicago Bears",38,"Tampa Bay Buccaneers",28,66,10,TRUE,"9/8/1985",1985,"September","1980s",81,79,10
"4111","198509080min","Minnesota Vikings",28,"San Francisco 49ers",21,49,7,TRUE,"9/8/1985",1985,"September","1980s",72,NA,NA
"4112","198509080buf","Buffalo Bills",9,"San Diego Chargers",14,23,-5,FALSE,"9/8/1985",1985,"September","1980s",76,83,11
"4113","198509080oti","Houston Oilers",26,"Miami Dolphins",23,49,3,TRUE,"9/8/1985",1985,"September","1980s",72,NA,NA
"4114","198509080ram","Los Angeles Rams",20,"Denver Broncos",16,36,4,TRUE,"9/8/1985",1985,"September","1980s",69,62,12
"4115","198509080pit","Pittsburgh Steelers",45,"Indianapolis Colts",3,48,42,TRUE,"9/8/1985",1985,"September","1980s",79,66,9
"4116","198509080cle","Cleveland Browns",24,"St. Louis Cardinals",27,51,-3,FALSE,"9/8/1985",1985,"September","1980s",77,80,10
"4117","198509080nwe","New England Patriots",26,"Green Bay Packers",20,46,6,TRUE,"9/8/1985",1985,"September","1980s",74,74,10
"4118","198509080nyg","New York Giants",21,"Philadelphia Eagles",0,21,21,TRUE,"9/8/1985",1985,"September","1980s",78,82,11
"4119","198509080cin","Cincinnati Bengals",24,"Seattle Seahawks",28,52,-4,FALSE,"9/8/1985",1985,"September","1980s",79,71,8
"4120","198509080rai","Los Angeles Raiders",31,"New York Jets",0,31,31,TRUE,"9/8/1985",1985,"September","1980s",69,62,12
"4121","198509080nor","New Orleans Saints",27,"Kansas City Chiefs",47,74,-20,FALSE,"9/8/1985",1985,"September","1980s",72,NA,NA
"4122","198509090dal","Dallas Cowboys",44,"Washington Redskins",14,58,30,TRUE,"9/9/1985",1985,"September","1980s",88,44,10
"4123","198509120kan","Kansas City Chiefs",36,"Los Angeles Raiders",20,56,16,TRUE,"9/12/1985",1985,"September","1980s",66,73,12
"4124","198509150mia","Miami Dolphins",30,"Indianapolis Colts",13,43,17,TRUE,"9/15/1985",1985,"September","1980s",81,72,23
"4125","198509150chi","Chicago Bears",20,"New England Patriots",7,27,13,TRUE,"9/15/1985",1985,"September","1980s",55,62,5
"4126","198509150was","Washington Redskins",16,"Houston Oilers",13,29,3,TRUE,"9/15/1985",1985,"September","1980s",62,52,8
"4127","198509150det","Detroit Lions",26,"Dallas Cowboys",21,47,5,TRUE,"9/15/1985",1985,"September","1980s",72,NA,NA
"4128","198509150tam","Tampa Bay Buccaneers",16,"Minnesota Vikings",31,47,-15,FALSE,"9/15/1985",1985,"September","1980s",76,68,15
"4129","198509150crd","St. Louis Cardinals",41,"Cincinnati Bengals",27,68,14,TRUE,"9/15/1985",1985,"September","1980s",66,52,8
"4130","198509150phi","Philadelphia Eagles",6,"Los Angeles Rams",17,23,-11,FALSE,"9/15/1985",1985,"September","1980s",60,51,8
"4131","198509150sdg","San Diego Chargers",35,"Seattle Seahawks",49,84,-14,FALSE,"9/15/1985",1985,"September","1980s",70,73,8
"4132","198509150sfo","San Francisco 49ers",35,"Atlanta Falcons",16,51,19,TRUE,"9/15/1985",1985,"September","1980s",62,72,17
"4133","198509150den","Denver Broncos",34,"New Orleans Saints",23,57,11,TRUE,"9/15/1985",1985,"September","1980s",69,45,12
"4134","198509150nyj","New York Jets",42,"Buffalo Bills",3,45,39,TRUE,"9/15/1985",1985,"September","1980s",65,50,10
"4135","198509150gnb","Green Bay Packers",23,"New York Giants",20,43,3,TRUE,"9/15/1985",1985,"September","1980s",56,66,8
"4136","198509160cle","Cleveland Browns",17,"Pittsburgh Steelers",7,24,10,TRUE,"9/16/1985",1985,"September","1980s",57,65,4
"4137","198509190min","Minnesota Vikings",24,"Chicago Bears",33,57,-9,FALSE,"9/19/1985",1985,"September","1980s",72,NA,NA
"4138","198509220dal","Dallas Cowboys",20,"Cleveland Browns",7,27,13,TRUE,"9/22/1985",1985,"September","1980s",80,55,17
"4139","198509220mia","Miami Dolphins",31,"Kansas City Chiefs",0,31,31,TRUE,"9/22/1985",1985,"September","1980s",82,75,9
"4140","198509220pit","Pittsburgh Steelers",20,"Houston Oilers",0,20,20,TRUE,"9/22/1985",1985,"September","1980s",69,65,4
"4141","198509220nor","New Orleans Saints",20,"Tampa Bay Buccaneers",13,33,7,TRUE,"9/22/1985",1985,"September","1980s",72,NA,NA
"4142","198509220atl","Atlanta Falcons",28,"Denver Broncos",44,72,-16,FALSE,"9/22/1985",1985,"September","1980s",73,64,8
"4143","198509220cin","Cincinnati Bengals",41,"San Diego Chargers",44,85,-3,FALSE,"9/22/1985",1985,"September","1980s",71,56,9
"4144","198509220gnb","Green Bay Packers",3,"New York Jets",24,27,-21,FALSE,"9/22/1985",1985,"September","1980s",64,95,13
"4145","198509220clt","Indianapolis Colts",14,"Detroit Lions",6,20,8,TRUE,"9/22/1985",1985,"September","1980s",72,NA,NA
"4146","198509220buf","Buffalo Bills",14,"New England Patriots",17,31,-3,FALSE,"9/22/1985",1985,"September","1980s",65,76,7
"4147","198509220nyg","New York Giants",27,"St. Louis Cardinals",17,44,10,TRUE,"9/22/1985",1985,"September","1980s",72,76,13
"4148","198509220was","Washington Redskins",6,"Philadelphia Eagles",19,25,-13,FALSE,"9/22/1985",1985,"September","1980s",70,82,9
"4149","198509220rai","Los Angeles Raiders",10,"San Francisco 49ers",34,44,-24,FALSE,"9/22/1985",1985,"September","1980s",68,66,9
"4150","198509230sea","Seattle Seahawks",24,"Los Angeles Rams",35,59,-11,FALSE,"9/23/1985",1985,"September","1980s",72,NA,NA
"4151","198509290crd","St. Louis Cardinals",43,"Green Bay Packers",28,71,15,TRUE,"9/29/1985",1985,"September","1980s",65,57,13
"4152","198509290nyj","New York Jets",25,"Indianapolis Colts",20,45,5,TRUE,"9/29/1985",1985,"September","1980s",66,57,8
"4153","198509290phi","Philadelphia Eagles",10,"New York Giants",16,26,-6,FALSE,"9/29/1985",1985,"September","1980s",61,65,5
"4154","198509290nwe","New England Patriots",20,"Los Angeles Raiders",35,55,-15,FALSE,"9/29/1985",1985,"September","1980s",61,66,9
"4155","198509290det","Detroit Lions",30,"Tampa Bay Buccaneers",9,39,21,TRUE,"9/29/1985",1985,"September","1980s",72,NA,NA
"4156","198509290kan","Kansas City Chiefs",28,"Seattle Seahawks",7,35,21,TRUE,"9/29/1985",1985,"September","1980s",48,94,12
"4157","198509290den","Denver Broncos",26,"Miami Dolphins",30,56,-4,FALSE,"9/29/1985",1985,"September","1980s",23,80,6
"4158","198509290sdg","San Diego Chargers",7,"Cleveland Browns",21,28,-14,FALSE,"9/29/1985",1985,"September","1980s",69,72,9
"4159","198509290sfo","San Francisco 49ers",17,"New Orleans Saints",20,37,-3,FALSE,"9/29/1985",1985,"September","1980s",57,75,14
"4160","198509290oti","Houston Oilers",10,"Dallas Cowboys",17,27,-7,FALSE,"9/29/1985",1985,"September","1980s",72,NA,NA
"4161","198509290ram","Los Angeles Rams",17,"Atlanta Falcons",6,23,11,TRUE,"9/29/1985",1985,"September","1980s",67,70,8
"4162","198509290chi","Chicago Bears",45,"Washington Redskins",10,55,35,TRUE,"9/29/1985",1985,"September","1980s",63,52,11
"4163","198509290buf","Buffalo Bills",20,"Minnesota Vikings",27,47,-7,FALSE,"9/29/1985",1985,"September","1980s",60,63,9
"4164","198509300pit","Pittsburgh Steelers",24,"Cincinnati Bengals",37,61,-13,FALSE,"9/30/1985",1985,"September","1980s",62,58,7
"4165","198510060tam","Tampa Bay Buccaneers",19,"Chicago Bears",27,46,-8,FALSE,"10/6/1985",1985,"October","1980s",73,71,9
"4166","198510060mia","Miami Dolphins",24,"Pittsburgh Steelers",20,44,4,TRUE,"10/6/1985",1985,"October","1980s",80,78,9
"4167","198510060gnb","Green Bay Packers",43,"Detroit Lions",10,53,33,TRUE,"10/6/1985",1985,"October","1980s",44,71,11
"4168","198510060sea","Seattle Seahawks",26,"San Diego Chargers",21,47,5,TRUE,"10/6/1985",1985,"October","1980s",72,NA,NA
"4169","198510060cle","Cleveland Browns",24,"New England Patriots",20,44,4,TRUE,"10/6/1985",1985,"October","1980s",46,74,14
"4170","198510060den","Denver Broncos",31,"Houston Oilers",20,51,11,TRUE,"10/6/1985",1985,"October","1980s",57,29,7
"4171","198510060rai","Los Angeles Raiders",19,"Kansas City Chiefs",10,29,9,TRUE,"10/6/1985",1985,"October","1980s",72,59,14
"4172","198510060nyg","New York Giants",29,"Dallas Cowboys",30,59,-1,FALSE,"10/6/1985",1985,"October","1980s",59,56,16
"4173","198510060nor","New Orleans Saints",23,"Philadelphia Eagles",21,44,2,TRUE,"10/6/1985",1985,"October","1980s",72,NA,NA
"4174","198510060ram","Los Angeles Rams",13,"Minnesota Vikings",10,23,3,TRUE,"10/6/1985",1985,"October","1980s",72,59,14
"4175","198510060atl","Atlanta Falcons",17,"San Francisco 49ers",38,55,-21,FALSE,"10/6/1985",1985,"October","1980s",56,58,11
"4176","198510060clt","Indianapolis Colts",49,"Buffalo Bills",17,66,32,TRUE,"10/6/1985",1985,"October","1980s",72,NA,NA
"4177","198510060cin","Cincinnati Bengals",20,"New York Jets",29,49,-9,FALSE,"10/6/1985",1985,"October","1980s",47,68,11
"4178","198510070was","Washington Redskins",27,"St. Louis Cardinals",10,37,17,TRUE,"10/7/1985",1985,"October","1980s",57,51,7
"4179","198510130dal","Dallas Cowboys",27,"Pittsburgh Steelers",13,40,14,TRUE,"10/13/1985",1985,"October","1980s",79,68,15
"4180","198510130tam","Tampa Bay Buccaneers",27,"Los Angeles Rams",31,58,-4,FALSE,"10/13/1985",1985,"October","1980s",78,75,6
"4181","198510130nwe","New England Patriots",14,"Buffalo Bills",3,17,11,TRUE,"10/13/1985",1985,"October","1980s",50,81,12
"4182","198510130rai","Los Angeles Raiders",23,"New Orleans Saints",13,36,10,TRUE,"10/13/1985",1985,"October","1980s",63,67,8
"4183","198510130phi","Philadelphia Eagles",30,"St. Louis Cardinals",7,37,23,TRUE,"10/13/1985",1985,"October","1980s",60,74,10
"4184","198510130was","Washington Redskins",24,"Detroit Lions",3,27,21,TRUE,"10/13/1985",1985,"October","1980s",63,74,11
"4185","198510130oti","Houston Oilers",6,"Cleveland Browns",21,27,-15,FALSE,"10/13/1985",1985,"October","1980s",72,NA,NA
"4186","198510130sdg","San Diego Chargers",31,"Kansas City Chiefs",20,51,11,TRUE,"10/13/1985",1985,"October","1980s",64,72,7
"4187","198510130sfo","San Francisco 49ers",10,"Chicago Bears",26,36,-16,FALSE,"10/13/1985",1985,"October","1980s",58,64,11
"4188","198510130clt","Indianapolis Colts",10,"Denver Broncos",15,25,-5,FALSE,"10/13/1985",1985,"October","1980s",72,NA,NA
"4189","198510130cin","Cincinnati Bengals",35,"New York Giants",30,65,5,TRUE,"10/13/1985",1985,"October","1980s",72,75,11
"4190","198510130sea","Seattle Seahawks",30,"Atlanta Falcons",26,56,4,TRUE,"10/13/1985",1985,"October","1980s",72,NA,NA
"4191","198510130gnb","Green Bay Packers",20,"Minnesota Vikings",17,37,3,TRUE,"10/13/1985",1985,"October","1980s",57,78,10
"4192","198510140nyj","New York Jets",23,"Miami Dolphins",7,30,16,TRUE,"10/14/1985",1985,"October","1980s",65,82,9
"4193","198510200atl","Atlanta Falcons",31,"New Orleans Saints",24,55,7,TRUE,"10/20/1985",1985,"October","1980s",72,70,6
"4194","198510200nyg","New York Giants",17,"Washington Redskins",3,20,14,TRUE,"10/20/1985",1985,"October","1980s",60,58,14
"4195","198510200kan","Kansas City Chiefs",0,"Los Angeles Rams",16,16,-16,FALSE,"10/20/1985",1985,"October","1980s",56,92,5
"4196","198510200pit","Pittsburgh Steelers",23,"St. Louis Cardinals",10,33,13,TRUE,"10/20/1985",1985,"October","1980s",56,78,10
"4197","198510200oti","Houston Oilers",44,"Cincinnati Bengals",27,71,17,TRUE,"10/20/1985",1985,"October","1980s",72,NA,NA
"4198","198510200mia","Miami Dolphins",41,"Tampa Bay Buccaneers",38,79,3,TRUE,"10/20/1985",1985,"October","1980s",78,77,12
"4199","198510200min","Minnesota Vikings",21,"San Diego Chargers",17,38,4,TRUE,"10/20/1985",1985,"October","1980s",72,NA,NA
"4200","198510200phi","Philadelphia Eagles",16,"Dallas Cowboys",14,30,2,TRUE,"10/20/1985",1985,"October","1980s",63,62,12
"4201","198510200den","Denver Broncos",13,"Seattle Seahawks",10,23,3,TRUE,"10/20/1985",1985,"October","1980s",50,42,6
"4202","198510200buf","Buffalo Bills",21,"Indianapolis Colts",9,30,12,TRUE,"10/20/1985",1985,"October","1980s",47,76,8
"4203","198510200nwe","New England Patriots",20,"New York Jets",13,33,7,TRUE,"10/20/1985",1985,"October","1980s",54,60,12
"4204","198510200det","Detroit Lions",23,"San Francisco 49ers",21,44,2,TRUE,"10/20/1985",1985,"October","1980s",72,NA,NA
"4205","198510200cle","Cleveland Browns",20,"Los Angeles Raiders",21,41,-1,FALSE,"10/20/1985",1985,"October","1980s",54,73,12
"4206","198510210chi","Chicago Bears",23,"Green Bay Packers",7,30,16,TRUE,"10/21/1985",1985,"October","1980s",54,80,10
"4207","198510270ram","Los Angeles Rams",14,"San Francisco 49ers",28,42,-14,FALSE,"10/27/1985",1985,"October","1980s",64,82,8
"4208","198510270kan","Kansas City Chiefs",10,"Denver Broncos",30,40,-20,FALSE,"10/27/1985",1985,"October","1980s",62,78,8
"4209","198510270dal","Dallas Cowboys",24,"Atlanta Falcons",10,34,14,TRUE,"10/27/1985",1985,"October","1980s",64,67,11
"4210","198510270det","Detroit Lions",31,"Miami Dolphins",21,52,10,TRUE,"10/27/1985",1985,"October","1980s",72,NA,NA
"4211","198510270phi","Philadelphia Eagles",21,"Buffalo Bills",17,38,4,TRUE,"10/27/1985",1985,"October","1980s",55,68,11
"4212","198510270clt","Indianapolis Colts",37,"Green Bay Packers",10,47,27,TRUE,"10/27/1985",1985,"October","1980s",72,NA,NA
"4213","198510270nor","New Orleans Saints",13,"New York Giants",21,34,-8,FALSE,"10/27/1985",1985,"October","1980s",72,NA,NA
"4214","198510270chi","Chicago Bears",27,"Minnesota Vikings",9,36,18,TRUE,"10/27/1985",1985,"October","1980s",57,48,11
"4215","198510270cle","Cleveland Browns",7,"Washington Redskins",14,21,-7,FALSE,"10/27/1985",1985,"October","1980s",53,50,8
"4216","198510270crd","St. Louis Cardinals",10,"Houston Oilers",20,30,-10,FALSE,"10/27/1985",1985,"October","1980s",61,41,5
"4217","198510270nyj","New York Jets",17,"Seattle Seahawks",14,31,3,TRUE,"10/27/1985",1985,"October","1980s",61,38,14
"4218","198510270tam","Tampa Bay Buccaneers",14,"New England Patriots",32,46,-18,FALSE,"10/27/1985",1985,"October","1980s",77,84,11
"4219","198510270cin","Cincinnati Bengals",26,"Pittsburgh Steelers",21,47,5,TRUE,"10/27/1985",1985,"October","1980s",59,56,4
"4220","198510280rai","Los Angeles Raiders",34,"San Diego Chargers",21,55,13,TRUE,"10/28/1985",1985,"October","1980s",65,73,9
"4221","198511030min","Minnesota Vikings",16,"Detroit Lions",13,29,3,TRUE,"11/3/1985",1985,"November","1980s",72,NA,NA
"4222","198511030sdg","San Diego Chargers",30,"Denver Broncos",10,40,20,TRUE,"11/3/1985",1985,"November","1980s",65,58,6
"4223","198511030ram","Los Angeles Rams",28,"New Orleans Saints",10,38,18,TRUE,"11/3/1985",1985,"November","1980s",67,53,9
"4224","198511030pit","Pittsburgh Steelers",10,"Cleveland Browns",9,19,1,TRUE,"11/3/1985",1985,"November","1980s",50,87,9
"4225","198511030atl","Atlanta Falcons",10,"Washington Redskins",44,54,-34,FALSE,"11/3/1985",1985,"November","1980s",58,92,7
"4226","198511030nyg","New York Giants",22,"Tampa Bay Buccaneers",20,42,2,TRUE,"11/3/1985",1985,"November","1980s",53,73,21
"4227","198511030gnb","Green Bay Packers",10,"Chicago Bears",16,26,-6,FALSE,"11/3/1985",1985,"November","1980s",42,80,11
"4228","198511030oti","Houston Oilers",23,"Kansas City Chiefs",20,43,3,TRUE,"11/3/1985",1985,"November","1980s",72,NA,NA
"4229","198511030sfo","San Francisco 49ers",24,"Philadelphia Eagles",13,37,11,TRUE,"11/3/1985",1985,"November","1980s",58,78,10
"4230","198511030sea","Seattle Seahawks",33,"Los Angeles Raiders",3,36,30,TRUE,"11/3/1985",1985,"November","1980s",72,NA,NA
"4231","198511030clt","Indianapolis Colts",17,"New York Jets",35,52,-18,FALSE,"11/3/1985",1985,"November","1980s",72,NA,NA
"4232","198511030nwe","New England Patriots",17,"Miami Dolphins",13,30,4,TRUE,"11/3/1985",1985,"November","1980s",48,87,17
"4233","198511030buf","Buffalo Bills",17,"Cincinnati Bengals",23,40,-6,FALSE,"11/3/1985",1985,"November","1980s",50,92,11
"4234","198511040crd","St. Louis Cardinals",21,"Dallas Cowboys",10,31,11,TRUE,"11/4/1985",1985,"November","1980s",42,74,12
"4235","198511100was","Washington Redskins",7,"Dallas Cowboys",13,20,-6,FALSE,"11/10/1985",1985,"November","1980s",60,60,17
"4236","198511100buf","Buffalo Bills",20,"Houston Oilers",0,20,20,TRUE,"11/10/1985",1985,"November","1980s",45,96,14
"4237","198511100tam","Tampa Bay Buccaneers",16,"St. Louis Cardinals",0,16,16,TRUE,"11/10/1985",1985,"November","1980s",70,79,8
"4238","198511100min","Minnesota Vikings",17,"Green Bay Packers",27,44,-10,FALSE,"11/10/1985",1985,"November","1980s",72,NA,NA
"4239","198511100mia","Miami Dolphins",21,"New York Jets",17,38,4,TRUE,"11/10/1985",1985,"November","1980s",76,72,10
"4240","198511100cin","Cincinnati Bengals",27,"Cleveland Browns",10,37,17,TRUE,"11/10/1985",1985,"November","1980s",61,60,19
"4241","198511100phi","Philadelphia Eagles",23,"Atlanta Falcons",17,40,6,TRUE,"11/10/1985",1985,"November","1980s",61,64,16
"4242","198511100kan","Kansas City Chiefs",28,"Pittsburgh Steelers",36,64,-8,FALSE,"11/10/1985",1985,"November","1980s",36,94,13
"4243","198511100sdg","San Diego Chargers",40,"Los Angeles Raiders",34,74,6,TRUE,"11/10/1985",1985,"November","1980s",61,56,10
"4244","198511100chi","Chicago Bears",24,"Detroit Lions",3,27,21,TRUE,"11/10/1985",1985,"November","1980s",39,85,18
"4245","198511100nor","New Orleans Saints",3,"Seattle Seahawks",27,30,-24,FALSE,"11/10/1985",1985,"November","1980s",72,NA,NA
"4246","198511100nyg","New York Giants",24,"Los Angeles Rams",19,43,5,TRUE,"11/10/1985",1985,"November","1980s",63,56,18
"4247","198511100nwe","New England Patriots",34,"Indianapolis Colts",15,49,19,TRUE,"11/10/1985",1985,"November","1980s",61,66,18
"4248","198511110den","Denver Broncos",17,"San Francisco 49ers",16,33,1,TRUE,"11/11/1985",1985,"November","1980s",17,84,5
"4249","198511170oti","Houston Oilers",7,"Pittsburgh Steelers",30,37,-23,FALSE,"11/17/1985",1985,"November","1980s",72,NA,NA
"4250","198511170sea","Seattle Seahawks",13,"New England Patriots",20,33,-7,FALSE,"11/17/1985",1985,"November","1980s",72,NA,NA
"4251","198511170gnb","Green Bay Packers",38,"New Orleans Saints",14,52,24,TRUE,"11/17/1985",1985,"November","1980s",40,76,17
"4252","198511170sfo","San Francisco 49ers",31,"Kansas City Chiefs",3,34,28,TRUE,"11/17/1985",1985,"November","1980s",51,73,18
"4253","198511170nyj","New York Jets",62,"Tampa Bay Buccaneers",28,90,34,TRUE,"11/17/1985",1985,"November","1980s",54,74,16
"4254","198511170rai","Los Angeles Raiders",13,"Cincinnati Bengals",6,19,7,TRUE,"11/17/1985",1985,"November","1980s",60,62,13
"4255","198511170det","Detroit Lions",41,"Minnesota Vikings",21,62,20,TRUE,"11/17/1985",1985,"November","1980s",72,NA,NA
"4256","198511170den","Denver Broncos",30,"San Diego Chargers",24,54,6,TRUE,"11/17/1985",1985,"November","1980s",32,66,7
"4257","198511170clt","Indianapolis Colts",20,"Miami Dolphins",34,54,-14,FALSE,"11/17/1985",1985,"November","1980s",72,NA,NA
"4258","198511170dal","Dallas Cowboys",0,"Chicago Bears",44,44,-44,FALSE,"11/17/1985",1985,"November","1980s",57,83,10
"4259","198511170cle","Cleveland Browns",17,"Buffalo Bills",7,24,10,TRUE,"11/17/1985",1985,"November","1980s",45,69,16
"4260","198511170atl","Atlanta Falcons",30,"Los Angeles Rams",14,44,16,TRUE,"11/17/1985",1985,"November","1980s",70,69,7
"4261","198511170crd","St. Louis Cardinals",14,"Philadelphia Eagles",24,38,-10,FALSE,"11/17/1985",1985,"November","1980s",48,72,9
"4262","198511180was","Washington Redskins",23,"New York Giants",21,44,2,TRUE,"11/18/1985",1985,"November","1980s",52,82,6
"4263","198511240crd","St. Louis Cardinals",3,"New York Giants",34,37,-31,FALSE,"11/24/1985",1985,"November","1980s",30,78,12
"4264","198511240pit","Pittsburgh Steelers",23,"Washington Redskins",30,53,-7,FALSE,"11/24/1985",1985,"November","1980s",38,59,8
"4265","198511240dal","Dallas Cowboys",34,"Philadelphia Eagles",17,51,17,TRUE,"11/24/1985",1985,"November","1980s",52,86,11
"4266","198511240rai","Los Angeles Raiders",31,"Denver Broncos",28,59,3,TRUE,"11/24/1985",1985,"November","1980s",56,76,11
"4267","198511240min","Minnesota Vikings",23,"New Orleans Saints",30,53,-7,FALSE,"11/24/1985",1985,"November","1980s",72,NA,NA
"4268","198511240chi","Chicago Bears",36,"Atlanta Falcons",0,36,36,TRUE,"11/24/1985",1985,"November","1980s",20,57,11
"4269","198511240ram","Los Angeles Rams",34,"Green Bay Packers",17,51,17,TRUE,"11/24/1985",1985,"November","1980s",56,76,11
"4270","198511240nyj","New York Jets",16,"New England Patriots",13,29,3,TRUE,"11/24/1985",1985,"November","1980s",46,55,16
"4271","198511240oti","Houston Oilers",37,"San Diego Chargers",35,72,2,TRUE,"11/24/1985",1985,"November","1980s",72,NA,NA
"4272","198511240cle","Cleveland Browns",24,"Cincinnati Bengals",6,30,18,TRUE,"11/24/1985",1985,"November","1980s",36,71,11
"4273","198511240kan","Kansas City Chiefs",20,"Indianapolis Colts",7,27,13,TRUE,"11/24/1985",1985,"November","1980s",22,72,14
"4274","198511240tam","Tampa Bay Buccaneers",19,"Detroit Lions",16,35,3,TRUE,"11/24/1985",1985,"November","1980s",74,80,8
"4275","198511240buf","Buffalo Bills",14,"Miami Dolphins",23,37,-9,FALSE,"11/24/1985",1985,"November","1980s",36,69,17
"4276","198511250sfo","San Francisco 49ers",19,"Seattle Seahawks",6,25,13,TRUE,"11/25/1985",1985,"November","1980s",53,94,10
"4277","198511280dal","Dallas Cowboys",35,"St. Louis Cardinals",17,52,18,TRUE,"11/28/1985",1985,"November","1980s",36,80,12
"4278","198511280det","Detroit Lions",31,"New York Jets",20,51,11,TRUE,"11/28/1985",1985,"November","1980s",72,NA,NA
"4279","198512010atl","Atlanta Falcons",24,"Los Angeles Raiders",34,58,-10,FALSE,"12/1/1985",1985,"December","1980s",57,98,13
"4280","198512010phi","Philadelphia Eagles",23,"Minnesota Vikings",28,51,-5,FALSE,"12/1/1985",1985,"December","1980s",44,94,15
"4281","198512010sdg","San Diego Chargers",40,"Buffalo Bills",7,47,33,TRUE,"12/1/1985",1985,"December","1980s",55,73,6
"4282","198512010nyg","New York Giants",33,"Cleveland Browns",35,68,-2,FALSE,"12/1/1985",1985,"December","1980s",43,90,20
"4283","198512010pit","Pittsburgh Steelers",23,"Denver Broncos",31,54,-8,FALSE,"12/1/1985",1985,"December","1980s",52,70,12
"4284","198512010cin","Cincinnati Bengals",45,"Houston Oilers",27,72,18,TRUE,"12/1/1985",1985,"December","1980s",48,93,17
"4285","198512010sea","Seattle Seahawks",24,"Kansas City Chiefs",6,30,18,TRUE,"12/1/1985",1985,"December","1980s",72,NA,NA
"4286","198512010was","Washington Redskins",8,"San Francisco 49ers",35,43,-27,FALSE,"12/1/1985",1985,"December","1980s",46,97,12
"4287","198512010gnb","Green Bay Packers",21,"Tampa Bay Buccaneers",0,21,21,TRUE,"12/1/1985",1985,"December","1980s",28,96,21
"4288","198512010nor","New Orleans Saints",29,"Los Angeles Rams",3,32,26,TRUE,"12/1/1985",1985,"December","1980s",72,NA,NA
"4289","198512010clt","Indianapolis Colts",31,"New England Patriots",38,69,-7,FALSE,"12/1/1985",1985,"December","1980s",72,NA,NA
"4290","198512020mia","Miami Dolphins",38,"Chicago Bears",24,62,14,TRUE,"12/2/1985",1985,"December","1980s",76,75,8
"4291","198512080buf","Buffalo Bills",7,"New York Jets",27,34,-20,FALSE,"12/8/1985",1985,"December","1980s",34,85,15
"4292","198512080oti","Houston Oilers",14,"New York Giants",35,49,-21,FALSE,"12/8/1985",1985,"December","1980s",72,NA,NA
"4293","198512080kan","Kansas City Chiefs",38,"Atlanta Falcons",10,48,28,TRUE,"12/8/1985",1985,"December","1980s",36,81,6
"4294","198512080sdg","San Diego Chargers",54,"Pittsburgh Steelers",44,98,10,TRUE,"12/8/1985",1985,"December","1980s",56,85,7
"4295","198512080chi","Chicago Bears",17,"Indianapolis Colts",10,27,7,TRUE,"12/8/1985",1985,"December","1980s",31,86,8
"4296","198512080phi","Philadelphia Eagles",12,"Washington Redskins",17,29,-5,FALSE,"12/8/1985",1985,"December","1980s",39,67,9
"4297","198512080cin","Cincinnati Bengals",50,"Dallas Cowboys",24,74,26,TRUE,"12/8/1985",1985,"December","1980s",34,82,7
"4298","198512080min","Minnesota Vikings",26,"Tampa Bay Buccaneers",7,33,19,TRUE,"12/8/1985",1985,"December","1980s",72,NA,NA
"4299","198512080crd","St. Louis Cardinals",28,"New Orleans Saints",16,44,12,TRUE,"12/8/1985",1985,"December","1980s",41,67,7
"4300","198512080sea","Seattle Seahawks",31,"Cleveland Browns",13,44,18,TRUE,"12/8/1985",1985,"December","1980s",72,NA,NA
"4301","198512080gnb","Green Bay Packers",24,"Miami Dolphins",34,58,-10,FALSE,"12/8/1985",1985,"December","1980s",18,91,5
"4302","198512080den","Denver Broncos",14,"Los Angeles Raiders",17,31,-3,FALSE,"12/8/1985",1985,"December","1980s",31,63,9
"4303","198512080nwe","New England Patriots",23,"Detroit Lions",6,29,17,TRUE,"12/8/1985",1985,"December","1980s",38,62,14
"4304","198512090sfo","San Francisco 49ers",20,"Los Angeles Rams",27,47,-7,FALSE,"12/9/1985",1985,"December","1980s",48,76,11
"4305","198512140den","Denver Broncos",14,"Kansas City Chiefs",13,27,1,TRUE,"12/14/1985",1985,"December","1980s",27,44,10
"4306","198512140nyj","New York Jets",6,"Chicago Bears",19,25,-13,FALSE,"12/14/1985",1985,"December","1980s",36,65,22
"4307","198512150sdg","San Diego Chargers",20,"Philadelphia Eagles",14,34,6,TRUE,"12/15/1985",1985,"December","1980s",55,51,7
"4308","198512150dal","Dallas Cowboys",28,"New York Giants",21,49,7,TRUE,"12/15/1985",1985,"December","1980s",36,59,11
"4309","198512150rai","Los Angeles Raiders",13,"Seattle Seahawks",3,16,10,TRUE,"12/15/1985",1985,"December","1980s",57,36,7
"4310","198512150atl","Atlanta Falcons",14,"Minnesota Vikings",13,27,1,TRUE,"12/15/1985",1985,"December","1980s",27,47,10
"4311","198512150was","Washington Redskins",27,"Cincinnati Bengals",24,51,3,TRUE,"12/15/1985",1985,"December","1980s",28,46,12
"4312","198512150nor","New Orleans Saints",19,"San Francisco 49ers",31,50,-12,FALSE,"12/15/1985",1985,"December","1980s",72,NA,NA
"4313","198512150det","Detroit Lions",23,"Green Bay Packers",26,49,-3,FALSE,"12/15/1985",1985,"December","1980s",72,NA,NA
"4314","198512150ram","Los Angeles Rams",46,"St. Louis Cardinals",14,60,32,TRUE,"12/15/1985",1985,"December","1980s",57,36,7
"4315","198512150cle","Cleveland Browns",28,"Houston Oilers",21,49,7,TRUE,"12/15/1985",1985,"December","1980s",16,72,20
"4316","198512150tam","Tampa Bay Buccaneers",23,"Indianapolis Colts",31,54,-8,FALSE,"12/15/1985",1985,"December","1980s",46,60,10
"4317","198512150pit","Pittsburgh Steelers",30,"Buffalo Bills",24,54,6,TRUE,"12/15/1985",1985,"December","1980s",17,64,14
"4318","198512160mia","Miami Dolphins",30,"New England Patriots",27,57,3,TRUE,"12/16/1985",1985,"December","1980s",65,75,8
"4319","198512200sea","Seattle Seahawks",24,"Denver Broncos",27,51,-3,FALSE,"12/20/1985",1985,"December","1980s",72,NA,NA
"4320","198512210crd","St. Louis Cardinals",16,"Washington Redskins",27,43,-11,FALSE,"12/21/1985",1985,"December","1980s",12,80,7
"4321","198512210nyg","New York Giants",28,"Pittsburgh Steelers",10,38,18,TRUE,"12/21/1985",1985,"December","1980s",27,71,15
"4322","198512220nor","New Orleans Saints",10,"Atlanta Falcons",16,26,-6,FALSE,"12/22/1985",1985,"December","1980s",72,NA,NA
"4323","198512220nwe","New England Patriots",34,"Cincinnati Bengals",23,57,11,TRUE,"12/22/1985",1985,"December","1980s",24,60,12
"4324","198512220nyj","New York Jets",37,"Cleveland Browns",10,47,27,TRUE,"12/22/1985",1985,"December","1980s",24,52,14
"4325","198512220tam","Tampa Bay Buccaneers",17,"Green Bay Packers",20,37,-3,FALSE,"12/22/1985",1985,"December","1980s",46,60,8
"4326","198512220min","Minnesota Vikings",35,"Philadelphia Eagles",37,72,-2,FALSE,"12/22/1985",1985,"December","1980s",72,NA,NA
"4327","198512220clt","Indianapolis Colts",34,"Houston Oilers",16,50,18,TRUE,"12/22/1985",1985,"December","1980s",72,NA,NA
"4328","198512220mia","Miami Dolphins",28,"Buffalo Bills",0,28,28,TRUE,"12/22/1985",1985,"December","1980s",54,52,12
"4329","198512220kan","Kansas City Chiefs",38,"San Diego Chargers",34,72,4,TRUE,"12/22/1985",1985,"December","1980s",35,77,17
"4330","198512220sfo","San Francisco 49ers",31,"Dallas Cowboys",16,47,15,TRUE,"12/22/1985",1985,"December","1980s",45,87,7
"4331","198512220det","Detroit Lions",17,"Chicago Bears",37,54,-20,FALSE,"12/22/1985",1985,"December","1980s",72,NA,NA
"4332","198512230ram","Los Angeles Rams",6,"Los Angeles Raiders",16,22,-10,FALSE,"12/23/1985",1985,"December","1980s",59,55,5
"4333","198512280nyj","New York Jets",14,"New England Patriots",26,40,-12,FALSE,"12/28/1985",1985,"December","1980s",36,46,20
"4334","198512290nyg","New York Giants",17,"San Francisco 49ers",3,20,14,TRUE,"12/29/1985",1985,"December","1980s",32,35,16
"4335","198601040ram","Los Angeles Rams",20,"Dallas Cowboys",0,20,20,TRUE,"1/4/1986",1986,"January","1980s",60,84,6
"4336","198601040mia","Miami Dolphins",24,"Cleveland Browns",21,45,3,TRUE,"1/4/1986",1986,"January","1980s",70,79,9
"4337","198601050chi","Chicago Bears",21,"New York Giants",0,21,21,TRUE,"1/5/1986",1986,"January","1980s",18,74,16
"4338","198601050rai","Los Angeles Raiders",20,"New England Patriots",27,47,-7,FALSE,"1/5/1986",1986,"January","1980s",61,89,8
"4339","198601120mia","Miami Dolphins",14,"New England Patriots",31,45,-17,FALSE,"1/12/1986",1986,"January","1980s",61,80,12
"4340","198601120chi","Chicago Bears",24,"Los Angeles Rams",0,24,24,TRUE,"1/12/1986",1986,"January","1980s",36,67,19
"4341","198601260chi","Chicago Bears",46,"New England Patriots",10,56,36,TRUE,"1/26/1986",1986,"January","1980s",72,NA,NA
"4342","198609070nor","New Orleans Saints",10,"Atlanta Falcons",31,41,-21,FALSE,"9/7/1986",1986,"September","1980s",72,NA,NA
"4343","198609070buf","Buffalo Bills",24,"New York Jets",28,52,-4,FALSE,"9/7/1986",1986,"September","1980s",56,61,12
"4344","198609070min","Minnesota Vikings",10,"Detroit Lions",13,23,-3,FALSE,"9/7/1986",1986,"September","1980s",72,NA,NA
"4345","198609070nwe","New England Patriots",33,"Indianapolis Colts",3,36,30,TRUE,"9/7/1986",1986,"September","1980s",65,54,13
"4346","198609070kan","Kansas City Chiefs",24,"Cincinnati Bengals",14,38,10,TRUE,"9/7/1986",1986,"September","1980s",56,75,11
"4347","198609070sdg","San Diego Chargers",50,"Miami Dolphins",28,78,22,TRUE,"9/7/1986",1986,"September","1980s",68,82,9
"4348","198609070tam","Tampa Bay Buccaneers",7,"San Francisco 49ers",31,38,-24,FALSE,"9/7/1986",1986,"September","1980s",82,81,5
"4349","198609070was","Washington Redskins",41,"Philadelphia Eagles",14,55,27,TRUE,"9/7/1986",1986,"September","1980s",69,62,9
"4350","198609070crd","St. Louis Cardinals",10,"Los Angeles Rams",16,26,-6,FALSE,"9/7/1986",1986,"September","1980s",60,72,6
"4351","198609070gnb","Green Bay Packers",3,"Houston Oilers",31,34,-28,FALSE,"9/7/1986",1986,"September","1980s",48,64,7
"4352","198609070den","Denver Broncos",38,"Los Angeles Raiders",36,74,2,TRUE,"9/7/1986",1986,"September","1980s",49,81,9
"4353","198609070sea","Seattle Seahawks",30,"Pittsburgh Steelers",0,30,30,TRUE,"9/7/1986",1986,"September","1980s",72,NA,NA
"4354","198609070chi","Chicago Bears",41,"Cleveland Browns",31,72,10,TRUE,"9/7/1986",1986,"September","1980s",55,56,9
"4355","198609080dal","Dallas Cowboys",31,"New York Giants",28,59,3,TRUE,"9/8/1986",1986,"September","1980s",71,71,11
"4356","198609110nyj","New York Jets",6,"New England Patriots",20,26,-14,FALSE,"9/11/1986",1986,"September","1980s",74,73,19
"4357","198609140det","Detroit Lions",7,"Dallas Cowboys",31,38,-24,FALSE,"9/14/1986",1986,"September","1980s",72,NA,NA
"4358","198609140chi","Chicago Bears",13,"Philadelphia Eagles",10,23,3,TRUE,"9/14/1986",1986,"September","1980s",61,70,12
"4359","198609140was","Washington Redskins",10,"Los Angeles Raiders",6,16,4,TRUE,"9/14/1986",1986,"September","1980s",69,57,8
"4360","198609140tam","Tampa Bay Buccaneers",10,"Minnesota Vikings",23,33,-13,FALSE,"9/14/1986",1986,"September","1980s",82,78,6
"4361","198609140nor","New Orleans Saints",24,"Green Bay Packers",10,34,14,TRUE,"9/14/1986",1986,"September","1980s",72,NA,NA
"4362","198609140sea","Seattle Seahawks",23,"Kansas City Chiefs",17,40,6,TRUE,"9/14/1986",1986,"September","1980s",72,NA,NA
"4363","198609140oti","Houston Oilers",20,"Cleveland Browns",23,43,-3,FALSE,"9/14/1986",1986,"September","1980s",72,NA,NA
"4364","198609140nyg","New York Giants",20,"San Diego Chargers",7,27,13,TRUE,"9/14/1986",1986,"September","1980s",65,52,17
"4365","198609140mia","Miami Dolphins",30,"Indianapolis Colts",10,40,20,TRUE,"9/14/1986",1986,"September","1980s",83,66,11
"4366","198609140atl","Atlanta Falcons",33,"St. Louis Cardinals",13,46,20,TRUE,"9/14/1986",1986,"September","1980s",72,69,10
"4367","198609140ram","Los Angeles Rams",16,"San Francisco 49ers",13,29,3,TRUE,"9/14/1986",1986,"September","1980s",66,66,10
"4368","198609140cin","Cincinnati Bengals",36,"Buffalo Bills",33,69,3,TRUE,"9/14/1986",1986,"September","1980s",65,62,4
"4369","198609150pit","Pittsburgh Steelers",10,"Denver Broncos",21,31,-11,FALSE,"9/15/1986",1986,"September","1980s",64,55,7
"4370","198609180cle","Cleveland Browns",13,"Cincinnati Bengals",30,43,-17,FALSE,"9/18/1986",1986,"September","1980s",62,71,11
"4371","198609210phi","Philadelphia Eagles",7,"Denver Broncos",33,40,-26,FALSE,"9/21/1986",1986,"September","1980s",71,78,9
"4372","198609210nwe","New England Patriots",31,"Seattle Seahawks",38,69,-7,FALSE,"9/21/1986",1986,"September","1980s",56,94,13
"4373","198609210clt","Indianapolis Colts",7,"Los Angeles Rams",24,31,-17,FALSE,"9/21/1986",1986,"September","1980s",72,NA,NA
"4374","198609210rai","Los Angeles Raiders",9,"New York Giants",14,23,-5,FALSE,"9/21/1986",1986,"September","1980s",63,76,11
"4375","198609210sfo","San Francisco 49ers",26,"New Orleans Saints",17,43,9,TRUE,"9/21/1986",1986,"September","1980s",60,76,14
"4376","198609210min","Minnesota Vikings",31,"Pittsburgh Steelers",7,38,24,TRUE,"9/21/1986",1986,"September","1980s",72,NA,NA
"4377","198609210buf","Buffalo Bills",17,"St. Louis Cardinals",10,27,7,TRUE,"9/21/1986",1986,"September","1980s",57,89,8
"4378","198609210kan","Kansas City Chiefs",27,"Houston Oilers",13,40,14,TRUE,"9/21/1986",1986,"September","1980s",79,73,15
"4379","198609210nyj","New York Jets",51,"Miami Dolphins",45,96,6,TRUE,"9/21/1986",1986,"September","1980s",69,78,11
"4380","198609210sdg","San Diego Chargers",27,"Washington Redskins",30,57,-3,FALSE,"9/21/1986",1986,"September","1980s",64,72,8
"4381","198609210det","Detroit Lions",20,"Tampa Bay Buccaneers",24,44,-4,FALSE,"9/21/1986",1986,"September","1980s",72,NA,NA
"4382","198609210dal","Dallas Cowboys",35,"Atlanta Falcons",37,72,-2,FALSE,"9/21/1986",1986,"September","1980s",80,71,13
"4383","198609220gnb","Green Bay Packers",12,"Chicago Bears",25,37,-13,FALSE,"9/22/1986",1986,"September","1980s",65,93,14
"4384","198609280was","Washington Redskins",19,"Seattle Seahawks",14,33,5,TRUE,"9/28/1986",1986,"September","1980s",66,90,10
"4385","198609280buf","Buffalo Bills",17,"Kansas City Chiefs",20,37,-3,FALSE,"9/28/1986",1986,"September","1980s",64,87,8
"4386","198609280den","Denver Broncos",27,"New England Patriots",20,47,7,TRUE,"9/28/1986",1986,"September","1980s",55,41,8
"4387","198609280nyg","New York Giants",20,"New Orleans Saints",17,37,3,TRUE,"9/28/1986",1986,"September","1980s",62,67,9
"4388","198609280cle","Cleveland Browns",24,"Detroit Lions",21,45,3,TRUE,"9/28/1986",1986,"September","1980s",72,85,10
"4389","198609280cin","Cincinnati Bengals",7,"Chicago Bears",44,51,-37,FALSE,"9/28/1986",1986,"September","1980s",75,80,6
"4390","198609280mia","Miami Dolphins",16,"San Francisco 49ers",31,47,-15,FALSE,"9/28/1986",1986,"September","1980s",83,71,10
"4391","198609280clt","Indianapolis Colts",7,"New York Jets",26,33,-19,FALSE,"9/28/1986",1986,"September","1980s",72,NA,NA
"4392","198609280rai","Los Angeles Raiders",17,"San Diego Chargers",13,30,4,TRUE,"9/28/1986",1986,"September","1980s",62,75,9
"4393","198609280phi","Philadelphia Eagles",34,"Los Angeles Rams",20,54,14,TRUE,"9/28/1986",1986,"September","1980s",63,78,18
"4394","198609280min","Minnesota Vikings",42,"Green Bay Packers",7,49,35,TRUE,"9/28/1986",1986,"September","1980s",72,NA,NA
"4395","198609280tam","Tampa Bay Buccaneers",20,"Atlanta Falcons",23,43,-3,FALSE,"9/28/1986",1986,"September","1980s",83,68,6
"4396","198609280oti","Houston Oilers",16,"Pittsburgh Steelers",22,38,-6,FALSE,"9/28/1986",1986,"September","1980s",72,NA,NA
"4397","198609290crd","St. Louis Cardinals",7,"Dallas Cowboys",31,38,-24,FALSE,"9/29/1986",1986,"September","1980s",79,74,12
"4398","198610050pit","Pittsburgh Steelers",24,"Cleveland Browns",27,51,-3,FALSE,"10/5/1986",1986,"October","1980s",61,67,17
"4399","198610050atl","Atlanta Falcons",0,"Philadelphia Eagles",16,16,-16,FALSE,"10/5/1986",1986,"October","1980s",77,71,10
"4400","198610050nor","New Orleans Saints",6,"Washington Redskins",14,20,-8,FALSE,"10/5/1986",1986,"October","1980s",72,NA,NA
"4401","198610050sfo","San Francisco 49ers",35,"Indianapolis Colts",14,49,21,TRUE,"10/5/1986",1986,"October","1980s",67,48,11
"4402","198610050nwe","New England Patriots",34,"Miami Dolphins",7,41,27,TRUE,"10/5/1986",1986,"October","1980s",58,74,14
"4403","198610050crd","St. Louis Cardinals",6,"New York Giants",13,19,-7,FALSE,"10/5/1986",1986,"October","1980s",60,70,11
"4404","198610050chi","Chicago Bears",23,"Minnesota Vikings",0,23,23,TRUE,"10/5/1986",1986,"October","1980s",52,76,10
"4405","198610050den","Denver Broncos",29,"Dallas Cowboys",14,43,15,TRUE,"10/5/1986",1986,"October","1980s",49,55,8
"4406","198610050kan","Kansas City Chiefs",17,"Los Angeles Raiders",24,41,-7,FALSE,"10/5/1986",1986,"October","1980s",57,76,8
"4407","198610050nyj","New York Jets",14,"Buffalo Bills",13,27,1,TRUE,"10/5/1986",1986,"October","1980s",68,66,18
"4408","198610050det","Detroit Lions",24,"Houston Oilers",13,37,11,TRUE,"10/5/1986",1986,"October","1980s",72,NA,NA
"4409","198610050gnb","Green Bay Packers",28,"Cincinnati Bengals",34,62,-6,FALSE,"10/5/1986",1986,"October","1980s",50,76,15
"4410","198610050ram","Los Angeles Rams",26,"Tampa Bay Buccaneers",20,46,6,TRUE,"10/5/1986",1986,"October","1980s",75,30,9
"4411","198610060sea","Seattle Seahawks",33,"San Diego Chargers",7,40,26,TRUE,"10/6/1986",1986,"October","1980s",72,NA,NA
"4412","198610120clt","Indianapolis Colts",14,"New Orleans Saints",17,31,-3,FALSE,"10/12/1986",1986,"October","1980s",72,NA,NA
"4413","198610120tam","Tampa Bay Buccaneers",19,"St. Louis Cardinals",30,49,-11,FALSE,"10/12/1986",1986,"October","1980s",80,79,4
"4414","198610120gnb","Green Bay Packers",14,"Detroit Lions",21,35,-7,FALSE,"10/12/1986",1986,"October","1980s",55,93,13
"4415","198610120dal","Dallas Cowboys",30,"Washington Redskins",6,36,24,TRUE,"10/12/1986",1986,"October","1980s",54,74,19
"4416","198610120sdg","San Diego Chargers",14,"Denver Broncos",31,45,-17,FALSE,"10/12/1986",1986,"October","1980s",66,74,10
"4417","198610120sfo","San Francisco 49ers",24,"Minnesota Vikings",27,51,-3,FALSE,"10/12/1986",1986,"October","1980s",57,77,12
"4418","198610120cle","Cleveland Browns",20,"Kansas City Chiefs",7,27,13,TRUE,"10/12/1986",1986,"October","1980s",60,66,17
"4419","198610120nyg","New York Giants",35,"Philadelphia Eagles",3,38,32,TRUE,"10/12/1986",1986,"October","1980s",55,78,12
"4420","198610120rai","Los Angeles Raiders",14,"Seattle Seahawks",10,24,4,TRUE,"10/12/1986",1986,"October","1980s",66,71,10
"4421","198610120oti","Houston Oilers",7,"Chicago Bears",20,27,-13,FALSE,"10/12/1986",1986,"October","1980s",72,NA,NA
"4422","198610120mia","Miami Dolphins",27,"Buffalo Bills",14,41,13,TRUE,"10/12/1986",1986,"October","1980s",83,72,10
"4423","198610120nwe","New England Patriots",24,"New York Jets",31,55,-7,FALSE,"10/12/1986",1986,"October","1980s",50,80,9
"4424","198610120atl","Atlanta Falcons",26,"Los Angeles Rams",14,40,12,TRUE,"10/12/1986",1986,"October","1980s",56,99,14
"4425","198610130cin","Cincinnati Bengals",24,"Pittsburgh Steelers",22,46,2,TRUE,"10/13/1986",1986,"October","1980s",59,92,10
"4426","198610190mia","Miami Dolphins",28,"Los Angeles Raiders",30,58,-2,FALSE,"10/19/1986",1986,"October","1980s",74,79,15
"4427","198610190min","Minnesota Vikings",23,"Chicago Bears",7,30,16,TRUE,"10/19/1986",1986,"October","1980s",72,NA,NA
"4428","198610190cin","Cincinnati Bengals",31,"Houston Oilers",28,59,3,TRUE,"10/19/1986",1986,"October","1980s",47,66,7
"4429","198610190sea","Seattle Seahawks",17,"New York Giants",12,29,5,TRUE,"10/19/1986",1986,"October","1980s",72,NA,NA
"4430","198610190ram","Los Angeles Rams",14,"Detroit Lions",10,24,4,TRUE,"10/19/1986",1986,"October","1980s",63,61,9
"4431","198610190was","Washington Redskins",28,"St. Louis Cardinals",21,49,7,TRUE,"10/19/1986",1986,"October","1980s",51,52,10
"4432","198610190kan","Kansas City Chiefs",42,"San Diego Chargers",41,83,1,TRUE,"10/19/1986",1986,"October","1980s",60,74,7
"4433","198610190pit","Pittsburgh Steelers",0,"New England Patriots",34,34,-34,FALSE,"10/19/1986",1986,"October","1980s",43,58,4
"4434","198610190atl","Atlanta Falcons",10,"San Francisco 49ers",10,20,0,FALSE,"10/19/1986",1986,"October","1980s",56,60,11
"4435","198610190buf","Buffalo Bills",24,"Indianapolis Colts",13,37,11,TRUE,"10/19/1986",1986,"October","1980s",42,73,9
"4436","198610190nor","New Orleans Saints",38,"Tampa Bay Buccaneers",7,45,31,TRUE,"10/19/1986",1986,"October","1980s",72,NA,NA
"4437","198610190phi","Philadelphia Eagles",14,"Dallas Cowboys",17,31,-3,FALSE,"10/19/1986",1986,"October","1980s",49,55,8
"4438","198610190cle","Cleveland Browns",14,"Green Bay Packers",17,31,-3,FALSE,"10/19/1986",1986,"October","1980s",43,76,6
"4439","198610200nyj","New York Jets",22,"Denver Broncos",10,32,12,TRUE,"10/20/1986",1986,"October","1980s",56,51,10
"4440","198610260den","Denver Broncos",20,"Seattle Seahawks",13,33,7,TRUE,"10/26/1986",1986,"October","1980s",50,44,9
"4441","198610260kan","Kansas City Chiefs",27,"Tampa Bay Buccaneers",20,47,7,TRUE,"10/26/1986",1986,"October","1980s",51,87,14
"4442","198610260gnb","Green Bay Packers",17,"San Francisco 49ers",31,48,-14,FALSE,"10/26/1986",1986,"October","1980s",52,96,15
"4443","198610260chi","Chicago Bears",13,"Detroit Lions",7,20,6,TRUE,"10/26/1986",1986,"October","1980s",55,90,12
"4444","198610260ram","Los Angeles Rams",14,"Atlanta Falcons",7,21,7,TRUE,"10/26/1986",1986,"October","1980s",68,63,7
"4445","198610260buf","Buffalo Bills",3,"New England Patriots",23,26,-20,FALSE,"10/26/1986",1986,"October","1980s",51,86,7
"4446","198610260phi","Philadelphia Eagles",23,"San Diego Chargers",7,30,16,TRUE,"10/26/1986",1986,"October","1980s",56,92,9
"4447","198610260oti","Houston Oilers",17,"Los Angeles Raiders",28,45,-11,FALSE,"10/26/1986",1986,"October","1980s",72,NA,NA
"4448","198610260nyj","New York Jets",28,"New Orleans Saints",23,51,5,TRUE,"10/26/1986",1986,"October","1980s",53,82,11
"4449","198610260dal","Dallas Cowboys",37,"St. Louis Cardinals",6,43,31,TRUE,"10/26/1986",1986,"October","1980s",60,66,10
"4450","198610260clt","Indianapolis Colts",13,"Miami Dolphins",17,30,-4,FALSE,"10/26/1986",1986,"October","1980s",72,NA,NA
"4451","198610260pit","Pittsburgh Steelers",30,"Cincinnati Bengals",9,39,21,TRUE,"10/26/1986",1986,"October","1980s",55,81,8
"4452","198610260min","Minnesota Vikings",20,"Cleveland Browns",23,43,-3,FALSE,"10/26/1986",1986,"October","1980s",72,NA,NA
"4453","198610270nyg","New York Giants",27,"Washington Redskins",20,47,7,TRUE,"10/27/1986",1986,"October","1980s",52,97,14
"4454","198611020det","Detroit Lions",17,"Cincinnati Bengals",24,41,-7,FALSE,"11/2/1986",1986,"November","1980s",72,NA,NA
"4455","198611020sdg","San Diego Chargers",23,"Kansas City Chiefs",24,47,-1,FALSE,"11/2/1986",1986,"November","1980s",65,59,9
"4456","198611020tam","Tampa Bay Buccaneers",34,"Buffalo Bills",28,62,6,TRUE,"11/2/1986",1986,"November","1980s",73,89,8
"4457","198611020rai","Los Angeles Raiders",10,"Denver Broncos",21,31,-11,FALSE,"11/2/1986",1986,"November","1980s",72,20,12
"4458","198611020nor","New Orleans Saints",23,"San Francisco 49ers",10,33,13,TRUE,"11/2/1986",1986,"November","1980s",72,NA,NA
"4459","198611020nwe","New England Patriots",25,"Atlanta Falcons",17,42,8,TRUE,"11/2/1986",1986,"November","1980s",56,80,18
"4460","198611020crd","St. Louis Cardinals",13,"Philadelphia Eagles",10,23,3,TRUE,"11/2/1986",1986,"November","1980s",46,79,11
"4461","198611020pit","Pittsburgh Steelers",27,"Green Bay Packers",3,30,24,TRUE,"11/2/1986",1986,"November","1980s",52,70,9
"4462","198611020nyg","New York Giants",17,"Dallas Cowboys",14,31,3,TRUE,"11/2/1986",1986,"November","1980s",59,83,14
"4463","198611020mia","Miami Dolphins",28,"Houston Oilers",7,35,21,TRUE,"11/2/1986",1986,"November","1980s",80,75,9
"4464","198611020clt","Indianapolis Colts",9,"Cleveland Browns",24,33,-15,FALSE,"11/2/1986",1986,"November","1980s",72,NA,NA
"4465","198611020was","Washington Redskins",44,"Minnesota Vikings",38,82,6,TRUE,"11/2/1986",1986,"November","1980s",58,88,10
"4466","198611020sea","Seattle Seahawks",7,"New York Jets",38,45,-31,FALSE,"11/2/1986",1986,"November","1980s",72,NA,NA
"4467","198611030chi","Chicago Bears",17,"Los Angeles Rams",20,37,-3,FALSE,"11/3/1986",1986,"November","1980s",36,72,11
"4468","198611090tam","Tampa Bay Buccaneers",3,"Chicago Bears",23,26,-20,FALSE,"11/9/1986",1986,"November","1980s",77,79,8
"4469","198611090det","Detroit Lions",10,"Minnesota Vikings",24,34,-14,FALSE,"11/9/1986",1986,"November","1980s",72,NA,NA
"4470","198611090atl","Atlanta Falcons",14,"New York Jets",28,42,-14,FALSE,"11/9/1986",1986,"November","1980s",70,83,11
"4471","198611090nor","New Orleans Saints",6,"Los Angeles Rams",0,6,6,TRUE,"11/9/1986",1986,"November","1980s",72,NA,NA
"4472","198611090phi","Philadelphia Eagles",14,"New York Giants",17,31,-3,FALSE,"11/9/1986",1986,"November","1980s",64,93,12
"4473","198611090clt","Indianapolis Colts",21,"New England Patriots",30,51,-9,FALSE,"11/9/1986",1986,"November","1980s",72,NA,NA
"4474","198611090dal","Dallas Cowboys",13,"Los Angeles Raiders",17,30,-4,FALSE,"11/9/1986",1986,"November","1980s",56,68,13
"4475","198611090kan","Kansas City Chiefs",27,"Seattle Seahawks",7,34,20,TRUE,"11/9/1986",1986,"November","1980s",39,56,8
"4476","198611090buf","Buffalo Bills",16,"Pittsburgh Steelers",12,28,4,TRUE,"11/9/1986",1986,"November","1980s",55,72,27
"4477","198611090den","Denver Broncos",3,"San Diego Chargers",9,12,-6,FALSE,"11/9/1986",1986,"November","1980s",31,48,8
"4478","198611090gnb","Green Bay Packers",7,"Washington Redskins",16,23,-9,FALSE,"11/9/1986",1986,"November","1980s",30,51,24
"4479","198611090sfo","San Francisco 49ers",43,"St. Louis Cardinals",17,60,26,TRUE,"11/9/1986",1986,"November","1980s",54,76,12
"4480","198611090oti","Houston Oilers",32,"Cincinnati Bengals",28,60,4,TRUE,"11/9/1986",1986,"November","1980s",72,NA,NA
"4481","198611100cle","Cleveland Browns",26,"Miami Dolphins",16,42,10,TRUE,"11/10/1986",1986,"November","1980s",38,57,11
"4482","198611160pit","Pittsburgh Steelers",21,"Houston Oilers",10,31,11,TRUE,"11/16/1986",1986,"November","1980s",39,77,8
"4483","198611160gnb","Green Bay Packers",31,"Tampa Bay Buccaneers",7,38,24,TRUE,"11/16/1986",1986,"November","1980s",36,66,11
"4484","198611160ram","Los Angeles Rams",28,"New England Patriots",30,58,-2,FALSE,"11/16/1986",1986,"November","1980s",66,65,6
"4485","198611160den","Denver Broncos",38,"Kansas City Chiefs",17,55,21,TRUE,"11/16/1986",1986,"November","1980s",50,29,11
"4486","198611160rai","Los Angeles Raiders",27,"Cleveland Browns",14,41,13,TRUE,"11/16/1986",1986,"November","1980s",66,65,6
"4487","198611160sdg","San Diego Chargers",21,"Dallas Cowboys",24,45,-3,FALSE,"11/16/1986",1986,"November","1980s",65,65,7
"4488","198611160phi","Philadelphia Eagles",11,"Detroit Lions",13,24,-2,FALSE,"11/16/1986",1986,"November","1980s",45,65,7
"4489","198611160buf","Buffalo Bills",24,"Miami Dolphins",34,58,-10,FALSE,"11/16/1986",1986,"November","1980s",36,84,10
"4490","198611160min","Minnesota Vikings",20,"New York Giants",22,42,-2,FALSE,"11/16/1986",1986,"November","1980s",72,NA,NA
"4491","198611160nyj","New York Jets",31,"Indianapolis Colts",16,47,15,TRUE,"11/16/1986",1986,"November","1980s",46,59,8
"4492","198611160atl","Atlanta Falcons",10,"Chicago Bears",13,23,-3,FALSE,"11/16/1986",1986,"November","1980s",55,86,9
"4493","198611160crd","St. Louis Cardinals",7,"New Orleans Saints",16,23,-9,FALSE,"11/16/1986",1986,"November","1980s",41,74,7
"4494","198611160cin","Cincinnati Bengals",34,"Seattle Seahawks",7,41,27,TRUE,"11/16/1986",1986,"November","1980s",41,85,10
"4495","198611170was","Washington Redskins",14,"San Francisco 49ers",6,20,8,TRUE,"11/17/1986",1986,"November","1980s",48,65,8
"4496","198611200sdg","San Diego Chargers",31,"Los Angeles Raiders",37,68,-6,FALSE,"11/20/1986",1986,"November","1980s",60,88,8
"4497","198611230oti","Houston Oilers",31,"Indianapolis Colts",17,48,14,TRUE,"11/23/1986",1986,"November","1980s",72,NA,NA
"4498","198611230cin","Cincinnati Bengals",24,"Minnesota Vikings",20,44,4,TRUE,"11/23/1986",1986,"November","1980s",46,81,11
"4499","198611230cle","Cleveland Browns",37,"Pittsburgh Steelers",31,68,6,TRUE,"11/23/1986",1986,"November","1980s",40,79,13
"4500","198611230ram","Los Angeles Rams",26,"New Orleans Saints",13,39,13,TRUE,"11/23/1986",1986,"November","1980s",67,30,14
"4501","198611230crd","St. Louis Cardinals",23,"Kansas City Chiefs",14,37,9,TRUE,"11/23/1986",1986,"November","1980s",46,73,14
"4502","198611230was","Washington Redskins",41,"Dallas Cowboys",14,55,27,TRUE,"11/23/1986",1986,"November","1980s",42,79,7
"4503","198611230sea","Seattle Seahawks",24,"Philadelphia Eagles",20,44,4,TRUE,"11/23/1986",1986,"November","1980s",72,NA,NA
"4504","198611230tam","Tampa Bay Buccaneers",17,"Detroit Lions",38,55,-21,FALSE,"11/23/1986",1986,"November","1980s",72,72,8
"4505","198611230nwe","New England Patriots",22,"Buffalo Bills",19,41,3,TRUE,"11/23/1986",1986,"November","1980s",37,65,12
"4506","198611230nyg","New York Giants",19,"Denver Broncos",16,35,3,TRUE,"11/23/1986",1986,"November","1980s",43,70,10
"4507","198611230sfo","San Francisco 49ers",20,"Atlanta Falcons",0,20,20,TRUE,"11/23/1986",1986,"November","1980s",55,80,13
"4508","198611230chi","Chicago Bears",12,"Green Bay Packers",10,22,2,TRUE,"11/23/1986",1986,"November","1980s",41,72,13
"4509","198611240mia","Miami Dolphins",45,"New York Jets",3,48,42,TRUE,"11/24/1986",1986,"November","1980s",81,73,16
"4510","198611270dal","Dallas Cowboys",14,"Seattle Seahawks",31,45,-17,FALSE,"11/27/1986",1986,"November","1980s",43,75,10
"4511","198611270det","Detroit Lions",40,"Green Bay Packers",44,84,-4,FALSE,"11/27/1986",1986,"November","1980s",72,NA,NA
"4512","198611300cle","Cleveland Browns",13,"Houston Oilers",10,23,3,TRUE,"11/30/1986",1986,"November","1980s",38,77,12
"4513","198611300chi","Chicago Bears",13,"Pittsburgh Steelers",10,23,3,TRUE,"11/30/1986",1986,"November","1980s",40,78,18
"4514","198611300clt","Indianapolis Colts",3,"San Diego Chargers",17,20,-14,FALSE,"11/30/1986",1986,"November","1980s",72,NA,NA
"4515","198611300min","Minnesota Vikings",45,"Tampa Bay Buccaneers",13,58,32,TRUE,"11/30/1986",1986,"November","1980s",72,NA,NA
"4516","198611300crd","St. Louis Cardinals",17,"Washington Redskins",20,37,-3,FALSE,"11/30/1986",1986,"November","1980s",36,96,10
"4517","198611300mia","Miami Dolphins",14,"Atlanta Falcons",20,34,-6,FALSE,"11/30/1986",1986,"November","1980s",78,85,11
"4518","198611300nor","New Orleans Saints",20,"New England Patriots",21,41,-1,FALSE,"11/30/1986",1986,"November","1980s",72,NA,NA
"4519","198611300nyj","New York Jets",3,"Los Angeles Rams",17,20,-14,FALSE,"11/30/1986",1986,"November","1980s",43,53,15
"4520","198611300kan","Kansas City Chiefs",14,"Buffalo Bills",17,31,-3,FALSE,"11/30/1986",1986,"November","1980s",42,77,14
"4521","198611300rai","Los Angeles Raiders",27,"Philadelphia Eagles",33,60,-6,FALSE,"11/30/1986",1986,"November","1980s",61,54,5
"4522","198611300den","Denver Broncos",34,"Cincinnati Bengals",28,62,6,TRUE,"11/30/1986",1986,"November","1980s",34,72,15
"4523","198612010sfo","San Francisco 49ers",17,"New York Giants",21,38,-4,FALSE,"12/1/1986",1986,"December","1980s",51,69,8
"4524","198612070nwe","New England Patriots",7,"Cincinnati Bengals",31,38,-24,FALSE,"12/7/1986",1986,"December","1980s",37,51,14
"4525","198612070buf","Buffalo Bills",17,"Cleveland Browns",21,38,-4,FALSE,"12/7/1986",1986,"December","1980s",33,90,16
"4526","198612070pit","Pittsburgh Steelers",27,"Detroit Lions",17,44,10,TRUE,"12/7/1986",1986,"December","1980s",40,48,9
"4527","198612070was","Washington Redskins",14,"New York Giants",24,38,-10,FALSE,"12/7/1986",1986,"December","1980s",38,69,8
"4528","198612070sdg","San Diego Chargers",27,"Houston Oilers",0,27,27,TRUE,"12/7/1986",1986,"December","1980s",58,81,8
"4529","198612070ram","Los Angeles Rams",29,"Dallas Cowboys",10,39,19,TRUE,"12/7/1986",1986,"December","1980s",57,71,8
"4530","198612070atl","Atlanta Falcons",23,"Indianapolis Colts",28,51,-5,FALSE,"12/7/1986",1986,"December","1980s",42,52,8
"4531","198612070sfo","San Francisco 49ers",24,"New York Jets",10,34,14,TRUE,"12/7/1986",1986,"December","1980s",53,72,10
"4532","198612070chi","Chicago Bears",48,"Tampa Bay Buccaneers",14,62,34,TRUE,"12/7/1986",1986,"December","1980s",36,92,8
"4533","198612070phi","Philadelphia Eagles",10,"St. Louis Cardinals",10,20,0,FALSE,"12/7/1986",1986,"December","1980s",37,72,8
"4534","198612070kan","Kansas City Chiefs",37,"Denver Broncos",10,47,27,TRUE,"12/7/1986",1986,"December","1980s",44,81,10
"4535","198612070gnb","Green Bay Packers",6,"Minnesota Vikings",32,38,-26,FALSE,"12/7/1986",1986,"December","1980s",28,83,6
"4536","198612070nor","New Orleans Saints",27,"Miami Dolphins",31,58,-4,FALSE,"12/7/1986",1986,"December","1980s",72,NA,NA
"4537","198612080sea","Seattle Seahawks",37,"Los Angeles Raiders",0,37,37,TRUE,"12/8/1986",1986,"December","1980s",72,NA,NA
"4538","198612130nyj","New York Jets",24,"Pittsburgh Steelers",45,69,-21,FALSE,"12/13/1986",1986,"December","1980s",32,51,22
"4539","198612130den","Denver Broncos",31,"Washington Redskins",30,61,1,TRUE,"12/13/1986",1986,"December","1980s",29,58,6
"4540","198612140atl","Atlanta Falcons",9,"New Orleans Saints",14,23,-5,FALSE,"12/14/1986",1986,"December","1980s",36,54,12
"4541","198612140sdg","San Diego Chargers",24,"Seattle Seahawks",34,58,-10,FALSE,"12/14/1986",1986,"December","1980s",57,71,6
"4542","198612140nyg","New York Giants",27,"St. Louis Cardinals",7,34,20,TRUE,"12/14/1986",1986,"December","1980s",26,46,14
"4543","198612140tam","Tampa Bay Buccaneers",7,"Green Bay Packers",21,28,-14,FALSE,"12/14/1986",1986,"December","1980s",62,72,11
"4544","198612140oti","Houston Oilers",23,"Minnesota Vikings",10,33,13,TRUE,"12/14/1986",1986,"December","1980s",72,NA,NA
"4545","198612140dal","Dallas Cowboys",21,"Philadelphia Eagles",23,44,-2,FALSE,"12/14/1986",1986,"December","1980s",44,82,8
"4546","198612140ram","Los Angeles Rams",31,"Miami Dolphins",37,68,-6,FALSE,"12/14/1986",1986,"December","1980s",56,66,6
"4547","198612140clt","Indianapolis Colts",24,"Buffalo Bills",14,38,10,TRUE,"12/14/1986",1986,"December","1980s",72,NA,NA
"4548","198612140nwe","New England Patriots",24,"San Francisco 49ers",29,53,-5,FALSE,"12/14/1986",1986,"December","1980s",23,44,16
"4549","198612140cin","Cincinnati Bengals",3,"Cleveland Browns",34,37,-31,FALSE,"12/14/1986",1986,"December","1980s",27,53,12
"4550","198612140rai","Los Angeles Raiders",17,"Kansas City Chiefs",20,37,-3,FALSE,"12/14/1986",1986,"December","1980s",56,66,6
"4551","198612150det","Detroit Lions",13,"Chicago Bears",16,29,-3,FALSE,"12/15/1986",1986,"December","1980s",72,NA,NA
"4552","198612190sfo","San Francisco 49ers",24,"Los Angeles Rams",14,38,10,TRUE,"12/19/1986",1986,"December","1980s",50,89,10
"4553","198612200sea","Seattle Seahawks",41,"Denver Broncos",16,57,25,TRUE,"12/20/1986",1986,"December","1980s",72,NA,NA
"4554","198612200nyg","New York Giants",55,"Green Bay Packers",24,79,31,TRUE,"12/20/1986",1986,"December","1980s",39,63,13
"4555","198612210pit","Pittsburgh Steelers",19,"Kansas City Chiefs",24,43,-5,FALSE,"12/21/1986",1986,"December","1980s",32,63,7
"4556","198612210crd","St. Louis Cardinals",21,"Tampa Bay Buccaneers",17,38,4,TRUE,"12/21/1986",1986,"December","1980s",37,79,4
"4557","198612210min","Minnesota Vikings",33,"New Orleans Saints",17,50,16,TRUE,"12/21/1986",1986,"December","1980s",72,NA,NA
"4558","198612210oti","Houston Oilers",16,"Buffalo Bills",7,23,9,TRUE,"12/21/1986",1986,"December","1980s",72,NA,NA
"4559","198612210cin","Cincinnati Bengals",52,"New York Jets",21,73,31,TRUE,"12/21/1986",1986,"December","1980s",28,78,4
"4560","198612210dal","Dallas Cowboys",10,"Chicago Bears",24,34,-14,FALSE,"12/21/1986",1986,"December","1980s",47,81,8
"4561","198612210phi","Philadelphia Eagles",14,"Washington Redskins",21,35,-7,FALSE,"12/21/1986",1986,"December","1980s",38,60,10
"4562","198612210cle","Cleveland Browns",47,"San Diego Chargers",17,64,30,TRUE,"12/21/1986",1986,"December","1980s",34,67,7
"4563","198612210rai","Los Angeles Raiders",24,"Indianapolis Colts",30,54,-6,FALSE,"12/21/1986",1986,"December","1980s",57,66,8
"4564","198612210det","Detroit Lions",6,"Atlanta Falcons",20,26,-14,FALSE,"12/21/1986",1986,"December","1980s",72,NA,NA
"4565","198612220mia","Miami Dolphins",27,"New England Patriots",34,61,-7,FALSE,"12/22/1986",1986,"December","1980s",70,68,11
"4566","198612280was","Washington Redskins",19,"Los Angeles Rams",7,26,12,TRUE,"12/28/1986",1986,"December","1980s",35,71,7
"4567","198612280nyj","New York Jets",35,"Kansas City Chiefs",15,50,20,TRUE,"12/28/1986",1986,"December","1980s",36,62,10
"4568","198701030cle","Cleveland Browns",23,"New York Jets",20,43,3,TRUE,"1/3/1987",1987,"January","1980s",32,80,12
"4569","198701030chi","Chicago Bears",13,"Washington Redskins",27,40,-14,FALSE,"1/3/1987",1987,"January","1980s",33,85,7
"4570","198701040den","Denver Broncos",22,"New England Patriots",17,39,5,TRUE,"1/4/1987",1987,"January","1980s",43,31,9
"4571","198701040nyg","New York Giants",49,"San Francisco 49ers",3,52,46,TRUE,"1/4/1987",1987,"January","1980s",31,66,15
"4572","198701110nyg","New York Giants",17,"Washington Redskins",0,17,17,TRUE,"1/11/1987",1987,"January","1980s",39,80,22
"4573","198701110cle","Cleveland Browns",20,"Denver Broncos",23,43,-3,FALSE,"1/11/1987",1987,"January","1980s",30,84,13
"4574","198701250den","Denver Broncos",20,"New York Giants",39,59,-19,FALSE,"1/25/1987",1987,"January","1980s",58,68,6
"4575","198709130tam","Tampa Bay Buccaneers",48,"Atlanta Falcons",10,58,38,TRUE,"9/13/1987",1987,"September","1980s",79,88,8
"4576","198709130buf","Buffalo Bills",28,"New York Jets",31,59,-3,FALSE,"9/13/1987",1987,"September","1980s",70,87,9
"4577","198709130oti","Houston Oilers",20,"Los Angeles Rams",16,36,4,TRUE,"9/13/1987",1987,"September","1980s",72,NA,NA
"4578","198709130crd","St. Louis Cardinals",24,"Dallas Cowboys",13,37,11,TRUE,"9/13/1987",1987,"September","1980s",72,52,6
"4579","198709130gnb","Green Bay Packers",0,"Los Angeles Raiders",20,20,-20,FALSE,"9/13/1987",1987,"September","1980s",56,78,9
"4580","198709130pit","Pittsburgh Steelers",30,"San Francisco 49ers",17,47,13,TRUE,"9/13/1987",1987,"September","1980s",71,85,5
"4581","198709130was","Washington Redskins",34,"Philadelphia Eagles",24,58,10,TRUE,"9/13/1987",1987,"September","1980s",74,92,11
"4582","198709130nor","New Orleans Saints",28,"Cleveland Browns",21,49,7,TRUE,"9/13/1987",1987,"September","1980s",72,NA,NA
"4583","198709130clt","Indianapolis Colts",21,"Cincinnati Bengals",23,44,-2,FALSE,"9/13/1987",1987,"September","1980s",72,NA,NA
"4584","198709130nwe","New England Patriots",28,"Miami Dolphins",21,49,7,TRUE,"9/13/1987",1987,"September","1980s",61,97,10
"4585","198709130den","Denver Broncos",40,"Seattle Seahawks",17,57,23,TRUE,"9/13/1987",1987,"September","1980s",69,34,10
"4586","198709130min","Minnesota Vikings",34,"Detroit Lions",19,53,15,TRUE,"9/13/1987",1987,"September","1980s",72,NA,NA
"4587","198709130kan","Kansas City Chiefs",20,"San Diego Chargers",13,33,7,TRUE,"9/13/1987",1987,"September","1980s",65,70,9
"4588","198709140chi","Chicago Bears",34,"New York Giants",19,53,15,TRUE,"9/14/1987",1987,"September","1980s",62,70,6
"4589","198709200rai","Los Angeles Raiders",27,"Detroit Lions",7,34,20,TRUE,"9/20/1987",1987,"September","1980s",66,87,8
"4590","198709200chi","Chicago Bears",20,"Tampa Bay Buccaneers",3,23,17,TRUE,"9/20/1987",1987,"September","1980s",56,82,10
"4591","198709200phi","Philadelphia Eagles",27,"New Orleans Saints",17,44,10,TRUE,"9/20/1987",1987,"September","1980s",62,85,12
"4592","198709200clt","Indianapolis Colts",10,"Miami Dolphins",23,33,-13,FALSE,"9/20/1987",1987,"September","1980s",72,NA,NA
"4593","198709200gnb","Green Bay Packers",17,"Denver Broncos",17,34,0,FALSE,"9/20/1987",1987,"September","1980s",55,89,9
"4594","198709200sdg","San Diego Chargers",28,"St. Louis Cardinals",24,52,4,TRUE,"9/20/1987",1987,"September","1980s",68,82,10
"4595","198709200ram","Los Angeles Rams",16,"Minnesota Vikings",21,37,-5,FALSE,"9/20/1987",1987,"September","1980s",66,87,8
"4596","198709200buf","Buffalo Bills",34,"Houston Oilers",30,64,4,TRUE,"9/20/1987",1987,"September","1980s",62,90,8
"4597","198709200sea","Seattle Seahawks",43,"Kansas City Chiefs",14,57,29,TRUE,"9/20/1987",1987,"September","1980s",72,NA,NA
"4598","198709200cin","Cincinnati Bengals",26,"San Francisco 49ers",27,53,-1,FALSE,"9/20/1987",1987,"September","1980s",62,60,9
"4599","198709200nyg","New York Giants",14,"Dallas Cowboys",16,30,-2,FALSE,"9/20/1987",1987,"September","1980s",60,90,16
"4600","198709200atl","Atlanta Falcons",21,"Washington Redskins",20,41,1,TRUE,"9/20/1987",1987,"September","1980s",70,67,10
"4601","198709200cle","Cleveland Browns",34,"Pittsburgh Steelers",10,44,24,TRUE,"9/20/1987",1987,"September","1980s",62,74,7
"4602","198709210nyj","New York Jets",43,"New England Patriots",24,67,19,TRUE,"9/21/1987",1987,"September","1980s",62,80,10
"4603","198710040det","Detroit Lions",27,"Tampa Bay Buccaneers",31,58,-4,FALSE,"10/4/1987",1987,"October","1980s",72,NA,NA
"4604","198710040nwe","New England Patriots",10,"Cleveland Browns",20,30,-10,FALSE,"10/4/1987",1987,"October","1980s",54,88,26
"4605","198710040cin","Cincinnati Bengals",9,"San Diego Chargers",10,19,-1,FALSE,"10/4/1987",1987,"October","1980s",44,55,8
"4606","198710040nor","New Orleans Saints",37,"Los Angeles Rams",10,47,27,TRUE,"10/4/1987",1987,"October","1980s",72,NA,NA
"4607","198710040min","Minnesota Vikings",16,"Green Bay Packers",23,39,-7,FALSE,"10/4/1987",1987,"October","1980s",72,NA,NA
"4608","198710040was","Washington Redskins",28,"St. Louis Cardinals",21,49,7,TRUE,"10/4/1987",1987,"October","1980s",50,49,16
"4609","198710040sea","Seattle Seahawks",24,"Miami Dolphins",20,44,4,TRUE,"10/4/1987",1987,"October","1980s",72,NA,NA
"4610","198710040den","Denver Broncos",10,"Houston Oilers",40,50,-30,FALSE,"10/4/1987",1987,"October","1980s",64,24,8
"4611","198710040nyj","New York Jets",24,"Dallas Cowboys",38,62,-14,FALSE,"10/4/1987",1987,"October","1980s",46,79,25
"4612","198710040rai","Los Angeles Raiders",35,"Kansas City Chiefs",17,52,18,TRUE,"10/4/1987",1987,"October","1980s",83,32,9
"4613","198710040phi","Philadelphia Eagles",3,"Chicago Bears",35,38,-32,FALSE,"10/4/1987",1987,"October","1980s",48,56,19
"4614","198710040atl","Atlanta Falcons",12,"Pittsburgh Steelers",28,40,-16,FALSE,"10/4/1987",1987,"October","1980s",53,47,8
"4615","198710040buf","Buffalo Bills",6,"Indianapolis Colts",47,53,-41,FALSE,"10/4/1987",1987,"October","1980s",43,62,13
"4616","198710050nyg","New York Giants",21,"San Francisco 49ers",41,62,-20,FALSE,"10/5/1987",1987,"October","1980s",56,53,12
"4617","198710110nwe","New England Patriots",14,"Buffalo Bills",7,21,7,TRUE,"10/11/1987",1987,"October","1980s",52,71,15
"4618","198710110crd","St. Louis Cardinals",24,"New Orleans Saints",19,43,5,TRUE,"10/11/1987",1987,"October","1980s",44,71,9
"4619","198710110clt","Indianapolis Colts",6,"New York Jets",0,6,6,TRUE,"10/11/1987",1987,"October","1980s",72,NA,NA
"4620","198710110chi","Chicago Bears",27,"Minnesota Vikings",7,34,20,TRUE,"10/11/1987",1987,"October","1980s",40,61,9
"4621","198710110cle","Cleveland Browns",10,"Houston Oilers",15,25,-5,FALSE,"10/11/1987",1987,"October","1980s",44,91,7
"4622","198710110dal","Dallas Cowboys",41,"Philadelphia Eagles",22,63,19,TRUE,"10/11/1987",1987,"October","1980s",58,66,16
"4623","198710110mia","Miami Dolphins",42,"Kansas City Chiefs",0,42,42,TRUE,"10/11/1987",1987,"October","1980s",76,93,9
"4624","198710110tam","Tampa Bay Buccaneers",13,"San Diego Chargers",17,30,-4,FALSE,"10/11/1987",1987,"October","1980s",75,83,12
"4625","198710110sea","Seattle Seahawks",10,"Cincinnati Bengals",17,27,-7,FALSE,"10/11/1987",1987,"October","1980s",72,NA,NA
"4626","198710110atl","Atlanta Falcons",17,"San Francisco 49ers",25,42,-8,FALSE,"10/11/1987",1987,"October","1980s",66,46,7
"4627","198710110ram","Los Angeles Rams",31,"Pittsburgh Steelers",21,52,10,TRUE,"10/11/1987",1987,"October","1980s",67,78,10
"4628","198710110nyg","New York Giants",12,"Washington Redskins",38,50,-26,FALSE,"10/11/1987",1987,"October","1980s",52,86,13
"4629","198710110gnb","Green Bay Packers",16,"Detroit Lions",19,35,-3,FALSE,"10/11/1987",1987,"October","1980s",35,61,9
"4630","198710120den","Denver Broncos",30,"Los Angeles Raiders",14,44,16,TRUE,"10/12/1987",1987,"October","1980s",53,26,7
"4631","198710180kan","Kansas City Chiefs",17,"Denver Broncos",26,43,-9,FALSE,"10/18/1987",1987,"October","1980s",56,54,9
"4632","198710180tam","Tampa Bay Buccaneers",20,"Minnesota Vikings",10,30,10,TRUE,"10/18/1987",1987,"October","1980s",74,70,10
"4633","198710180atl","Atlanta Falcons",24,"Los Angeles Rams",20,44,4,TRUE,"10/18/1987",1987,"October","1980s",66,45,8
"4634","198710180pit","Pittsburgh Steelers",21,"Indianapolis Colts",7,28,14,TRUE,"10/18/1987",1987,"October","1980s",49,78,6
"4635","198710180nyj","New York Jets",37,"Miami Dolphins",31,68,6,TRUE,"10/18/1987",1987,"October","1980s",61,74,10
"4636","198710180buf","Buffalo Bills",6,"New York Giants",3,9,3,TRUE,"10/18/1987",1987,"October","1980s",53,75,15
"4637","198710180rai","Los Angeles Raiders",17,"San Diego Chargers",23,40,-6,FALSE,"10/18/1987",1987,"October","1980s",65,80,9
"4638","198710180gnb","Green Bay Packers",16,"Philadelphia Eagles",10,26,6,TRUE,"10/18/1987",1987,"October","1980s",46,74,11
"4639","198710180sfo","San Francisco 49ers",34,"St. Louis Cardinals",28,62,6,TRUE,"10/18/1987",1987,"October","1980s",63,65,12
"4640","198710180det","Detroit Lions",14,"Seattle Seahawks",37,51,-23,FALSE,"10/18/1987",1987,"October","1980s",72,NA,NA
"4641","198710180cin","Cincinnati Bengals",0,"Cleveland Browns",34,34,-34,FALSE,"10/18/1987",1987,"October","1980s",48,70,4
"4642","198710180chi","Chicago Bears",17,"New Orleans Saints",19,36,-2,FALSE,"10/18/1987",1987,"October","1980s",51,71,11
"4643","198710180oti","Houston Oilers",7,"New England Patriots",21,28,-14,FALSE,"10/18/1987",1987,"October","1980s",72,NA,NA
"4644","198710190dal","Dallas Cowboys",7,"Washington Redskins",13,20,-6,FALSE,"10/19/1987",1987,"October","1980s",66,86,13
"4645","198710250nyg","New York Giants",30,"St. Louis Cardinals",7,37,23,TRUE,"10/25/1987",1987,"October","1980s",56,59,19
"4646","198710250rai","Los Angeles Raiders",13,"Seattle Seahawks",35,48,-22,FALSE,"10/25/1987",1987,"October","1980s",67,76,7
"4647","198710250sdg","San Diego Chargers",42,"Kansas City Chiefs",21,63,21,TRUE,"10/25/1987",1987,"October","1980s",68,76,7
"4648","198710250phi","Philadelphia Eagles",37,"Dallas Cowboys",20,57,17,TRUE,"10/25/1987",1987,"October","1980s",56,53,15
"4649","198710250pit","Pittsburgh Steelers",23,"Cincinnati Bengals",20,43,3,TRUE,"10/25/1987",1987,"October","1980s",43,73,15
"4650","198710250nor","New Orleans Saints",22,"San Francisco 49ers",24,46,-2,FALSE,"10/25/1987",1987,"October","1980s",72,NA,NA
"4651","198710250mia","Miami Dolphins",31,"Buffalo Bills",34,65,-3,FALSE,"10/25/1987",1987,"October","1980s",78,67,10
"4652","198710250clt","Indianapolis Colts",30,"New England Patriots",16,46,14,TRUE,"10/25/1987",1987,"October","1980s",72,NA,NA
"4653","198710250was","Washington Redskins",17,"New York Jets",16,33,1,TRUE,"10/25/1987",1987,"October","1980s",56,53,16
"4654","198710250tam","Tampa Bay Buccaneers",26,"Chicago Bears",27,53,-1,FALSE,"10/25/1987",1987,"October","1980s",72,73,8
"4655","198710250oti","Houston Oilers",37,"Atlanta Falcons",33,70,4,TRUE,"10/25/1987",1987,"October","1980s",72,NA,NA
"4656","198710250det","Detroit Lions",33,"Green Bay Packers",34,67,-1,FALSE,"10/25/1987",1987,"October","1980s",72,NA,NA
"4657","198710260cle","Cleveland Browns",30,"Los Angeles Rams",17,47,13,TRUE,"10/26/1987",1987,"October","1980s",40,67,7
"4658","198710260min","Minnesota Vikings",34,"Denver Broncos",27,61,7,TRUE,"10/26/1987",1987,"October","1980s",72,NA,NA
"4659","198711010chi","Chicago Bears",31,"Kansas City Chiefs",28,59,3,TRUE,"11/1/1987",1987,"November","1980s",56,93,8
"4660","198711010gnb","Green Bay Packers",17,"Tampa Bay Buccaneers",23,40,-6,FALSE,"11/1/1987",1987,"November","1980s",51,98,9
"4661","198711010crd","St. Louis Cardinals",23,"Philadelphia Eagles",28,51,-5,FALSE,"11/1/1987",1987,"November","1980s",68,60,10
"4662","198711010ram","Los Angeles Rams",10,"San Francisco 49ers",31,41,-21,FALSE,"11/1/1987",1987,"November","1980s",64,91,8
"4663","198711010den","Denver Broncos",34,"Detroit Lions",0,34,34,TRUE,"11/1/1987",1987,"November","1980s",53,71,6
"4664","198711010cin","Cincinnati Bengals",29,"Houston Oilers",31,60,-2,FALSE,"11/1/1987",1987,"November","1980s",63,59,5
"4665","198711010atl","Atlanta Falcons",0,"New Orleans Saints",38,38,-38,FALSE,"11/1/1987",1987,"November","1980s",66,54,8
"4666","198711010nwe","New England Patriots",26,"Los Angeles Raiders",23,49,3,TRUE,"11/1/1987",1987,"November","1980s",47,57,9
"4667","198711010sea","Seattle Seahawks",28,"Minnesota Vikings",17,45,11,TRUE,"11/1/1987",1987,"November","1980s",72,NA,NA
"4668","198711010mia","Miami Dolphins",35,"Pittsburgh Steelers",24,59,11,TRUE,"11/1/1987",1987,"November","1980s",77,85,20
"4669","198711010buf","Buffalo Bills",7,"Washington Redskins",27,34,-20,FALSE,"11/1/1987",1987,"November","1980s",44,74,7
"4670","198711010nyj","New York Jets",14,"Indianapolis Colts",19,33,-5,FALSE,"11/1/1987",1987,"November","1980s",53,62,9
"4671","198711010sdg","San Diego Chargers",27,"Cleveland Browns",24,51,3,TRUE,"11/1/1987",1987,"November","1980s",66,84,12
"4672","198711020dal","Dallas Cowboys",33,"New York Giants",24,57,9,TRUE,"11/2/1987",1987,"November","1980s",69,62,14
"4673","198711080nyg","New York Giants",17,"New England Patriots",10,27,7,TRUE,"11/8/1987",1987,"November","1980s",55,40,12
"4674","198711080min","Minnesota Vikings",31,"Los Angeles Raiders",20,51,11,TRUE,"11/8/1987",1987,"November","1980s",72,NA,NA
"4675","198711080clt","Indianapolis Colts",13,"San Diego Chargers",16,29,-3,FALSE,"11/8/1987",1987,"November","1980s",72,NA,NA
"4676","198711080sfo","San Francisco 49ers",27,"Houston Oilers",20,47,7,TRUE,"11/8/1987",1987,"November","1980s",59,71,8
"4677","198711080kan","Kansas City Chiefs",16,"Pittsburgh Steelers",17,33,-1,FALSE,"11/8/1987",1987,"November","1980s",56,62,13
"4678","198711080phi","Philadelphia Eagles",31,"Washington Redskins",27,58,4,TRUE,"11/8/1987",1987,"November","1980s",52,43,10
"4679","198711080buf","Buffalo Bills",21,"Denver Broncos",14,35,7,TRUE,"11/8/1987",1987,"November","1980s",50,68,17
"4680","198711080cle","Cleveland Browns",38,"Atlanta Falcons",3,41,35,TRUE,"11/8/1987",1987,"November","1980s",54,48,13
"4681","198711080det","Detroit Lions",27,"Dallas Cowboys",17,44,10,TRUE,"11/8/1987",1987,"November","1980s",72,NA,NA
"4682","198711080crd","St. Louis Cardinals",31,"Tampa Bay Buccaneers",28,59,3,TRUE,"11/8/1987",1987,"November","1980s",58,53,9
"4683","198711080cin","Cincinnati Bengals",14,"Miami Dolphins",20,34,-6,FALSE,"11/8/1987",1987,"November","1980s",58,33,13
"4684","198711080ram","Los Angeles Rams",14,"New Orleans Saints",31,45,-17,FALSE,"11/8/1987",1987,"November","1980s",61,87,7
"4685","198711080gnb","Green Bay Packers",24,"Chicago Bears",26,50,-2,FALSE,"11/8/1987",1987,"November","1980s",44,88,10
"4686","198711090nyj","New York Jets",30,"Seattle Seahawks",14,44,16,TRUE,"11/9/1987",1987,"November","1980s",62,55,17
"4687","198711150phi","Philadelphia Eagles",17,"New York Giants",20,37,-3,FALSE,"11/15/1987",1987,"November","1980s",50,55,8
"4688","198711150sea","Seattle Seahawks",24,"Green Bay Packers",13,37,11,TRUE,"11/15/1987",1987,"November","1980s",72,NA,NA
"4689","198711150cle","Cleveland Browns",27,"Buffalo Bills",21,48,6,TRUE,"11/15/1987",1987,"November","1980s",48,67,7
"4690","198711150min","Minnesota Vikings",23,"Tampa Bay Buccaneers",17,40,6,TRUE,"11/15/1987",1987,"November","1980s",72,NA,NA
"4691","198711150was","Washington Redskins",20,"Detroit Lions",13,33,7,TRUE,"11/15/1987",1987,"November","1980s",49,76,6
"4692","198711150pit","Pittsburgh Steelers",3,"Houston Oilers",23,26,-20,FALSE,"11/15/1987",1987,"November","1980s",48,59,5
"4693","198711150crd","St. Louis Cardinals",24,"Los Angeles Rams",27,51,-3,FALSE,"11/15/1987",1987,"November","1980s",55,52,16
"4694","198711150atl","Atlanta Falcons",10,"Cincinnati Bengals",16,26,-6,FALSE,"11/15/1987",1987,"November","1980s",57,32,9
"4695","198711150kan","Kansas City Chiefs",9,"New York Jets",16,25,-7,FALSE,"11/15/1987",1987,"November","1980s",57,70,16
"4696","198711150mia","Miami Dolphins",21,"Indianapolis Colts",40,61,-19,FALSE,"11/15/1987",1987,"November","1980s",77,76,14
"4697","198711150nwe","New England Patriots",17,"Dallas Cowboys",23,40,-6,FALSE,"11/15/1987",1987,"November","1980s",44,59,12
"4698","198711150sfo","San Francisco 49ers",24,"New Orleans Saints",26,50,-2,FALSE,"11/15/1987",1987,"November","1980s",54,67,10
"4699","198711150sdg","San Diego Chargers",16,"Los Angeles Raiders",14,30,2,TRUE,"11/15/1987",1987,"November","1980s",60,71,8
"4700","198711160den","Denver Broncos",31,"Chicago Bears",29,60,2,TRUE,"11/16/1987",1987,"November","1980s",25,75,9
"4701","198711220nor","New Orleans Saints",23,"New York Giants",14,37,9,TRUE,"11/22/1987",1987,"November","1980s",72,NA,NA
"4702","198711220sea","Seattle Seahawks",34,"San Diego Chargers",3,37,31,TRUE,"11/22/1987",1987,"November","1980s",72,NA,NA
"4703","198711220kan","Kansas City Chiefs",3,"Green Bay Packers",23,26,-20,FALSE,"11/22/1987",1987,"November","1980s",51,64,21
"4704","198711220nwe","New England Patriots",24,"Indianapolis Colts",0,24,24,TRUE,"11/22/1987",1987,"November","1980s",24,44,22
"4705","198711220phi","Philadelphia Eagles",19,"St. Louis Cardinals",31,50,-12,FALSE,"11/22/1987",1987,"November","1980s",26,37,19
"4706","198711220dal","Dallas Cowboys",14,"Miami Dolphins",20,34,-6,FALSE,"11/22/1987",1987,"November","1980s",59,72,17
"4707","198711220tam","Tampa Bay Buccaneers",10,"San Francisco 49ers",24,34,-14,FALSE,"11/22/1987",1987,"November","1980s",55,58,9
"4708","198711220chi","Chicago Bears",30,"Detroit Lions",10,40,20,TRUE,"11/22/1987",1987,"November","1980s",37,47,13
"4709","198711220cin","Cincinnati Bengals",16,"Pittsburgh Steelers",30,46,-14,FALSE,"11/22/1987",1987,"November","1980s",32,43,9
"4710","198711220rai","Los Angeles Raiders",17,"Denver Broncos",23,40,-6,FALSE,"11/22/1987",1987,"November","1980s",59,59,8
"4711","198711220oti","Houston Oilers",7,"Cleveland Browns",40,47,-33,FALSE,"11/22/1987",1987,"November","1980s",72,NA,NA
"4712","198711220nyj","New York Jets",14,"Buffalo Bills",17,31,-3,FALSE,"11/22/1987",1987,"November","1980s",27,45,26
"4713","198711220min","Minnesota Vikings",24,"Atlanta Falcons",13,37,11,TRUE,"11/22/1987",1987,"November","1980s",72,NA,NA
"4714","198711230was","Washington Redskins",26,"Los Angeles Rams",30,56,-4,FALSE,"11/23/1987",1987,"November","1980s",38,52,8
"4715","198711260det","Detroit Lions",20,"Kansas City Chiefs",27,47,-7,FALSE,"11/26/1987",1987,"November","1980s",72,NA,NA
"4716","198711260dal","Dallas Cowboys",38,"Minnesota Vikings",44,82,-6,FALSE,"11/26/1987",1987,"November","1980s",48,86,11
"4717","198711290nyj","New York Jets",27,"Cincinnati Bengals",20,47,7,TRUE,"11/29/1987",1987,"November","1980s",45,85,18
"4718","198711290nwe","New England Patriots",31,"Philadelphia Eagles",34,65,-3,FALSE,"11/29/1987",1987,"November","1980s",38,87,11
"4719","198711290was","Washington Redskins",23,"New York Giants",19,42,4,TRUE,"11/29/1987",1987,"November","1980s",52,98,11
"4720","198711290pit","Pittsburgh Steelers",16,"New Orleans Saints",20,36,-4,FALSE,"11/29/1987",1987,"November","1980s",47,95,12
"4721","198711290clt","Indianapolis Colts",51,"Houston Oilers",27,78,24,TRUE,"11/29/1987",1987,"November","1980s",72,NA,NA
"4722","198711290atl","Atlanta Falcons",21,"St. Louis Cardinals",34,55,-13,FALSE,"11/29/1987",1987,"November","1980s",51,83,9
"4723","198711290chi","Chicago Bears",23,"Green Bay Packers",10,33,13,TRUE,"11/29/1987",1987,"November","1980s",42,90,11
"4724","198711290ram","Los Angeles Rams",35,"Tampa Bay Buccaneers",3,38,32,TRUE,"11/29/1987",1987,"November","1980s",56,68,9
"4725","198711290sfo","San Francisco 49ers",38,"Cleveland Browns",24,62,14,TRUE,"11/29/1987",1987,"November","1980s",54,74,10
"4726","198711290buf","Buffalo Bills",27,"Miami Dolphins",0,27,27,TRUE,"11/29/1987",1987,"November","1980s",48,88,9
"4727","198711290sdg","San Diego Chargers",17,"Denver Broncos",31,48,-14,FALSE,"11/29/1987",1987,"November","1980s",60,67,9
"4728","198711300sea","Seattle Seahawks",14,"Los Angeles Raiders",37,51,-23,FALSE,"11/30/1987",1987,"November","1980s",72,NA,NA
"4729","198712060nyg","New York Giants",23,"Philadelphia Eagles",20,43,3,TRUE,"12/6/1987",1987,"December","1980s",38,55,22
"4730","198712060cle","Cleveland Browns",7,"Indianapolis Colts",9,16,-2,FALSE,"12/6/1987",1987,"December","1980s",32,74,7
"4731","198712060nor","New Orleans Saints",44,"Tampa Bay Buccaneers",34,78,10,TRUE,"12/6/1987",1987,"December","1980s",72,NA,NA
"4732","198712060cin","Cincinnati Bengals",30,"Kansas City Chiefs",27,57,3,TRUE,"12/6/1987",1987,"December","1980s",29,74,6
"4733","198712060min","Minnesota Vikings",24,"Chicago Bears",30,54,-6,FALSE,"12/6/1987",1987,"December","1980s",72,NA,NA
"4734","198712060oti","Houston Oilers",33,"San Diego Chargers",18,51,15,TRUE,"12/6/1987",1987,"December","1980s",72,NA,NA
"4735","198712060rai","Los Angeles Raiders",34,"Buffalo Bills",21,55,13,TRUE,"12/6/1987",1987,"December","1980s",58,79,7
"4736","198712060dal","Dallas Cowboys",10,"Atlanta Falcons",21,31,-11,FALSE,"12/6/1987",1987,"December","1980s",65,86,15
"4737","198712060pit","Pittsburgh Steelers",13,"Seattle Seahawks",9,22,4,TRUE,"12/6/1987",1987,"December","1980s",31,80,12
"4738","198712060gnb","Green Bay Packers",12,"San Francisco 49ers",23,35,-11,FALSE,"12/6/1987",1987,"December","1980s",27,91,5
"4739","198712060crd","St. Louis Cardinals",17,"Washington Redskins",34,51,-17,FALSE,"12/6/1987",1987,"December","1980s",39,70,18
"4740","198712060den","Denver Broncos",31,"New England Patriots",20,51,11,TRUE,"12/6/1987",1987,"December","1980s",45,60,9
"4741","198712060det","Detroit Lions",16,"Los Angeles Rams",37,53,-21,FALSE,"12/6/1987",1987,"December","1980s",72,NA,NA
"4742","198712070mia","Miami Dolphins",37,"New York Jets",28,65,9,TRUE,"12/7/1987",1987,"December","1980s",72,57,13
"4743","198712130cle","Cleveland Browns",38,"Cincinnati Bengals",24,62,14,TRUE,"12/13/1987",1987,"December","1980s",34,67,13
"4744","198712130gnb","Green Bay Packers",16,"Minnesota Vikings",10,26,6,TRUE,"12/13/1987",1987,"December","1980s",33,68,17
"4745","198712130nwe","New England Patriots",42,"New York Jets",20,62,22,TRUE,"12/13/1987",1987,"December","1980s",40,76,14
"4746","198712130nor","New Orleans Saints",24,"Houston Oilers",10,34,14,TRUE,"12/13/1987",1987,"December","1980s",72,NA,NA
"4747","198712130was","Washington Redskins",24,"Dallas Cowboys",20,44,4,TRUE,"12/13/1987",1987,"December","1980s",46,44,12
"4748","198712130clt","Indianapolis Colts",3,"Buffalo Bills",27,30,-24,FALSE,"12/13/1987",1987,"December","1980s",72,NA,NA
"4749","198712130crd","St. Louis Cardinals",27,"New York Giants",24,51,3,TRUE,"12/13/1987",1987,"December","1980s",34,66,9
"4750","198712130kan","Kansas City Chiefs",16,"Los Angeles Raiders",10,26,6,TRUE,"12/13/1987",1987,"December","1980s",32,68,8
"4751","198712130phi","Philadelphia Eagles",10,"Miami Dolphins",28,38,-18,FALSE,"12/13/1987",1987,"December","1980s",43,54,15
"4752","198712130sea","Seattle Seahawks",28,"Denver Broncos",21,49,7,TRUE,"12/13/1987",1987,"December","1980s",72,NA,NA
"4753","198712130tam","Tampa Bay Buccaneers",10,"Detroit Lions",20,30,-10,FALSE,"12/13/1987",1987,"December","1980s",66,82,6
"4754","198712130ram","Los Angeles Rams",33,"Atlanta Falcons",0,33,33,TRUE,"12/13/1987",1987,"December","1980s",54,16,17
"4755","198712130sdg","San Diego Chargers",16,"Pittsburgh Steelers",20,36,-4,FALSE,"12/13/1987",1987,"December","1980s",53,38,17
"4756","198712140sfo","San Francisco 49ers",41,"Chicago Bears",0,41,41,TRUE,"12/14/1987",1987,"December","1980s",47,42,15
"4757","198712190nyg","New York Giants",20,"Green Bay Packers",10,30,10,TRUE,"12/19/1987",1987,"December","1980s",37,57,12
"4758","198712190den","Denver Broncos",20,"Kansas City Chiefs",17,37,3,TRUE,"12/19/1987",1987,"December","1980s",26,77,6
"4759","198712200tam","Tampa Bay Buccaneers",14,"St. Louis Cardinals",31,45,-17,FALSE,"12/20/1987",1987,"December","1980s",68,73,9
"4760","198712200nyj","New York Jets",27,"Philadelphia Eagles",38,65,-11,FALSE,"12/20/1987",1987,"December","1980s",42,79,11
"4761","198712200det","Detroit Lions",14,"Minnesota Vikings",17,31,-3,FALSE,"12/20/1987",1987,"December","1980s",72,NA,NA
"4762","198712200oti","Houston Oilers",24,"Pittsburgh Steelers",16,40,8,TRUE,"12/20/1987",1987,"December","1980s",72,NA,NA
"4763","198712200sdg","San Diego Chargers",7,"Indianapolis Colts",20,27,-13,FALSE,"12/20/1987",1987,"December","1980s",53,80,7
"4764","198712200sfo","San Francisco 49ers",35,"Atlanta Falcons",7,42,28,TRUE,"12/20/1987",1987,"December","1980s",47,82,6
"4765","198712200cin","Cincinnati Bengals",24,"New Orleans Saints",41,65,-17,FALSE,"12/20/1987",1987,"December","1980s",46,72,20
"4766","198712200mia","Miami Dolphins",23,"Washington Redskins",21,44,2,TRUE,"12/20/1987",1987,"December","1980s",74,69,15
"4767","198712200rai","Los Angeles Raiders",17,"Cleveland Browns",24,41,-7,FALSE,"12/20/1987",1987,"December","1980s",54,59,6
"4768","198712200buf","Buffalo Bills",7,"New England Patriots",13,20,-6,FALSE,"12/20/1987",1987,"December","1980s",40,84,22
"4769","198712200chi","Chicago Bears",21,"Seattle Seahawks",34,55,-13,FALSE,"12/20/1987",1987,"December","1980s",36,82,17
"4770","198712210ram","Los Angeles Rams",21,"Dallas Cowboys",29,50,-8,FALSE,"12/21/1987",1987,"December","1980s",54,60,8
"4771","198712260pit","Pittsburgh Steelers",13,"Cleveland Browns",19,32,-6,FALSE,"12/26/1987",1987,"December","1980s",36,85,9
"4772","198712260min","Minnesota Vikings",24,"Washington Redskins",27,51,-3,FALSE,"12/26/1987",1987,"December","1980s",72,NA,NA
"4773","198712270sfo","San Francisco 49ers",48,"Los Angeles Rams",0,48,48,TRUE,"12/27/1987",1987,"December","1980s",47,75,7
"4774","198712270den","Denver Broncos",24,"San Diego Chargers",0,24,24,TRUE,"12/27/1987",1987,"December","1980s",18,91,16
"4775","198712270atl","Atlanta Falcons",13,"Detroit Lions",30,43,-17,FALSE,"12/27/1987",1987,"December","1980s",60,98,8
"4776","198712270oti","Houston Oilers",21,"Cincinnati Bengals",17,38,4,TRUE,"12/27/1987",1987,"December","1980s",72,NA,NA
"4777","198712270nor","New Orleans Saints",33,"Green Bay Packers",24,57,9,TRUE,"12/27/1987",1987,"December","1980s",72,NA,NA
"4778","198712270phi","Philadelphia Eagles",17,"Buffalo Bills",7,24,10,TRUE,"12/27/1987",1987,"December","1980s",35,63,10
"4779","198712270dal","Dallas Cowboys",21,"St. Louis Cardinals",16,37,5,TRUE,"12/27/1987",1987,"December","1980s",35,69,17
"4780","198712270rai","Los Angeles Raiders",3,"Chicago Bears",6,9,-3,FALSE,"12/27/1987",1987,"December","1980s",47,51,6
"4781","198712270nyg","New York Giants",20,"New York Jets",7,27,13,TRUE,"12/27/1987",1987,"December","1980s",35,61,11
"4782","198712270kan","Kansas City Chiefs",41,"Seattle Seahawks",20,61,21,TRUE,"12/27/1987",1987,"December","1980s",32,95,12
"4783","198712270clt","Indianapolis Colts",24,"Tampa Bay Buccaneers",6,30,18,TRUE,"12/27/1987",1987,"December","1980s",72,NA,NA
"4784","198712280mia","Miami Dolphins",10,"New England Patriots",24,34,-14,FALSE,"12/28/1987",1987,"December","1980s",75,73,8
"4785","198801030oti","Houston Oilers",23,"Seattle Seahawks",20,43,3,TRUE,"1/3/1988",1988,"January","1980s",72,NA,NA
"4786","198801030nor","New Orleans Saints",10,"Minnesota Vikings",44,54,-34,FALSE,"1/3/1988",1988,"January","1980s",72,NA,NA
"4787","198801090cle","Cleveland Browns",38,"Indianapolis Colts",21,59,17,TRUE,"1/9/1988",1988,"January","1980s",16,71,8
"4788","198801090sfo","San Francisco 49ers",24,"Minnesota Vikings",36,60,-12,FALSE,"1/9/1988",1988,"January","1980s",52,87,8
"4789","198801100chi","Chicago Bears",17,"Washington Redskins",21,38,-4,FALSE,"1/10/1988",1988,"January","1980s",-3,65,11
"4790","198801100den","Denver Broncos",34,"Houston Oilers",10,44,24,TRUE,"1/10/1988",1988,"January","1980s",28,55,9
"4791","198801170den","Denver Broncos",38,"Cleveland Browns",33,71,5,TRUE,"1/17/1988",1988,"January","1980s",29,63,8
"4792","198801170was","Washington Redskins",17,"Minnesota Vikings",10,27,7,TRUE,"1/17/1988",1988,"January","1980s",35,57,10
"4793","198801310den","Denver Broncos",10,"Washington Redskins",42,52,-32,FALSE,"1/31/1988",1988,"January","1980s",56,75,7
"4794","198809040det","Detroit Lions",31,"Atlanta Falcons",17,48,14,TRUE,"9/4/1988",1988,"September","1980s",72,NA,NA
"4795","198809040chi","Chicago Bears",34,"Miami Dolphins",7,41,27,TRUE,"9/4/1988",1988,"September","1980s",66,68,16
"4796","198809040nwe","New England Patriots",28,"New York Jets",3,31,25,TRUE,"9/4/1988",1988,"September","1980s",63,96,14
"4797","198809040nor","New Orleans Saints",33,"San Francisco 49ers",34,67,-1,FALSE,"9/4/1988",1988,"September","1980s",72,NA,NA
"4798","198809040buf","Buffalo Bills",13,"Minnesota Vikings",10,23,3,TRUE,"9/4/1988",1988,"September","1980s",68,85,11
"4799","198809040tam","Tampa Bay Buccaneers",14,"Philadelphia Eagles",41,55,-27,FALSE,"9/4/1988",1988,"September","1980s",82,80,9
"4800","198809040cin","Cincinnati Bengals",21,"Phoenix Cardinals",14,35,7,TRUE,"9/4/1988",1988,"September","1980s",68,79,10
"4801","198809040rai","Los Angeles Raiders",24,"San Diego Chargers",13,37,11,TRUE,"9/4/1988",1988,"September","1980s",82,45,8
"4802","198809040kan","Kansas City Chiefs",3,"Cleveland Browns",6,9,-3,FALSE,"9/4/1988",1988,"September","1980s",65,64,13
"4803","198809040clt","Indianapolis Colts",14,"Houston Oilers",17,31,-3,FALSE,"9/4/1988",1988,"September","1980s",72,NA,NA
"4804","198809040den","Denver Broncos",14,"Seattle Seahawks",21,35,-7,FALSE,"9/4/1988",1988,"September","1980s",62,38,9
"4805","198809040pit","Pittsburgh Steelers",24,"Dallas Cowboys",21,45,3,TRUE,"9/4/1988",1988,"September","1980s",69,87,12
"4806","198809040gnb","Green Bay Packers",7,"Los Angeles Rams",34,41,-27,FALSE,"9/4/1988",1988,"September","1980s",62,91,15
"4807","198809050nyg","New York Giants",27,"Washington Redskins",20,47,7,TRUE,"9/5/1988",1988,"September","1980s",72,74,17
"4808","198809110nyg","New York Giants",17,"San Francisco 49ers",20,37,-3,FALSE,"9/11/1988",1988,"September","1980s",69,51,15
"4809","198809110clt","Indianapolis Colts",13,"Chicago Bears",17,30,-4,FALSE,"9/11/1988",1988,"September","1980s",72,NA,NA
"4810","198809110ram","Los Angeles Rams",17,"Detroit Lions",10,27,7,TRUE,"9/11/1988",1988,"September","1980s",64,78,9
"4811","198809110sea","Seattle Seahawks",31,"Kansas City Chiefs",10,41,21,TRUE,"9/11/1988",1988,"September","1980s",72,NA,NA
"4812","198809110min","Minnesota Vikings",36,"New England Patriots",6,42,30,TRUE,"9/11/1988",1988,"September","1980s",72,NA,NA
"4813","198809110gnb","Green Bay Packers",10,"Tampa Bay Buccaneers",13,23,-3,FALSE,"9/11/1988",1988,"September","1980s",63,62,9
"4814","198809110cle","Cleveland Browns",3,"New York Jets",23,26,-20,FALSE,"9/11/1988",1988,"September","1980s",65,69,5
"4815","198809110phi","Philadelphia Eagles",24,"Cincinnati Bengals",28,52,-4,FALSE,"9/11/1988",1988,"September","1980s",66,59,9
"4816","198809110den","Denver Broncos",34,"San Diego Chargers",3,37,31,TRUE,"9/11/1988",1988,"September","1980s",69,43,13
"4817","198809110oti","Houston Oilers",38,"Los Angeles Raiders",35,73,3,TRUE,"9/11/1988",1988,"September","1980s",72,NA,NA
"4818","198809110buf","Buffalo Bills",9,"Miami Dolphins",6,15,3,TRUE,"9/11/1988",1988,"September","1980s",60,64,9
"4819","198809110atl","Atlanta Falcons",21,"New Orleans Saints",29,50,-8,FALSE,"9/11/1988",1988,"September","1980s",75,86,10
"4820","198809110was","Washington Redskins",30,"Pittsburgh Steelers",29,59,1,TRUE,"9/11/1988",1988,"September","1980s",73,61,9
"4821","198809120crd","Phoenix Cardinals",14,"Dallas Cowboys",17,31,-3,FALSE,"9/12/1988",1988,"September","1980s",89,25,10
"4822","198809180chi","Chicago Bears",7,"Minnesota Vikings",31,38,-24,FALSE,"9/18/1988",1988,"September","1980s",76,66,9
"4823","198809180kan","Kansas City Chiefs",20,"Denver Broncos",13,33,7,TRUE,"9/18/1988",1988,"September","1980s",76,86,17
"4824","198809180was","Washington Redskins",17,"Philadelphia Eagles",10,27,7,TRUE,"9/18/1988",1988,"September","1980s",69,87,10
"4825","198809180nwe","New England Patriots",14,"Buffalo Bills",16,30,-2,FALSE,"9/18/1988",1988,"September","1980s",67,75,14
"4826","198809180nyj","New York Jets",45,"Houston Oilers",3,48,42,TRUE,"9/18/1988",1988,"September","1980s",67,78,12
"4827","198809180sfo","San Francisco 49ers",17,"Atlanta Falcons",34,51,-17,FALSE,"9/18/1988",1988,"September","1980s",65,48,12
"4828","198809180rai","Los Angeles Raiders",17,"Los Angeles Rams",22,39,-5,FALSE,"9/18/1988",1988,"September","1980s",65,74,8
"4829","198809180pit","Pittsburgh Steelers",12,"Cincinnati Bengals",17,29,-5,FALSE,"9/18/1988",1988,"September","1980s",67,95,10
"4830","198809180det","Detroit Lions",14,"New Orleans Saints",22,36,-8,FALSE,"9/18/1988",1988,"September","1980s",72,NA,NA
"4831","198809180tam","Tampa Bay Buccaneers",24,"Phoenix Cardinals",30,54,-6,FALSE,"9/18/1988",1988,"September","1980s",81,78,6
"4832","198809180mia","Miami Dolphins",24,"Green Bay Packers",17,41,7,TRUE,"9/18/1988",1988,"September","1980s",84,72,12
"4833","198809180sdg","San Diego Chargers",17,"Seattle Seahawks",6,23,11,TRUE,"9/18/1988",1988,"September","1980s",66,74,7
"4834","198809180dal","Dallas Cowboys",10,"New York Giants",12,22,-2,FALSE,"9/18/1988",1988,"September","1980s",82,71,16
"4835","198809190cle","Cleveland Browns",23,"Indianapolis Colts",17,40,6,TRUE,"9/19/1988",1988,"September","1980s",72,86,13
"4836","198809250clt","Indianapolis Colts",15,"Miami Dolphins",13,28,2,TRUE,"9/25/1988",1988,"September","1980s",72,NA,NA
"4837","198809250sea","Seattle Seahawks",7,"San Francisco 49ers",38,45,-31,FALSE,"9/25/1988",1988,"September","1980s",72,NA,NA
"4838","198809250nor","New Orleans Saints",13,"Tampa Bay Buccaneers",9,22,4,TRUE,"9/25/1988",1988,"September","1980s",72,NA,NA
"4839","198809250dal","Dallas Cowboys",26,"Atlanta Falcons",20,46,6,TRUE,"9/25/1988",1988,"September","1980s",69,70,10
"4840","198809250det","Detroit Lions",10,"New York Jets",17,27,-7,FALSE,"9/25/1988",1988,"September","1980s",72,NA,NA
"4841","198809250min","Minnesota Vikings",23,"Philadelphia Eagles",21,44,2,TRUE,"9/25/1988",1988,"September","1980s",72,NA,NA
"4842","198809250nyg","New York Giants",31,"Los Angeles Rams",45,76,-14,FALSE,"9/25/1988",1988,"September","1980s",64,63,11
"4843","198809250oti","Houston Oilers",31,"New England Patriots",6,37,25,TRUE,"9/25/1988",1988,"September","1980s",72,NA,NA
"4844","198809250crd","Phoenix Cardinals",30,"Washington Redskins",21,51,9,TRUE,"9/25/1988",1988,"September","1980s",84,27,7
"4845","198809250buf","Buffalo Bills",36,"Pittsburgh Steelers",28,64,8,TRUE,"9/25/1988",1988,"September","1980s",57,62,7
"4846","198809250gnb","Green Bay Packers",6,"Chicago Bears",24,30,-18,FALSE,"9/25/1988",1988,"September","1980s",58,65,10
"4847","198809250kan","Kansas City Chiefs",23,"San Diego Chargers",24,47,-1,FALSE,"9/25/1988",1988,"September","1980s",64,63,8
"4848","198809250cin","Cincinnati Bengals",24,"Cleveland Browns",17,41,7,TRUE,"9/25/1988",1988,"September","1980s",61,71,9
"4849","198809260den","Denver Broncos",27,"Los Angeles Raiders",30,57,-3,FALSE,"9/26/1988",1988,"September","1980s",66,28,8
"4850","198810020sfo","San Francisco 49ers",20,"Detroit Lions",13,33,7,TRUE,"10/2/1988",1988,"October","1980s",60,75,12
"4851","198810020tam","Tampa Bay Buccaneers",27,"Green Bay Packers",24,51,3,TRUE,"10/2/1988",1988,"October","1980s",80,68,8
"4852","198810020atl","Atlanta Falcons",20,"Seattle Seahawks",31,51,-11,FALSE,"10/2/1988",1988,"October","1980s",70,87,9
"4853","198810020sdg","San Diego Chargers",0,"Denver Broncos",12,12,-12,FALSE,"10/2/1988",1988,"October","1980s",66,83,9
"4854","198810020ram","Los Angeles Rams",27,"Phoenix Cardinals",41,68,-14,FALSE,"10/2/1988",1988,"October","1980s",64,82,10
"4855","198810020nwe","New England Patriots",21,"Indianapolis Colts",17,38,4,TRUE,"10/2/1988",1988,"October","1980s",68,74,19
"4856","198810020chi","Chicago Bears",24,"Buffalo Bills",3,27,21,TRUE,"10/2/1988",1988,"October","1980s",59,76,11
"4857","198810020pit","Pittsburgh Steelers",9,"Cleveland Browns",23,32,-14,FALSE,"10/2/1988",1988,"October","1980s",68,79,15
"4858","198810020nyj","New York Jets",17,"Kansas City Chiefs",17,34,0,FALSE,"10/2/1988",1988,"October","1980s",70,73,14
"4859","198810020phi","Philadelphia Eagles",32,"Houston Oilers",23,55,9,TRUE,"10/2/1988",1988,"October","1980s",68,80,13
"4860","198810020rai","Los Angeles Raiders",21,"Cincinnati Bengals",45,66,-24,FALSE,"10/2/1988",1988,"October","1980s",64,82,10
"4861","198810020was","Washington Redskins",23,"New York Giants",24,47,-1,FALSE,"10/2/1988",1988,"October","1980s",69,84,16
"4862","198810020mia","Miami Dolphins",24,"Minnesota Vikings",7,31,17,TRUE,"10/2/1988",1988,"October","1980s",82,76,14
"4863","198810030nor","New Orleans Saints",20,"Dallas Cowboys",17,37,3,TRUE,"10/3/1988",1988,"October","1980s",72,NA,NA
"4864","198810090sdg","San Diego Chargers",17,"New Orleans Saints",23,40,-6,FALSE,"10/9/1988",1988,"October","1980s",72,51,8
"4865","198810090det","Detroit Lions",7,"Chicago Bears",24,31,-17,FALSE,"10/9/1988",1988,"October","1980s",72,NA,NA
"4866","198810090atl","Atlanta Falcons",0,"Los Angeles Rams",33,33,-33,FALSE,"10/9/1988",1988,"October","1980s",56,55,6
"4867","198810090oti","Houston Oilers",7,"Kansas City Chiefs",6,13,1,TRUE,"10/9/1988",1988,"October","1980s",72,NA,NA
"4868","198810090sfo","San Francisco 49ers",13,"Denver Broncos",16,29,-3,FALSE,"10/9/1988",1988,"October","1980s",62,74,16
"4869","198810090buf","Buffalo Bills",34,"Indianapolis Colts",23,57,11,TRUE,"10/9/1988",1988,"October","1980s",42,85,7
"4870","198810090cin","Cincinnati Bengals",36,"New York Jets",19,55,17,TRUE,"10/9/1988",1988,"October","1980s",51,56,9
"4871","198810090dal","Dallas Cowboys",17,"Washington Redskins",35,52,-18,FALSE,"10/9/1988",1988,"October","1980s",63,82,11
"4872","198810090crd","Phoenix Cardinals",31,"Pittsburgh Steelers",14,45,17,TRUE,"10/9/1988",1988,"October","1980s",84,19,5
"4873","198810090gnb","Green Bay Packers",45,"New England Patriots",3,48,42,TRUE,"10/9/1988",1988,"October","1980s",53,77,7
"4874","198810090cle","Cleveland Browns",10,"Seattle Seahawks",16,26,-6,FALSE,"10/9/1988",1988,"October","1980s",50,65,9
"4875","198810090rai","Los Angeles Raiders",14,"Miami Dolphins",24,38,-10,FALSE,"10/9/1988",1988,"October","1980s",74,47,10
"4876","198810090min","Minnesota Vikings",14,"Tampa Bay Buccaneers",13,27,1,TRUE,"10/9/1988",1988,"October","1980s",72,NA,NA
"4877","198810100phi","Philadelphia Eagles",24,"New York Giants",13,37,11,TRUE,"10/10/1988",1988,"October","1980s",55,66,12
"4878","198810160sea","Seattle Seahawks",19,"New Orleans Saints",20,39,-1,FALSE,"10/16/1988",1988,"October","1980s",72,NA,NA
"4879","198810160chi","Chicago Bears",17,"Dallas Cowboys",7,24,10,TRUE,"10/16/1988",1988,"October","1980s",63,68,20
"4880","198810160min","Minnesota Vikings",14,"Green Bay Packers",34,48,-20,FALSE,"10/16/1988",1988,"October","1980s",72,NA,NA
"4881","198810160was","Washington Redskins",33,"Phoenix Cardinals",17,50,16,TRUE,"10/16/1988",1988,"October","1980s",61,57,9
"4882","198810160pit","Pittsburgh Steelers",14,"Houston Oilers",34,48,-20,FALSE,"10/16/1988",1988,"October","1980s",59,46,11
"4883","198810160kan","Kansas City Chiefs",17,"Los Angeles Raiders",27,44,-10,FALSE,"10/16/1988",1988,"October","1980s",64,64,9
"4884","198810160clt","Indianapolis Colts",35,"Tampa Bay Buccaneers",31,66,4,TRUE,"10/16/1988",1988,"October","1980s",72,NA,NA
"4885","198810160mia","Miami Dolphins",31,"San Diego Chargers",28,59,3,TRUE,"10/16/1988",1988,"October","1980s",78,63,14
"4886","198810160cle","Cleveland Browns",19,"Philadelphia Eagles",3,22,16,TRUE,"10/16/1988",1988,"October","1980s",61,48,17
"4887","198810160ram","Los Angeles Rams",21,"San Francisco 49ers",24,45,-3,FALSE,"10/16/1988",1988,"October","1980s",66,82,6
"4888","198810160nyg","New York Giants",30,"Detroit Lions",10,40,20,TRUE,"10/16/1988",1988,"October","1980s",59,70,10
"4889","198810160nwe","New England Patriots",27,"Cincinnati Bengals",21,48,6,TRUE,"10/16/1988",1988,"October","1980s",52,92,10
"4890","198810160den","Denver Broncos",30,"Atlanta Falcons",14,44,16,TRUE,"10/16/1988",1988,"October","1980s",61,33,15
"4891","198810170nyj","New York Jets",14,"Buffalo Bills",37,51,-23,FALSE,"10/17/1988",1988,"October","1980s",63,81,13
"4892","198810230phi","Philadelphia Eagles",24,"Dallas Cowboys",23,47,1,TRUE,"10/23/1988",1988,"October","1980s",50,68,14
"4893","198810230nor","New Orleans Saints",20,"Los Angeles Raiders",6,26,14,TRUE,"10/23/1988",1988,"October","1980s",72,NA,NA
"4894","198810230ram","Los Angeles Rams",31,"Seattle Seahawks",10,41,21,TRUE,"10/23/1988",1988,"October","1980s",64,83,6
"4895","198810230cin","Cincinnati Bengals",44,"Houston Oilers",21,65,23,TRUE,"10/23/1988",1988,"October","1980s",42,84,13
"4896","198810230pit","Pittsburgh Steelers",39,"Denver Broncos",21,60,18,TRUE,"10/23/1988",1988,"October","1980s",43,81,13
"4897","198810230gnb","Green Bay Packers",17,"Washington Redskins",20,37,-3,FALSE,"10/23/1988",1988,"October","1980s",43,80,14
"4898","198810230kan","Kansas City Chiefs",6,"Detroit Lions",7,13,-1,FALSE,"10/23/1988",1988,"October","1980s",58,47,20
"4899","198810230mia","Miami Dolphins",30,"New York Jets",44,74,-14,FALSE,"10/23/1988",1988,"October","1980s",77,71,11
"4900","198810230tam","Tampa Bay Buccaneers",20,"Minnesota Vikings",49,69,-29,FALSE,"10/23/1988",1988,"October","1980s",65,60,6
"4901","198810230sdg","San Diego Chargers",0,"Indianapolis Colts",16,16,-16,FALSE,"10/23/1988",1988,"October","1980s",63,89,7
"4902","198810230crd","Phoenix Cardinals",21,"Cleveland Browns",29,50,-8,FALSE,"10/23/1988",1988,"October","1980s",80,46,7
"4903","198810230atl","Atlanta Falcons",16,"New York Giants",23,39,-7,FALSE,"10/23/1988",1988,"October","1980s",54,51,8
"4904","198810230buf","Buffalo Bills",23,"New England Patriots",20,43,3,TRUE,"10/23/1988",1988,"October","1980s",43,81,12
"4905","198810240chi","Chicago Bears",10,"San Francisco 49ers",9,19,1,TRUE,"10/24/1988",1988,"October","1980s",38,73,18
"4906","198810300nyj","New York Jets",24,"Pittsburgh Steelers",20,44,4,TRUE,"10/30/1988",1988,"October","1980s",46,40,14
"4907","198810300oti","Houston Oilers",41,"Washington Redskins",17,58,24,TRUE,"10/30/1988",1988,"October","1980s",72,NA,NA
"4908","198810300nor","New Orleans Saints",10,"Los Angeles Rams",12,22,-2,FALSE,"10/30/1988",1988,"October","1980s",72,NA,NA
"4909","198810300buf","Buffalo Bills",28,"Green Bay Packers",0,28,28,TRUE,"10/30/1988",1988,"October","1980s",36,58,15
"4910","198810300dal","Dallas Cowboys",10,"Phoenix Cardinals",16,26,-6,FALSE,"10/30/1988",1988,"October","1980s",57,95,10
"4911","198810300det","Detroit Lions",10,"New York Giants",13,23,-3,FALSE,"10/30/1988",1988,"October","1980s",72,NA,NA
"4912","198810300sfo","San Francisco 49ers",24,"Minnesota Vikings",21,45,3,TRUE,"10/30/1988",1988,"October","1980s",56,76,9
"4913","198810300tam","Tampa Bay Buccaneers",14,"Miami Dolphins",17,31,-3,FALSE,"10/30/1988",1988,"October","1980s",73,73,6
"4914","198810300nwe","New England Patriots",30,"Chicago Bears",7,37,23,TRUE,"10/30/1988",1988,"October","1980s",43,44,13
"4915","198810300sea","Seattle Seahawks",17,"San Diego Chargers",14,31,3,TRUE,"10/30/1988",1988,"October","1980s",72,NA,NA
"4916","198810300cle","Cleveland Browns",23,"Cincinnati Bengals",16,39,7,TRUE,"10/30/1988",1988,"October","1980s",38,57,9
"4917","198810300phi","Philadelphia Eagles",24,"Atlanta Falcons",27,51,-3,FALSE,"10/30/1988",1988,"October","1980s",43,50,10
"4918","198810300rai","Los Angeles Raiders",17,"Kansas City Chiefs",10,27,7,TRUE,"10/30/1988",1988,"October","1980s",62,74,10
"4919","198810310clt","Indianapolis Colts",55,"Denver Broncos",23,78,32,TRUE,"10/31/1988",1988,"October","1980s",72,NA,NA
"4920","198811060cin","Cincinnati Bengals",42,"Pittsburgh Steelers",7,49,35,TRUE,"11/6/1988",1988,"November","1980s",37,84,18
"4921","198811060sea","Seattle Seahawks",3,"Buffalo Bills",13,16,-10,FALSE,"11/6/1988",1988,"November","1980s",72,NA,NA
"4922","198811060nwe","New England Patriots",21,"Miami Dolphins",10,31,11,TRUE,"11/6/1988",1988,"November","1980s",58,76,17
"4923","198811060min","Minnesota Vikings",44,"Detroit Lions",17,61,27,TRUE,"11/6/1988",1988,"November","1980s",72,NA,NA
"4924","198811060was","Washington Redskins",27,"New Orleans Saints",24,51,3,TRUE,"11/6/1988",1988,"November","1980s",54,78,17
"4925","198811060chi","Chicago Bears",28,"Tampa Bay Buccaneers",10,38,18,TRUE,"11/6/1988",1988,"November","1980s",34,91,18
"4926","198811060phi","Philadelphia Eagles",30,"Los Angeles Rams",24,54,6,TRUE,"11/6/1988",1988,"November","1980s",58,69,16
"4927","198811060den","Denver Broncos",17,"Kansas City Chiefs",11,28,6,TRUE,"11/6/1988",1988,"November","1980s",47,39,8
"4928","198811060clt","Indianapolis Colts",38,"New York Jets",14,52,24,TRUE,"11/6/1988",1988,"November","1980s",72,NA,NA
"4929","198811060sdg","San Diego Chargers",3,"Los Angeles Raiders",13,16,-10,FALSE,"11/6/1988",1988,"November","1980s",61,89,7
"4930","198811060nyg","New York Giants",29,"Dallas Cowboys",21,50,8,TRUE,"11/6/1988",1988,"November","1980s",59,78,18
"4931","198811060atl","Atlanta Falcons",20,"Green Bay Packers",0,20,20,TRUE,"11/6/1988",1988,"November","1980s",53,55,13
"4932","198811060crd","Phoenix Cardinals",24,"San Francisco 49ers",23,47,1,TRUE,"11/6/1988",1988,"November","1980s",74,30,6
"4933","198811070oti","Houston Oilers",24,"Cleveland Browns",17,41,7,TRUE,"11/7/1988",1988,"November","1980s",72,NA,NA
"4934","198811130atl","Atlanta Falcons",7,"San Diego Chargers",10,17,-3,FALSE,"11/13/1988",1988,"November","1980s",54,75,9
"4935","198811130sea","Seattle Seahawks",27,"Houston Oilers",24,51,3,TRUE,"11/13/1988",1988,"November","1980s",72,NA,NA
"4936","198811130dal","Dallas Cowboys",3,"Minnesota Vikings",43,46,-40,FALSE,"11/13/1988",1988,"November","1980s",59,52,12
"4937","198811130crd","Phoenix Cardinals",24,"New York Giants",17,41,7,TRUE,"11/13/1988",1988,"November","1980s",68,35,6
"4938","198811130kan","Kansas City Chiefs",31,"Cincinnati Bengals",28,59,3,TRUE,"11/13/1988",1988,"November","1980s",48,61,16
"4939","198811130was","Washington Redskins",14,"Chicago Bears",34,48,-20,FALSE,"11/13/1988",1988,"November","1980s",50,80,11
"4940","198811130sfo","San Francisco 49ers",3,"Los Angeles Raiders",9,12,-6,FALSE,"11/13/1988",1988,"November","1980s",57,78,20
"4941","198811130nyj","New York Jets",13,"New England Patriots",14,27,-1,FALSE,"11/13/1988",1988,"November","1980s",50,79,18
"4942","198811130gnb","Green Bay Packers",13,"Indianapolis Colts",20,33,-7,FALSE,"11/13/1988",1988,"November","1980s",38,88,13
"4943","198811130det","Detroit Lions",20,"Tampa Bay Buccaneers",23,43,-3,FALSE,"11/13/1988",1988,"November","1980s",72,NA,NA
"4944","198811130den","Denver Broncos",30,"Cleveland Browns",7,37,23,TRUE,"11/13/1988",1988,"November","1980s",46,36,9
"4945","198811130pit","Pittsburgh Steelers",26,"Philadelphia Eagles",27,53,-1,FALSE,"11/13/1988",1988,"November","1980s",47,57,17
"4946","198811130ram","Los Angeles Rams",10,"New Orleans Saints",14,24,-4,FALSE,"11/13/1988",1988,"November","1980s",61,82,6
"4947","198811140mia","Miami Dolphins",6,"Buffalo Bills",31,37,-25,FALSE,"11/14/1988",1988,"November","1980s",76,72,16
"4948","198811200ram","Los Angeles Rams",24,"San Diego Chargers",38,62,-14,FALSE,"11/20/1988",1988,"November","1980s",55,62,6
"4949","198811200nyg","New York Giants",17,"Philadelphia Eagles",23,40,-6,FALSE,"11/20/1988",1988,"November","1980s",48,92,11
"4950","198811200buf","Buffalo Bills",9,"New York Jets",6,15,3,TRUE,"11/20/1988",1988,"November","1980s",43,87,10
"4951","198811200rai","Los Angeles Raiders",6,"Atlanta Falcons",12,18,-6,FALSE,"11/20/1988",1988,"November","1980s",55,62,6
"4952","198811200mia","Miami Dolphins",3,"New England Patriots",6,9,-3,FALSE,"11/20/1988",1988,"November","1980s",80,75,16
"4953","198811200tam","Tampa Bay Buccaneers",15,"Chicago Bears",27,42,-12,FALSE,"11/20/1988",1988,"November","1980s",77,76,10
"4954","198811200nor","New Orleans Saints",42,"Denver Broncos",0,42,42,TRUE,"11/20/1988",1988,"November","1980s",72,NA,NA
"4955","198811200cle","Cleveland Browns",27,"Pittsburgh Steelers",7,34,20,TRUE,"11/20/1988",1988,"November","1980s",46,97,12
"4956","198811200gnb","Green Bay Packers",9,"Detroit Lions",19,28,-10,FALSE,"11/20/1988",1988,"November","1980s",38,82,13
"4957","198811200oti","Houston Oilers",38,"Phoenix Cardinals",20,58,18,TRUE,"11/20/1988",1988,"November","1980s",72,NA,NA
"4958","198811200dal","Dallas Cowboys",24,"Cincinnati Bengals",38,62,-14,FALSE,"11/20/1988",1988,"November","1980s",45,67,21
"4959","198811200kan","Kansas City Chiefs",27,"Seattle Seahawks",24,51,3,TRUE,"11/20/1988",1988,"November","1980s",34,67,18
"4960","198811200min","Minnesota Vikings",12,"Indianapolis Colts",3,15,9,TRUE,"11/20/1988",1988,"November","1980s",72,NA,NA
"4961","198811210sfo","San Francisco 49ers",37,"Washington Redskins",21,58,16,TRUE,"11/21/1988",1988,"November","1980s",51,89,8
"4962","198811240dal","Dallas Cowboys",17,"Houston Oilers",25,42,-8,FALSE,"11/24/1988",1988,"November","1980s",57,58,17
"4963","198811240det","Detroit Lions",0,"Minnesota Vikings",23,23,-23,FALSE,"11/24/1988",1988,"November","1980s",72,NA,NA
"4964","198811270chi","Chicago Bears",16,"Green Bay Packers",0,16,16,TRUE,"11/27/1988",1988,"November","1980s",43,81,20
"4965","198811270den","Denver Broncos",35,"Los Angeles Rams",24,59,11,TRUE,"11/27/1988",1988,"November","1980s",23,62,8
"4966","198811270sdg","San Diego Chargers",10,"San Francisco 49ers",48,58,-38,FALSE,"11/27/1988",1988,"November","1980s",57,77,6
"4967","198811270nor","New Orleans Saints",12,"New York Giants",13,25,-1,FALSE,"11/27/1988",1988,"November","1980s",72,NA,NA
"4968","198811270was","Washington Redskins",13,"Cleveland Browns",17,30,-4,FALSE,"11/27/1988",1988,"November","1980s",61,83,15
"4969","198811270atl","Atlanta Falcons",17,"Tampa Bay Buccaneers",10,27,7,TRUE,"11/27/1988",1988,"November","1980s",61,86,14
"4970","198811270cin","Cincinnati Bengals",35,"Buffalo Bills",21,56,14,TRUE,"11/27/1988",1988,"November","1980s",54,82,19
"4971","198811270clt","Indianapolis Colts",24,"New England Patriots",21,45,3,TRUE,"11/27/1988",1988,"November","1980s",72,NA,NA
"4972","198811270pit","Pittsburgh Steelers",16,"Kansas City Chiefs",10,26,6,TRUE,"11/27/1988",1988,"November","1980s",59,56,18
"4973","198811270nyj","New York Jets",38,"Miami Dolphins",34,72,4,TRUE,"11/27/1988",1988,"November","1980s",54,86,9
"4974","198811270phi","Philadelphia Eagles",31,"Phoenix Cardinals",21,52,10,TRUE,"11/27/1988",1988,"November","1980s",55,88,11
"4975","198811280sea","Seattle Seahawks",35,"Los Angeles Raiders",27,62,8,TRUE,"11/28/1988",1988,"November","1980s",72,NA,NA
"4976","198812040rai","Los Angeles Raiders",21,"Denver Broncos",20,41,1,TRUE,"12/4/1988",1988,"December","1980s",63,37,6
"4977","198812040nwe","New England Patriots",13,"Seattle Seahawks",7,20,6,TRUE,"12/4/1988",1988,"December","1980s",39,39,23
"4978","198812040min","Minnesota Vikings",45,"New Orleans Saints",3,48,42,TRUE,"12/4/1988",1988,"December","1980s",72,NA,NA
"4979","198812040cle","Cleveland Browns",24,"Dallas Cowboys",21,45,3,TRUE,"12/4/1988",1988,"December","1980s",35,58,16
"4980","198812040atl","Atlanta Falcons",3,"San Francisco 49ers",13,16,-10,FALSE,"12/4/1988",1988,"December","1980s",49,56,8
"4981","198812040det","Detroit Lions",30,"Green Bay Packers",14,44,16,TRUE,"12/4/1988",1988,"December","1980s",72,NA,NA
"4982","198812040kan","Kansas City Chiefs",38,"New York Jets",34,72,4,TRUE,"12/4/1988",1988,"December","1980s",35,72,11
"4983","198812040oti","Houston Oilers",34,"Pittsburgh Steelers",37,71,-3,FALSE,"12/4/1988",1988,"December","1980s",72,NA,NA
"4984","198812040phi","Philadelphia Eagles",19,"Washington Redskins",20,39,-1,FALSE,"12/4/1988",1988,"December","1980s",41,39,17
"4985","198812040mia","Miami Dolphins",28,"Indianapolis Colts",31,59,-3,FALSE,"12/4/1988",1988,"December","1980s",68,61,12
"4986","198812040nyg","New York Giants",44,"Phoenix Cardinals",7,51,37,TRUE,"12/4/1988",1988,"December","1980s",42,40,24
"4987","198812040cin","Cincinnati Bengals",27,"San Diego Chargers",10,37,17,TRUE,"12/4/1988",1988,"December","1980s",37,55,13
"4988","198812040tam","Tampa Bay Buccaneers",10,"Buffalo Bills",5,15,5,TRUE,"12/4/1988",1988,"December","1980s",56,60,9
"4989","198812050ram","Los Angeles Rams",23,"Chicago Bears",3,26,20,TRUE,"12/5/1988",1988,"December","1980s",64,35,7
"4990","198812100crd","Phoenix Cardinals",17,"Philadelphia Eagles",23,40,-6,FALSE,"12/10/1988",1988,"December","1980s",58,54,9
"4991","198812100nyj","New York Jets",34,"Indianapolis Colts",16,50,18,TRUE,"12/10/1988",1988,"December","1980s",31,46,14
"4992","198812110was","Washington Redskins",17,"Dallas Cowboys",24,41,-7,FALSE,"12/11/1988",1988,"December","1980s",30,50,15
"4993","198812110sea","Seattle Seahawks",42,"Denver Broncos",14,56,28,TRUE,"12/11/1988",1988,"December","1980s",72,NA,NA
"4994","198812110nyg","New York Giants",28,"Kansas City Chiefs",12,40,16,TRUE,"12/11/1988",1988,"December","1980s",27,41,20
"4995","198812110sdg","San Diego Chargers",20,"Pittsburgh Steelers",14,34,6,TRUE,"12/11/1988",1988,"December","1980s",58,54,6
"4996","198812110ram","Los Angeles Rams",22,"Atlanta Falcons",7,29,15,TRUE,"12/11/1988",1988,"December","1980s",58,50,6
"4997","198812110buf","Buffalo Bills",37,"Los Angeles Raiders",21,58,16,TRUE,"12/11/1988",1988,"December","1980s",12,78,11
"4998","198812110oti","Houston Oilers",41,"Cincinnati Bengals",6,47,35,TRUE,"12/11/1988",1988,"December","1980s",72,NA,NA
"4999","198812110nwe","New England Patriots",10,"Tampa Bay Buccaneers",7,17,3,TRUE,"12/11/1988",1988,"December","1980s",22,51,17
"5000","198812110sfo","San Francisco 49ers",30,"New Orleans Saints",17,47,13,TRUE,"12/11/1988",1988,"December","1980s",54,70,5
"5001","198812110gnb","Green Bay Packers",18,"Minnesota Vikings",6,24,12,TRUE,"12/11/1988",1988,"December","1980s",6,65,9
"5002","198812110chi","Chicago Bears",13,"Detroit Lions",12,25,1,TRUE,"12/11/1988",1988,"December","1980s",11,67,9
"5003","198812120mia","Miami Dolphins",38,"Cleveland Browns",31,69,7,TRUE,"12/12/1988",1988,"December","1980s",74,83,11
"5004","198812170den","Denver Broncos",21,"New England Patriots",10,31,11,TRUE,"12/17/1988",1988,"December","1980s",32,56,9
"5005","198812170cin","Cincinnati Bengals",20,"Washington Redskins",17,37,3,TRUE,"12/17/1988",1988,"December","1980s",23,65,16
"5006","198812180dal","Dallas Cowboys",7,"Philadelphia Eagles",23,30,-16,FALSE,"12/18/1988",1988,"December","1980s",46,50,12
"5007","198812180nyj","New York Jets",27,"New York Giants",21,48,6,TRUE,"12/18/1988",1988,"December","1980s",25,42,15
"5008","198812180sfo","San Francisco 49ers",16,"Los Angeles Rams",38,54,-22,FALSE,"12/18/1988",1988,"December","1980s",49,83,6
"5009","198812180nor","New Orleans Saints",10,"Atlanta Falcons",9,19,1,TRUE,"12/18/1988",1988,"December","1980s",72,NA,NA
"5010","198812180pit","Pittsburgh Steelers",40,"Miami Dolphins",24,64,16,TRUE,"12/18/1988",1988,"December","1980s",19,95,16
"5011","198812180sdg","San Diego Chargers",24,"Kansas City Chiefs",13,37,11,TRUE,"12/18/1988",1988,"December","1980s",54,76,7
"5012","198812180tam","Tampa Bay Buccaneers",21,"Detroit Lions",10,31,11,TRUE,"12/18/1988",1988,"December","1980s",45,47,10
"5013","198812180crd","Phoenix Cardinals",17,"Green Bay Packers",26,43,-9,FALSE,"12/18/1988",1988,"December","1980s",60,48,7
"5014","198812180rai","Los Angeles Raiders",37,"Seattle Seahawks",43,80,-6,FALSE,"12/18/1988",1988,"December","1980s",54,77,8
"5015","198812180clt","Indianapolis Colts",17,"Buffalo Bills",14,31,3,TRUE,"12/18/1988",1988,"December","1980s",72,NA,NA
"5016","198812180cle","Cleveland Browns",28,"Houston Oilers",23,51,5,TRUE,"12/18/1988",1988,"December","1980s",20,83,13
"5017","198812190min","Minnesota Vikings",28,"Chicago Bears",27,55,1,TRUE,"12/19/1988",1988,"December","1980s",72,NA,NA
"5018","198812240cle","Cleveland Browns",23,"Houston Oilers",24,47,-1,FALSE,"12/24/1988",1988,"December","1980s",38,72,11
"5019","198812260min","Minnesota Vikings",28,"Los Angeles Rams",17,45,11,TRUE,"12/26/1988",1988,"December","1980s",72,NA,NA
"5020","198812310cin","Cincinnati Bengals",21,"Seattle Seahawks",13,34,8,TRUE,"12/31/1988",1988,"December","1980s",32,74,7
"5021","198812310chi","Chicago Bears",20,"Philadelphia Eagles",12,32,8,TRUE,"12/31/1988",1988,"December","1980s",25,84,7
"5022","198901010buf","Buffalo Bills",17,"Houston Oilers",10,27,7,TRUE,"1/1/1989",1989,"January","1980s",28,73,8
"5023","198901010sfo","San Francisco 49ers",34,"Minnesota Vikings",9,43,25,TRUE,"1/1/1989",1989,"January","1980s",43,80,9
"5024","198901080cin","Cincinnati Bengals",21,"Buffalo Bills",10,31,11,TRUE,"1/8/1989",1989,"January","1980s",43,70,21
"5025","198901080chi","Chicago Bears",3,"San Francisco 49ers",28,31,-25,FALSE,"1/8/1989",1989,"January","1980s",20,72,29
"5026","198901220cin","Cincinnati Bengals",16,"San Francisco 49ers",20,36,-4,FALSE,"1/22/1989",1989,"January","1980s",72,80,17
"5027","198909100atl","Atlanta Falcons",21,"Los Angeles Rams",31,52,-10,FALSE,"9/10/1989",1989,"September","1980s",80,66,9
"5028","198909100nor","New Orleans Saints",28,"Dallas Cowboys",0,28,28,TRUE,"9/10/1989",1989,"September","1980s",72,NA,NA
"5029","198909100mia","Miami Dolphins",24,"Buffalo Bills",27,51,-3,FALSE,"9/10/1989",1989,"September","1980s",82,70,11
"5030","198909100den","Denver Broncos",34,"Kansas City Chiefs",20,54,14,TRUE,"9/10/1989",1989,"September","1980s",54,82,11
"5031","198909100phi","Philadelphia Eagles",31,"Seattle Seahawks",7,38,24,TRUE,"9/10/1989",1989,"September","1980s",80,73,8
"5032","198909100gnb","Green Bay Packers",21,"Tampa Bay Buccaneers",23,44,-2,FALSE,"9/10/1989",1989,"September","1980s",60,68,6
"5033","198909100rai","Los Angeles Raiders",40,"San Diego Chargers",14,54,26,TRUE,"9/10/1989",1989,"September","1980s",65,80,10
"5034","198909100chi","Chicago Bears",17,"Cincinnati Bengals",14,31,3,TRUE,"9/10/1989",1989,"September","1980s",64,75,12
"5035","198909100clt","Indianapolis Colts",24,"San Francisco 49ers",30,54,-6,FALSE,"9/10/1989",1989,"September","1980s",72,NA,NA
"5036","198909100min","Minnesota Vikings",38,"Houston Oilers",7,45,31,TRUE,"9/10/1989",1989,"September","1980s",72,NA,NA
"5037","198909100nyj","New York Jets",24,"New England Patriots",27,51,-3,FALSE,"9/10/1989",1989,"September","1980s",85,61,9
"5038","198909100det","Detroit Lions",13,"Phoenix Cardinals",16,29,-3,FALSE,"9/10/1989",1989,"September","1980s",72,NA,NA
"5039","198909100pit","Pittsburgh Steelers",0,"Cleveland Browns",51,51,-51,FALSE,"9/10/1989",1989,"September","1980s",73,83,8
"5040","198909110was","Washington Redskins",24,"New York Giants",27,51,-3,FALSE,"9/11/1989",1989,"September","1980s",83,70,11
"5041","198909170nyg","New York Giants",24,"Detroit Lions",14,38,10,TRUE,"9/17/1989",1989,"September","1980s",69,84,8
"5042","198909170cle","Cleveland Browns",38,"New York Jets",24,62,14,TRUE,"9/17/1989",1989,"September","1980s",62,84,11
"5043","198909170cin","Cincinnati Bengals",41,"Pittsburgh Steelers",10,51,31,TRUE,"9/17/1989",1989,"September","1980s",63,75,6
"5044","198909170nwe","New England Patriots",10,"Miami Dolphins",24,34,-14,FALSE,"9/17/1989",1989,"September","1980s",62,96,11
"5045","198909170kan","Kansas City Chiefs",24,"Los Angeles Raiders",19,43,5,TRUE,"9/17/1989",1989,"September","1980s",68,76,13
"5046","198909170gnb","Green Bay Packers",35,"New Orleans Saints",34,69,1,TRUE,"9/17/1989",1989,"September","1980s",60,66,7
"5047","198909170chi","Chicago Bears",38,"Minnesota Vikings",7,45,31,TRUE,"9/17/1989",1989,"September","1980s",62,69,4
"5048","198909170ram","Los Angeles Rams",31,"Indianapolis Colts",17,48,14,TRUE,"9/17/1989",1989,"September","1980s",67,79,12
"5049","198909170sea","Seattle Seahawks",24,"Phoenix Cardinals",34,58,-10,FALSE,"9/17/1989",1989,"September","1980s",72,NA,NA
"5050","198909170sdg","San Diego Chargers",27,"Houston Oilers",34,61,-7,FALSE,"9/17/1989",1989,"September","1980s",70,80,10
"5051","198909170was","Washington Redskins",37,"Philadelphia Eagles",42,79,-5,FALSE,"9/17/1989",1989,"September","1980s",72,78,11
"5052","198909170atl","Atlanta Falcons",27,"Dallas Cowboys",21,48,6,TRUE,"9/17/1989",1989,"September","1980s",70,66,9
"5053","198909170tam","Tampa Bay Buccaneers",16,"San Francisco 49ers",20,36,-4,FALSE,"9/17/1989",1989,"September","1980s",82,74,6
"5054","198909180buf","Buffalo Bills",14,"Denver Broncos",28,42,-14,FALSE,"9/18/1989",1989,"September","1980s",57,79,6
"5055","198909240tam","Tampa Bay Buccaneers",20,"New Orleans Saints",10,30,10,TRUE,"9/24/1989",1989,"September","1980s",77,86,8
"5056","198909240pit","Pittsburgh Steelers",27,"Minnesota Vikings",14,41,13,TRUE,"9/24/1989",1989,"September","1980s",48,67,7
"5057","198909240clt","Indianapolis Colts",13,"Atlanta Falcons",9,22,4,TRUE,"9/24/1989",1989,"September","1980s",72,NA,NA
"5058","198909240sdg","San Diego Chargers",21,"Kansas City Chiefs",6,27,15,TRUE,"9/24/1989",1989,"September","1980s",67,85,10
"5059","198909240nyg","New York Giants",35,"Phoenix Cardinals",7,42,28,TRUE,"9/24/1989",1989,"September","1980s",54,54,16
"5060","198909240ram","Los Angeles Rams",41,"Green Bay Packers",38,79,3,TRUE,"9/24/1989",1989,"September","1980s",64,86,10
"5061","198909240det","Detroit Lions",27,"Chicago Bears",47,74,-20,FALSE,"9/24/1989",1989,"September","1980s",72,NA,NA
"5062","198909240dal","Dallas Cowboys",7,"Washington Redskins",30,37,-23,FALSE,"9/24/1989",1989,"September","1980s",59,42,13
"5063","198909240phi","Philadelphia Eagles",28,"San Francisco 49ers",38,66,-10,FALSE,"9/24/1989",1989,"September","1980s",52,62,10
"5064","198909240mia","Miami Dolphins",33,"New York Jets",40,73,-7,FALSE,"9/24/1989",1989,"September","1980s",82,75,11
"5065","198909240den","Denver Broncos",31,"Los Angeles Raiders",21,52,10,TRUE,"9/24/1989",1989,"September","1980s",62,43,11
"5066","198909240oti","Houston Oilers",41,"Buffalo Bills",47,88,-6,FALSE,"9/24/1989",1989,"September","1980s",72,NA,NA
"5067","198909240nwe","New England Patriots",3,"Seattle Seahawks",24,27,-21,FALSE,"9/24/1989",1989,"September","1980s",53,49,17
"5068","198909250cin","Cincinnati Bengals",21,"Cleveland Browns",14,35,7,TRUE,"9/25/1989",1989,"September","1980s",52,72,6
"5069","198910010crd","Phoenix Cardinals",13,"San Diego Chargers",24,37,-11,FALSE,"10/1/1989",1989,"October","1980s",86,21,7
"5070","198910010kan","Kansas City Chiefs",17,"Cincinnati Bengals",21,38,-4,FALSE,"10/1/1989",1989,"October","1980s",68,64,15
"5071","198910010dal","Dallas Cowboys",13,"New York Giants",30,43,-17,FALSE,"10/1/1989",1989,"October","1980s",73,52,8
"5072","198910010det","Detroit Lions",3,"Pittsburgh Steelers",23,26,-20,FALSE,"10/1/1989",1989,"October","1980s",72,NA,NA
"5073","198910010nyj","New York Jets",10,"Indianapolis Colts",17,27,-7,FALSE,"10/1/1989",1989,"October","1980s",63,67,9
"5074","198910010cle","Cleveland Browns",16,"Denver Broncos",13,29,3,TRUE,"10/1/1989",1989,"October","1980s",60,84,12
"5075","198910010oti","Houston Oilers",39,"Miami Dolphins",7,46,32,TRUE,"10/1/1989",1989,"October","1980s",72,NA,NA
"5076","198910010buf","Buffalo Bills",31,"New England Patriots",10,41,21,TRUE,"10/1/1989",1989,"October","1980s",60,68,10
"5077","198910010rai","Los Angeles Raiders",20,"Seattle Seahawks",24,44,-4,FALSE,"10/1/1989",1989,"October","1980s",65,78,9
"5078","198910010sfo","San Francisco 49ers",12,"Los Angeles Rams",13,25,-1,FALSE,"10/1/1989",1989,"October","1980s",60,82,15
"5079","198910010gnb","Green Bay Packers",23,"Atlanta Falcons",21,44,2,TRUE,"10/1/1989",1989,"October","1980s",61,85,10
"5080","198910010nor","New Orleans Saints",14,"Washington Redskins",16,30,-2,FALSE,"10/1/1989",1989,"October","1980s",72,NA,NA
"5081","198910010min","Minnesota Vikings",17,"Tampa Bay Buccaneers",3,20,14,TRUE,"10/1/1989",1989,"October","1980s",72,NA,NA
"5082","198910020chi","Chicago Bears",27,"Philadelphia Eagles",13,40,14,TRUE,"10/2/1989",1989,"October","1980s",62,74,16
"5083","198910080nwe","New England Patriots",23,"Houston Oilers",13,36,10,TRUE,"10/8/1989",1989,"October","1980s",51,54,15
"5084","198910080gnb","Green Bay Packers",31,"Dallas Cowboys",13,44,18,TRUE,"10/8/1989",1989,"October","1980s",39,57,8
"5085","198910080mia","Miami Dolphins",13,"Cleveland Browns",10,23,3,TRUE,"10/8/1989",1989,"October","1980s",81,78,10
"5086","198910080phi","Philadelphia Eagles",21,"New York Giants",19,40,2,TRUE,"10/8/1989",1989,"October","1980s",50,58,10
"5087","198910080min","Minnesota Vikings",24,"Detroit Lions",17,41,7,TRUE,"10/8/1989",1989,"October","1980s",72,NA,NA
"5088","198910080clt","Indianapolis Colts",37,"Buffalo Bills",14,51,23,TRUE,"10/8/1989",1989,"October","1980s",72,NA,NA
"5089","198910080nor","New Orleans Saints",20,"San Francisco 49ers",24,44,-4,FALSE,"10/8/1989",1989,"October","1980s",72,NA,NA
"5090","198910080pit","Pittsburgh Steelers",16,"Cincinnati Bengals",26,42,-10,FALSE,"10/8/1989",1989,"October","1980s",41,80,9
"5091","198910080was","Washington Redskins",30,"Phoenix Cardinals",28,58,2,TRUE,"10/8/1989",1989,"October","1980s",52,60,11
"5092","198910080sea","Seattle Seahawks",16,"Kansas City Chiefs",20,36,-4,FALSE,"10/8/1989",1989,"October","1980s",72,NA,NA
"5093","198910080ram","Los Angeles Rams",26,"Atlanta Falcons",14,40,12,TRUE,"10/8/1989",1989,"October","1980s",65,88,9
"5094","198910080tam","Tampa Bay Buccaneers",42,"Chicago Bears",35,77,7,TRUE,"10/8/1989",1989,"October","1980s",80,79,9
"5095","198910080den","Denver Broncos",16,"San Diego Chargers",10,26,6,TRUE,"10/8/1989",1989,"October","1980s",55,34,8
"5096","198910090nyj","New York Jets",7,"Los Angeles Raiders",14,21,-7,FALSE,"10/9/1989",1989,"October","1980s",49,51,15
"5097","198910150dal","Dallas Cowboys",14,"San Francisco 49ers",31,45,-17,FALSE,"10/15/1989",1989,"October","1980s",76,58,12
"5098","198910150den","Denver Broncos",14,"Indianapolis Colts",3,17,11,TRUE,"10/15/1989",1989,"October","1980s",52,40,11
"5099","198910150crd","Phoenix Cardinals",5,"Philadelphia Eagles",17,22,-12,FALSE,"10/15/1989",1989,"October","1980s",80,26,8
"5100","198910150sdg","San Diego Chargers",16,"Seattle Seahawks",17,33,-1,FALSE,"10/15/1989",1989,"October","1980s",66,67,8
"5101","198910150min","Minnesota Vikings",26,"Green Bay Packers",14,40,12,TRUE,"10/15/1989",1989,"October","1980s",72,NA,NA
"5102","198910150nyg","New York Giants",20,"Washington Redskins",17,37,3,TRUE,"10/15/1989",1989,"October","1980s",62,81,13
"5103","198910150chi","Chicago Bears",28,"Houston Oilers",33,61,-5,FALSE,"10/15/1989",1989,"October","1980s",69,62,13
"5104","198910150rai","Los Angeles Raiders",20,"Kansas City Chiefs",14,34,6,TRUE,"10/15/1989",1989,"October","1980s",64,77,9
"5105","198910150tam","Tampa Bay Buccaneers",16,"Detroit Lions",17,33,-1,FALSE,"10/15/1989",1989,"October","1980s",79,79,5
"5106","198910150atl","Atlanta Falcons",16,"New England Patriots",15,31,1,TRUE,"10/15/1989",1989,"October","1980s",70,70,8
"5107","198910150nor","New Orleans Saints",29,"New York Jets",14,43,15,TRUE,"10/15/1989",1989,"October","1980s",72,NA,NA
"5108","198910150cin","Cincinnati Bengals",13,"Miami Dolphins",20,33,-7,FALSE,"10/15/1989",1989,"October","1980s",66,68,9
"5109","198910150cle","Cleveland Browns",7,"Pittsburgh Steelers",17,24,-10,FALSE,"10/15/1989",1989,"October","1980s",68,62,13
"5110","198910160buf","Buffalo Bills",23,"Los Angeles Rams",20,43,3,TRUE,"10/16/1989",1989,"October","1980s",66,66,16
"5111","198910220mia","Miami Dolphins",23,"Green Bay Packers",20,43,3,TRUE,"10/22/1989",1989,"October","1980s",69,65,15
"5112","198910220ram","Los Angeles Rams",21,"New Orleans Saints",40,61,-19,FALSE,"10/22/1989",1989,"October","1980s",66,82,9
"5113","198910220sea","Seattle Seahawks",21,"Denver Broncos",24,45,-3,FALSE,"10/22/1989",1989,"October","1980s",72,NA,NA
"5114","198910220sfo","San Francisco 49ers",37,"New England Patriots",20,57,17,TRUE,"10/22/1989",1989,"October","1980s",63,76,16
"5115","198910220oti","Houston Oilers",27,"Pittsburgh Steelers",0,27,27,TRUE,"10/22/1989",1989,"October","1980s",72,NA,NA
"5116","198910220was","Washington Redskins",32,"Tampa Bay Buccaneers",28,60,4,TRUE,"10/22/1989",1989,"October","1980s",55,45,15
"5117","198910220det","Detroit Lions",7,"Minnesota Vikings",20,27,-13,FALSE,"10/22/1989",1989,"October","1980s",72,NA,NA
"5118","198910220sdg","San Diego Chargers",13,"New York Giants",20,33,-7,FALSE,"10/22/1989",1989,"October","1980s",68,80,8
"5119","198910220phi","Philadelphia Eagles",10,"Los Angeles Raiders",7,17,3,TRUE,"10/22/1989",1989,"October","1980s",51,72,14
"5120","198910220kan","Kansas City Chiefs",36,"Dallas Cowboys",28,64,8,TRUE,"10/22/1989",1989,"October","1980s",56,57,9
"5121","198910220cin","Cincinnati Bengals",12,"Indianapolis Colts",23,35,-11,FALSE,"10/22/1989",1989,"October","1980s",46,65,8
"5122","198910220buf","Buffalo Bills",34,"New York Jets",3,37,31,TRUE,"10/22/1989",1989,"October","1980s",44,73,17
"5123","198910220crd","Phoenix Cardinals",34,"Atlanta Falcons",20,54,14,TRUE,"10/22/1989",1989,"October","1980s",70,74,8
"5124","198910230cle","Cleveland Browns",27,"Chicago Bears",7,34,20,TRUE,"10/23/1989",1989,"October","1980s",51,62,9
"5125","198910290gnb","Green Bay Packers",23,"Detroit Lions",20,43,3,TRUE,"10/29/1989",1989,"October","1980s",61,54,13
"5126","198910290rai","Los Angeles Raiders",37,"Washington Redskins",24,61,13,TRUE,"10/29/1989",1989,"October","1980s",63,47,8
"5127","198910290cle","Cleveland Browns",28,"Houston Oilers",17,45,11,TRUE,"10/29/1989",1989,"October","1980s",55,59,7
"5128","198910290nyj","New York Jets",10,"San Francisco 49ers",23,33,-13,FALSE,"10/29/1989",1989,"October","1980s",64,77,6
"5129","198910290pit","Pittsburgh Steelers",23,"Kansas City Chiefs",17,40,6,TRUE,"10/29/1989",1989,"October","1980s",56,58,4
"5130","198910290buf","Buffalo Bills",31,"Miami Dolphins",17,48,14,TRUE,"10/29/1989",1989,"October","1980s",56,55,6
"5131","198910290cin","Cincinnati Bengals",56,"Tampa Bay Buccaneers",23,79,33,TRUE,"10/29/1989",1989,"October","1980s",59,49,5
"5132","198910290clt","Indianapolis Colts",20,"New England Patriots",23,43,-3,FALSE,"10/29/1989",1989,"October","1980s",72,NA,NA
"5133","198910290den","Denver Broncos",24,"Philadelphia Eagles",28,52,-4,FALSE,"10/29/1989",1989,"October","1980s",39,38,14
"5134","198910290nor","New Orleans Saints",20,"Atlanta Falcons",13,33,7,TRUE,"10/29/1989",1989,"October","1980s",72,NA,NA
"5135","198910290dal","Dallas Cowboys",10,"Phoenix Cardinals",19,29,-9,FALSE,"10/29/1989",1989,"October","1980s",71,71,15
"5136","198910290sea","Seattle Seahawks",10,"San Diego Chargers",7,17,3,TRUE,"10/29/1989",1989,"October","1980s",72,NA,NA
"5137","198910290chi","Chicago Bears",20,"Los Angeles Rams",10,30,10,TRUE,"10/29/1989",1989,"October","1980s",63,52,11
"5138","198910300nyg","New York Giants",24,"Minnesota Vikings",14,38,10,TRUE,"10/30/1989",1989,"October","1980s",63,72,7
"5139","198911050sdg","San Diego Chargers",20,"Philadelphia Eagles",17,37,3,TRUE,"11/5/1989",1989,"November","1980s",62,82,8
"5140","198911050gnb","Green Bay Packers",14,"Chicago Bears",13,27,1,TRUE,"11/5/1989",1989,"November","1980s",47,76,14
"5141","198911050oti","Houston Oilers",35,"Detroit Lions",31,66,4,TRUE,"11/5/1989",1989,"November","1980s",72,NA,NA
"5142","198911050tam","Tampa Bay Buccaneers",31,"Cleveland Browns",42,73,-11,FALSE,"11/5/1989",1989,"November","1980s",71,71,6
"5143","198911050min","Minnesota Vikings",23,"Los Angeles Rams",21,44,2,TRUE,"11/5/1989",1989,"November","1980s",72,NA,NA
"5144","198911050rai","Los Angeles Raiders",28,"Cincinnati Bengals",7,35,21,TRUE,"11/5/1989",1989,"November","1980s",63,78,10
"5145","198911050kan","Kansas City Chiefs",20,"Seattle Seahawks",10,30,10,TRUE,"11/5/1989",1989,"November","1980s",57,69,19
"5146","198911050nwe","New England Patriots",26,"New York Jets",27,53,-1,FALSE,"11/5/1989",1989,"November","1980s",43,54,10
"5147","198911050den","Denver Broncos",34,"Pittsburgh Steelers",7,41,27,TRUE,"11/5/1989",1989,"November","1980s",48,46,17
"5148","198911050mia","Miami Dolphins",19,"Indianapolis Colts",13,32,6,TRUE,"11/5/1989",1989,"November","1980s",79,80,11
"5149","198911050was","Washington Redskins",3,"Dallas Cowboys",13,16,-10,FALSE,"11/5/1989",1989,"November","1980s",49,76,9
"5150","198911050crd","Phoenix Cardinals",13,"New York Giants",20,33,-7,FALSE,"11/5/1989",1989,"November","1980s",67,18,7
"5151","198911050atl","Atlanta Falcons",30,"Buffalo Bills",28,58,2,TRUE,"11/5/1989",1989,"November","1980s",56,51,7
"5152","198911060sfo","San Francisco 49ers",31,"New Orleans Saints",13,44,18,TRUE,"11/6/1989",1989,"November","1980s",53,83,11
"5153","198911120det","Detroit Lions",31,"Green Bay Packers",22,53,9,TRUE,"11/12/1989",1989,"November","1980s",72,NA,NA
"5154","198911120sfo","San Francisco 49ers",45,"Atlanta Falcons",3,48,42,TRUE,"11/12/1989",1989,"November","1980s",55,87,14
"5155","198911120sdg","San Diego Chargers",14,"Los Angeles Raiders",12,26,2,TRUE,"11/12/1989",1989,"November","1980s",64,80,9
"5156","198911120nwe","New England Patriots",24,"New Orleans Saints",28,52,-4,FALSE,"11/12/1989",1989,"November","1980s",47,44,22
"5157","198911120nyj","New York Jets",23,"Miami Dolphins",31,54,-8,FALSE,"11/12/1989",1989,"November","1980s",52,44,20
"5158","198911120phi","Philadelphia Eagles",3,"Washington Redskins",10,13,-7,FALSE,"11/12/1989",1989,"November","1980s",53,65,14
"5159","198911120pit","Pittsburgh Steelers",0,"Chicago Bears",20,20,-20,FALSE,"11/12/1989",1989,"November","1980s",44,50,12
"5160","198911120buf","Buffalo Bills",30,"Indianapolis Colts",7,37,23,TRUE,"11/12/1989",1989,"November","1980s",38,60,19
"5161","198911120ram","Los Angeles Rams",31,"New York Giants",10,41,21,TRUE,"11/12/1989",1989,"November","1980s",60,84,7
"5162","198911120crd","Phoenix Cardinals",24,"Dallas Cowboys",20,44,4,TRUE,"11/12/1989",1989,"November","1980s",70,23,6
"5163","198911120tam","Tampa Bay Buccaneers",10,"Minnesota Vikings",24,34,-14,FALSE,"11/12/1989",1989,"November","1980s",68,66,8
"5164","198911120kan","Kansas City Chiefs",13,"Denver Broncos",16,29,-3,FALSE,"11/12/1989",1989,"November","1980s",53,57,12
"5165","198911120sea","Seattle Seahawks",7,"Cleveland Browns",17,24,-10,FALSE,"11/12/1989",1989,"November","1980s",72,NA,NA
"5166","198911130oti","Houston Oilers",26,"Cincinnati Bengals",24,50,2,TRUE,"11/13/1989",1989,"November","1980s",72,NA,NA
"5167","198911190dal","Dallas Cowboys",14,"Miami Dolphins",17,31,-3,FALSE,"11/19/1989",1989,"November","1980s",55,77,9
"5168","198911190atl","Atlanta Falcons",17,"New Orleans Saints",26,43,-9,FALSE,"11/19/1989",1989,"November","1980s",49,48,8
"5169","198911190clt","Indianapolis Colts",27,"New York Jets",10,37,17,TRUE,"11/19/1989",1989,"November","1980s",72,NA,NA
"5170","198911190pit","Pittsburgh Steelers",20,"San Diego Chargers",17,37,3,TRUE,"11/19/1989",1989,"November","1980s",28,60,12
"5171","198911190ram","Los Angeles Rams",37,"Phoenix Cardinals",14,51,23,TRUE,"11/19/1989",1989,"November","1980s",72,21,6
"5172","198911190chi","Chicago Bears",31,"Tampa Bay Buccaneers",32,63,-1,FALSE,"11/19/1989",1989,"November","1980s",33,63,15
"5173","198911190nyg","New York Giants",15,"Seattle Seahawks",3,18,12,TRUE,"11/19/1989",1989,"November","1980s",35,47,17
"5174","198911190phi","Philadelphia Eagles",10,"Minnesota Vikings",9,19,1,TRUE,"11/19/1989",1989,"November","1980s",33,69,12
"5175","198911190cin","Cincinnati Bengals",42,"Detroit Lions",7,49,35,TRUE,"11/19/1989",1989,"November","1980s",33,55,12
"5176","198911190nwe","New England Patriots",33,"Buffalo Bills",24,57,9,TRUE,"11/19/1989",1989,"November","1980s",34,46,14
"5177","198911190sfo","San Francisco 49ers",17,"Green Bay Packers",21,38,-4,FALSE,"11/19/1989",1989,"November","1980s",59,70,4
"5178","198911190cle","Cleveland Browns",10,"Kansas City Chiefs",10,20,0,FALSE,"11/19/1989",1989,"November","1980s",30,64,14
"5179","198911190oti","Houston Oilers",23,"Los Angeles Raiders",7,30,16,TRUE,"11/19/1989",1989,"November","1980s",72,NA,NA
"5180","198911200was","Washington Redskins",10,"Denver Broncos",14,24,-4,FALSE,"11/20/1989",1989,"November","1980s",51,43,15
"5181","198911230dal","Dallas Cowboys",0,"Philadelphia Eagles",27,27,-27,FALSE,"11/23/1989",1989,"November","1980s",42,50,14
"5182","198911230det","Detroit Lions",13,"Cleveland Browns",10,23,3,TRUE,"11/23/1989",1989,"November","1980s",72,NA,NA
"5183","198911260mia","Miami Dolphins",14,"Pittsburgh Steelers",34,48,-20,FALSE,"11/26/1989",1989,"November","1980s",77,86,10
"5184","198911260nyj","New York Jets",27,"Atlanta Falcons",7,34,20,TRUE,"11/26/1989",1989,"November","1980s",45,68,14
"5185","198911260was","Washington Redskins",38,"Chicago Bears",14,52,24,TRUE,"11/26/1989",1989,"November","1980s",48,66,11
"5186","198911260den","Denver Broncos",41,"Seattle Seahawks",14,55,27,TRUE,"11/26/1989",1989,"November","1980s",40,60,11
"5187","198911260crd","Phoenix Cardinals",13,"Tampa Bay Buccaneers",14,27,-1,FALSE,"11/26/1989",1989,"November","1980s",63,60,7
"5188","198911260rai","Los Angeles Raiders",24,"New England Patriots",21,45,3,TRUE,"11/26/1989",1989,"November","1980s",61,77,10
"5189","198911260clt","Indianapolis Colts",10,"San Diego Chargers",6,16,4,TRUE,"11/26/1989",1989,"November","1980s",72,NA,NA
"5190","198911260nor","New Orleans Saints",17,"Los Angeles Rams",20,37,-3,FALSE,"11/26/1989",1989,"November","1980s",72,NA,NA
"5191","198911260buf","Buffalo Bills",24,"Cincinnati Bengals",7,31,17,TRUE,"11/26/1989",1989,"November","1980s",41,81,18
"5192","198911260gnb","Green Bay Packers",20,"Minnesota Vikings",19,39,1,TRUE,"11/26/1989",1989,"November","1980s",36,71,9
"5193","198911260kan","Kansas City Chiefs",34,"Houston Oilers",0,34,34,TRUE,"11/26/1989",1989,"November","1980s",42,67,10
"5194","198911270sfo","San Francisco 49ers",34,"New York Giants",24,58,10,TRUE,"11/27/1989",1989,"November","1980s",51,70,12
"5195","198912030rai","Los Angeles Raiders",16,"Denver Broncos",13,29,3,TRUE,"12/3/1989",1989,"December","1980s",66,19,8
"5196","198912030cle","Cleveland Browns",0,"Cincinnati Bengals",21,21,-21,FALSE,"12/3/1989",1989,"December","1980s",24,69,17
"5197","198912030crd","Phoenix Cardinals",10,"Washington Redskins",29,39,-19,FALSE,"12/3/1989",1989,"December","1980s",63,24,12
"5198","198912030dal","Dallas Cowboys",31,"Los Angeles Rams",35,66,-4,FALSE,"12/3/1989",1989,"December","1980s",44,31,13
"5199","198912030tam","Tampa Bay Buccaneers",16,"Green Bay Packers",17,33,-1,FALSE,"12/3/1989",1989,"December","1980s",59,56,12
"5200","198912030sdg","San Diego Chargers",17,"New York Jets",20,37,-3,FALSE,"12/3/1989",1989,"December","1980s",65,19,9
"5201","198912030nwe","New England Patriots",22,"Indianapolis Colts",16,38,6,TRUE,"12/3/1989",1989,"December","1980s",30,70,17
"5202","198912030det","Detroit Lions",21,"New Orleans Saints",14,35,7,TRUE,"12/3/1989",1989,"December","1980s",72,NA,NA
"5203","198912030pit","Pittsburgh Steelers",16,"Houston Oilers",23,39,-7,FALSE,"12/3/1989",1989,"December","1980s",24,76,23
"5204","198912030nyg","New York Giants",17,"Philadelphia Eagles",24,41,-7,FALSE,"12/3/1989",1989,"December","1980s",35,56,26
"5205","198912030kan","Kansas City Chiefs",26,"Miami Dolphins",21,47,5,TRUE,"12/3/1989",1989,"December","1980s",21,47,13
"5206","198912030atl","Atlanta Falcons",10,"San Francisco 49ers",23,33,-13,FALSE,"12/3/1989",1989,"December","1980s",39,38,19
"5207","198912030min","Minnesota Vikings",27,"Chicago Bears",16,43,11,TRUE,"12/3/1989",1989,"December","1980s",72,NA,NA
"5208","198912040sea","Seattle Seahawks",17,"Buffalo Bills",16,33,1,TRUE,"12/4/1989",1989,"December","1980s",72,NA,NA
"5209","198912100min","Minnesota Vikings",43,"Atlanta Falcons",17,60,26,TRUE,"12/10/1989",1989,"December","1980s",72,NA,NA
"5210","198912100nyj","New York Jets",0,"Pittsburgh Steelers",13,13,-13,FALSE,"12/10/1989",1989,"December","1980s",27,42,12
"5211","198912100was","Washington Redskins",26,"San Diego Chargers",21,47,5,TRUE,"12/10/1989",1989,"December","1980s",27,55,12
"5212","198912100oti","Houston Oilers",20,"Tampa Bay Buccaneers",17,37,3,TRUE,"12/10/1989",1989,"December","1980s",72,NA,NA
"5213","198912100buf","Buffalo Bills",19,"New Orleans Saints",22,41,-3,FALSE,"12/10/1989",1989,"December","1980s",26,68,13
"5214","198912100phi","Philadelphia Eagles",20,"Dallas Cowboys",10,30,10,TRUE,"12/10/1989",1989,"December","1980s",24,56,9
"5215","198912100clt","Indianapolis Colts",23,"Cleveland Browns",17,40,6,TRUE,"12/10/1989",1989,"December","1980s",72,NA,NA
"5216","198912100den","Denver Broncos",7,"New York Giants",14,21,-7,FALSE,"12/10/1989",1989,"December","1980s",31,70,12
"5217","198912100cin","Cincinnati Bengals",17,"Seattle Seahawks",24,41,-7,FALSE,"12/10/1989",1989,"December","1980s",28,89,11
"5218","198912100gnb","Green Bay Packers",3,"Kansas City Chiefs",21,24,-18,FALSE,"12/10/1989",1989,"December","1980s",26,61,11
"5219","198912100mia","Miami Dolphins",31,"New England Patriots",10,41,21,TRUE,"12/10/1989",1989,"December","1980s",60,73,12
"5220","198912100chi","Chicago Bears",17,"Detroit Lions",27,44,-10,FALSE,"12/10/1989",1989,"December","1980s",32,66,11
"5221","198912100rai","Los Angeles Raiders",16,"Phoenix Cardinals",14,30,2,TRUE,"12/10/1989",1989,"December","1980s",57,85,8
"5222","198912110ram","Los Angeles Rams",27,"San Francisco 49ers",30,57,-3,FALSE,"12/11/1989",1989,"December","1980s",56,61,8
"5223","198912160crd","Phoenix Cardinals",0,"Denver Broncos",37,37,-37,FALSE,"12/16/1989",1989,"December","1980s",53,25,4
"5224","198912160nyg","New York Giants",15,"Dallas Cowboys",0,15,15,TRUE,"12/16/1989",1989,"December","1980s",27,57,24
"5225","198912170chi","Chicago Bears",28,"Green Bay Packers",40,68,-12,FALSE,"12/17/1989",1989,"December","1980s",8,73,11
"5226","198912170det","Detroit Lions",33,"Tampa Bay Buccaneers",7,40,26,TRUE,"12/17/1989",1989,"December","1980s",72,NA,NA
"5227","198912170cle","Cleveland Browns",23,"Minnesota Vikings",17,40,6,TRUE,"12/17/1989",1989,"December","1980s",2,71,12
"5228","198912170pit","Pittsburgh Steelers",28,"New England Patriots",10,38,18,TRUE,"12/17/1989",1989,"December","1980s",3,74,10
"5229","198912170atl","Atlanta Falcons",30,"Washington Redskins",31,61,-1,FALSE,"12/17/1989",1989,"December","1980s",27,44,8
"5230","198912170sea","Seattle Seahawks",23,"Los Angeles Raiders",17,40,6,TRUE,"12/17/1989",1989,"December","1980s",72,NA,NA
"5231","198912170ram","Los Angeles Rams",38,"New York Jets",14,52,24,TRUE,"12/17/1989",1989,"December","1980s",55,76,7
"5232","198912170clt","Indianapolis Colts",42,"Miami Dolphins",13,55,29,TRUE,"12/17/1989",1989,"December","1980s",72,NA,NA
"5233","198912170kan","Kansas City Chiefs",13,"San Diego Chargers",20,33,-7,FALSE,"12/17/1989",1989,"December","1980s",11,67,11
"5234","198912170sfo","San Francisco 49ers",21,"Buffalo Bills",10,31,11,TRUE,"12/17/1989",1989,"December","1980s",47,80,8
"5235","198912170cin","Cincinnati Bengals",61,"Houston Oilers",7,68,54,TRUE,"12/17/1989",1989,"December","1980s",1,69,6
"5236","198912180nor","New Orleans Saints",30,"Philadelphia Eagles",20,50,10,TRUE,"12/18/1989",1989,"December","1980s",72,NA,NA
"5237","198912230sea","Seattle Seahawks",0,"Washington Redskins",29,29,-29,FALSE,"12/23/1989",1989,"December","1980s",72,NA,NA
"5238","198912230oti","Houston Oilers",20,"Cleveland Browns",24,44,-4,FALSE,"12/23/1989",1989,"December","1980s",72,NA,NA
"5239","198912230nyj","New York Jets",0,"Buffalo Bills",37,37,-37,FALSE,"12/23/1989",1989,"December","1980s",12,52,18
"5240","198912240phi","Philadelphia Eagles",31,"Phoenix Cardinals",14,45,17,TRUE,"12/24/1989",1989,"December","1980s",14,54,12
"5241","198912240dal","Dallas Cowboys",10,"Green Bay Packers",20,30,-10,FALSE,"12/24/1989",1989,"December","1980s",23,32,11
"5242","198912240tam","Tampa Bay Buccaneers",22,"Pittsburgh Steelers",31,53,-9,FALSE,"12/24/1989",1989,"December","1980s",31,58,18
"5243","198912240mia","Miami Dolphins",24,"Kansas City Chiefs",27,51,-3,FALSE,"12/24/1989",1989,"December","1980s",38,62,20
"5244","198912240nwe","New England Patriots",20,"Los Angeles Rams",24,44,-4,FALSE,"12/24/1989",1989,"December","1980s",12,48,15
"5245","198912240sdg","San Diego Chargers",19,"Denver Broncos",16,35,3,TRUE,"12/24/1989",1989,"December","1980s",63,30,7
"5246","198912240sfo","San Francisco 49ers",26,"Chicago Bears",0,26,26,TRUE,"12/24/1989",1989,"December","1980s",46,83,8
"5247","198912240nyg","New York Giants",34,"Los Angeles Raiders",17,51,17,TRUE,"12/24/1989",1989,"December","1980s",14,50,17
"5248","198912240nor","New Orleans Saints",41,"Indianapolis Colts",6,47,35,TRUE,"12/24/1989",1989,"December","1980s",72,NA,NA
"5249","198912240atl","Atlanta Falcons",24,"Detroit Lions",31,55,-7,FALSE,"12/24/1989",1989,"December","1980s",17,46,15
"5250","198912250min","Minnesota Vikings",29,"Cincinnati Bengals",21,50,8,TRUE,"12/25/1989",1989,"December","1980s",72,NA,NA
"5251","198912310phi","Philadelphia Eagles",7,"Los Angeles Rams",21,28,-14,FALSE,"12/31/1989",1989,"December","1980s",34,94,8
"5252","198912310oti","Houston Oilers",23,"Pittsburgh Steelers",26,49,-3,FALSE,"12/31/1989",1989,"December","1980s",72,NA,NA
"5253","199001060sfo","San Francisco 49ers",41,"Minnesota Vikings",13,54,28,TRUE,"1/6/1990",1990,"January","1990s",48,94,8
"5254","199001060cle","Cleveland Browns",34,"Buffalo Bills",30,64,4,TRUE,"1/6/1990",1990,"January","1990s",28,88,7
"5255","199001070den","Denver Broncos",24,"Pittsburgh Steelers",23,47,1,TRUE,"1/7/1990",1990,"January","1990s",37,36,8
"5256","199001070nyg","New York Giants",13,"Los Angeles Rams",19,32,-6,FALSE,"1/7/1990",1990,"January","1990s",37,52,14
"5257","199001140den","Denver Broncos",37,"Cleveland Browns",21,58,16,TRUE,"1/14/1990",1990,"January","1990s",47,34,13
"5258","199001140sfo","San Francisco 49ers",30,"Los Angeles Rams",3,33,27,TRUE,"1/14/1990",1990,"January","1990s",52,91,14
"5259","199001280den","Denver Broncos",10,"San Francisco 49ers",55,65,-45,FALSE,"1/28/1990",1990,"January","1990s",72,NA,NA
"5260","199009090atl","Atlanta Falcons",47,"Houston Oilers",27,74,20,TRUE,"9/9/1990",1990,"September","1990s",79,70,10
"5261","199009090was","Washington Redskins",31,"Phoenix Cardinals",0,31,31,TRUE,"9/9/1990",1990,"September","1990s",68,75,9
"5262","199009090chi","Chicago Bears",17,"Seattle Seahawks",0,17,17,TRUE,"9/9/1990",1990,"September","1990s",73,78,7
"5263","199009090gnb","Green Bay Packers",36,"Los Angeles Rams",24,60,12,TRUE,"9/9/1990",1990,"September","1990s",68,83,8
"5264","199009090nwe","New England Patriots",24,"Miami Dolphins",27,51,-3,FALSE,"9/9/1990",1990,"September","1990s",58,65,13
"5265","199009090nyg","New York Giants",27,"Philadelphia Eagles",20,47,7,TRUE,"9/9/1990",1990,"September","1990s",64,61,6
"5266","199009090kan","Kansas City Chiefs",24,"Minnesota Vikings",21,45,3,TRUE,"9/9/1990",1990,"September","1990s",78,71,6
"5267","199009090cin","Cincinnati Bengals",25,"New York Jets",20,45,5,TRUE,"9/9/1990",1990,"September","1990s",72,91,9
"5268","199009090buf","Buffalo Bills",26,"Indianapolis Colts",10,36,16,TRUE,"9/9/1990",1990,"September","1990s",59,83,7
"5269","199009090det","Detroit Lions",21,"Tampa Bay Buccaneers",38,59,-17,FALSE,"9/9/1990",1990,"September","1990s",72,NA,NA
"5270","199009090cle","Cleveland Browns",13,"Pittsburgh Steelers",3,16,10,TRUE,"9/9/1990",1990,"September","1990s",68,79,8
"5271","199009090dal","Dallas Cowboys",17,"San Diego Chargers",14,31,3,TRUE,"9/9/1990",1990,"September","1990s",76,87,6
"5272","199009090rai","Los Angeles Raiders",14,"Denver Broncos",9,23,5,TRUE,"9/9/1990",1990,"September","1990s",75,64,7
"5273","199009100nor","New Orleans Saints",12,"San Francisco 49ers",13,25,-1,FALSE,"9/10/1990",1990,"September","1990s",72,NA,NA
"5274","199009160nyj","New York Jets",24,"Cleveland Browns",21,45,3,TRUE,"9/16/1990",1990,"September","1990s",67,57,12
"5275","199009160dal","Dallas Cowboys",7,"New York Giants",28,35,-21,FALSE,"9/16/1990",1990,"September","1990s",84,58,5
"5276","199009160phi","Philadelphia Eagles",21,"Phoenix Cardinals",23,44,-2,FALSE,"9/16/1990",1990,"September","1990s",64,68,9
"5277","199009160pit","Pittsburgh Steelers",20,"Houston Oilers",9,29,11,TRUE,"9/16/1990",1990,"September","1990s",57,86,12
"5278","199009160min","Minnesota Vikings",32,"New Orleans Saints",3,35,29,TRUE,"9/16/1990",1990,"September","1990s",72,NA,NA
"5279","199009160sdg","San Diego Chargers",16,"Cincinnati Bengals",21,37,-5,FALSE,"9/16/1990",1990,"September","1990s",70,77,8
"5280","199009160clt","Indianapolis Colts",14,"New England Patriots",16,30,-2,FALSE,"9/16/1990",1990,"September","1990s",72,NA,NA
"5281","199009160gnb","Green Bay Packers",13,"Chicago Bears",31,44,-18,FALSE,"9/16/1990",1990,"September","1990s",54,78,13
"5282","199009160sfo","San Francisco 49ers",26,"Washington Redskins",13,39,13,TRUE,"9/16/1990",1990,"September","1990s",63,71,16
"5283","199009160mia","Miami Dolphins",30,"Buffalo Bills",7,37,23,TRUE,"9/16/1990",1990,"September","1990s",82,76,7
"5284","199009160det","Detroit Lions",21,"Atlanta Falcons",14,35,7,TRUE,"9/16/1990",1990,"September","1990s",72,NA,NA
"5285","199009160sea","Seattle Seahawks",13,"Los Angeles Raiders",17,30,-4,FALSE,"9/16/1990",1990,"September","1990s",72,NA,NA
"5286","199009160tam","Tampa Bay Buccaneers",14,"Los Angeles Rams",35,49,-21,FALSE,"9/16/1990",1990,"September","1990s",83,79,9
"5287","199009170den","Denver Broncos",24,"Kansas City Chiefs",23,47,1,TRUE,"9/17/1990",1990,"September","1990s",62,65,12
"5288","199009230cle","Cleveland Browns",14,"San Diego Chargers",24,38,-10,FALSE,"9/23/1990",1990,"September","1990s",49,84,12
"5289","199009230den","Denver Broncos",34,"Seattle Seahawks",31,65,3,TRUE,"9/23/1990",1990,"September","1990s",58,46,6
"5290","199009230tam","Tampa Bay Buccaneers",23,"Detroit Lions",20,43,3,TRUE,"9/23/1990",1990,"September","1990s",85,73,11
"5291","199009230oti","Houston Oilers",24,"Indianapolis Colts",10,34,14,TRUE,"9/23/1990",1990,"September","1990s",72,NA,NA
"5292","199009230chi","Chicago Bears",19,"Minnesota Vikings",16,35,3,TRUE,"9/23/1990",1990,"September","1990s",50,63,18
"5293","199009230gnb","Green Bay Packers",3,"Kansas City Chiefs",17,20,-14,FALSE,"9/23/1990",1990,"September","1990s",47,63,12
"5294","199009230cin","Cincinnati Bengals",41,"New England Patriots",7,48,34,TRUE,"9/23/1990",1990,"September","1990s",52,72,14
"5295","199009230was","Washington Redskins",19,"Dallas Cowboys",15,34,4,TRUE,"9/23/1990",1990,"September","1990s",63,58,13
"5296","199009230sfo","San Francisco 49ers",19,"Atlanta Falcons",13,32,6,TRUE,"9/23/1990",1990,"September","1990s",66,82,12
"5297","199009230nyg","New York Giants",20,"Miami Dolphins",3,23,17,TRUE,"9/23/1990",1990,"September","1990s",63,66,17
"5298","199009230rai","Los Angeles Raiders",20,"Pittsburgh Steelers",3,23,17,TRUE,"9/23/1990",1990,"September","1990s",69,77,11
"5299","199009230ram","Los Angeles Rams",21,"Philadelphia Eagles",27,48,-6,FALSE,"9/23/1990",1990,"September","1990s",69,77,11
"5300","199009230nor","New Orleans Saints",28,"Phoenix Cardinals",7,35,21,TRUE,"9/23/1990",1990,"September","1990s",72,NA,NA
"5301","199009240nyj","New York Jets",7,"Buffalo Bills",30,37,-23,FALSE,"9/24/1990",1990,"September","1990s",57,58,17
"5302","199009300pit","Pittsburgh Steelers",6,"Miami Dolphins",28,34,-22,FALSE,"9/30/1990",1990,"September","1990s",62,84,12
"5303","199009300sdg","San Diego Chargers",7,"Houston Oilers",17,24,-10,FALSE,"9/30/1990",1990,"September","1990s",70,77,9
"5304","199009300kan","Kansas City Chiefs",34,"Cleveland Browns",0,34,34,TRUE,"9/30/1990",1990,"September","1990s",56,74,7
"5305","199009300rai","Los Angeles Raiders",24,"Chicago Bears",10,34,14,TRUE,"9/30/1990",1990,"September","1990s",68,85,11
"5306","199009300nwe","New England Patriots",13,"New York Jets",37,50,-24,FALSE,"9/30/1990",1990,"September","1990s",67,82,13
"5307","199009300det","Detroit Lions",21,"Green Bay Packers",24,45,-3,FALSE,"9/30/1990",1990,"September","1990s",72,NA,NA
"5308","199009300crd","Phoenix Cardinals",10,"Washington Redskins",38,48,-28,FALSE,"9/30/1990",1990,"September","1990s",78,30,9
"5309","199009300buf","Buffalo Bills",29,"Denver Broncos",28,57,1,TRUE,"9/30/1990",1990,"September","1990s",58,91,12
"5310","199009300nyg","New York Giants",31,"Dallas Cowboys",17,48,14,TRUE,"9/30/1990",1990,"September","1990s",69,80,13
"5311","199009300phi","Philadelphia Eagles",23,"Indianapolis Colts",24,47,-1,FALSE,"9/30/1990",1990,"September","1990s",69,90,10
"5312","199009300min","Minnesota Vikings",20,"Tampa Bay Buccaneers",23,43,-3,FALSE,"9/30/1990",1990,"September","1990s",72,NA,NA
"5313","199010010sea","Seattle Seahawks",31,"Cincinnati Bengals",16,47,15,TRUE,"10/1/1990",1990,"October","1990s",72,NA,NA
"5314","199010070atl","Atlanta Falcons",28,"New Orleans Saints",27,55,1,TRUE,"10/7/1990",1990,"October","1990s",72,64,10
"5315","199010070ram","Los Angeles Rams",31,"Cincinnati Bengals",34,65,-3,FALSE,"10/7/1990",1990,"October","1990s",68,67,10
"5316","199010070mia","Miami Dolphins",20,"New York Jets",16,36,4,TRUE,"10/7/1990",1990,"October","1990s",82,70,13
"5317","199010070min","Minnesota Vikings",27,"Detroit Lions",34,61,-7,FALSE,"10/7/1990",1990,"October","1990s",72,NA,NA
"5318","199010070buf","Buffalo Bills",38,"Los Angeles Raiders",24,62,14,TRUE,"10/7/1990",1990,"October","1990s",71,53,16
"5319","199010070oti","Houston Oilers",21,"San Francisco 49ers",24,45,-3,FALSE,"10/7/1990",1990,"October","1990s",72,NA,NA
"5320","199010070pit","Pittsburgh Steelers",36,"San Diego Chargers",14,50,22,TRUE,"10/7/1990",1990,"October","1990s",66,66,11
"5321","199010070clt","Indianapolis Colts",23,"Kansas City Chiefs",19,42,4,TRUE,"10/7/1990",1990,"October","1990s",72,NA,NA
"5322","199010070chi","Chicago Bears",27,"Green Bay Packers",13,40,14,TRUE,"10/7/1990",1990,"October","1990s",58,79,17
"5323","199010070dal","Dallas Cowboys",14,"Tampa Bay Buccaneers",10,24,4,TRUE,"10/7/1990",1990,"October","1990s",83,66,15
"5324","199010070nwe","New England Patriots",20,"Seattle Seahawks",33,53,-13,FALSE,"10/7/1990",1990,"October","1990s",72,60,15
"5325","199010080den","Denver Broncos",29,"Cleveland Browns",30,59,-1,FALSE,"10/8/1990",1990,"October","1990s",32,86,10
"5326","199010140crd","Phoenix Cardinals",20,"Dallas Cowboys",3,23,17,TRUE,"10/14/1990",1990,"October","1990s",77,18,5
"5327","199010140atl","Atlanta Falcons",35,"San Francisco 49ers",45,80,-10,FALSE,"10/14/1990",1990,"October","1990s",63,75,7
"5328","199010140was","Washington Redskins",20,"New York Giants",24,44,-4,FALSE,"10/14/1990",1990,"October","1990s",74,68,11
"5329","199010140nor","New Orleans Saints",25,"Cleveland Browns",20,45,5,TRUE,"10/14/1990",1990,"October","1990s",72,NA,NA
"5330","199010140tam","Tampa Bay Buccaneers",26,"Green Bay Packers",14,40,12,TRUE,"10/14/1990",1990,"October","1990s",78,74,6
"5331","199010140chi","Chicago Bears",38,"Los Angeles Rams",9,47,29,TRUE,"10/14/1990",1990,"October","1990s",55,76,12
"5332","199010140kan","Kansas City Chiefs",43,"Detroit Lions",24,67,19,TRUE,"10/14/1990",1990,"October","1990s",62,57,15
"5333","199010140den","Denver Broncos",17,"Pittsburgh Steelers",34,51,-17,FALSE,"10/14/1990",1990,"October","1990s",50,42,10
"5334","199010140nyj","New York Jets",3,"San Diego Chargers",39,42,-36,FALSE,"10/14/1990",1990,"October","1990s",73,81,11
"5335","199010140oti","Houston Oilers",48,"Cincinnati Bengals",17,65,31,TRUE,"10/14/1990",1990,"October","1990s",72,NA,NA
"5336","199010140rai","Los Angeles Raiders",24,"Seattle Seahawks",17,41,7,TRUE,"10/14/1990",1990,"October","1990s",66,77,7
"5337","199010150phi","Philadelphia Eagles",32,"Minnesota Vikings",24,56,8,TRUE,"10/15/1990",1990,"October","1990s",70,70,12
"5338","199010180mia","Miami Dolphins",17,"New England Patriots",10,27,7,TRUE,"10/18/1990",1990,"October","1990s",82,70,5
"5339","199010210was","Washington Redskins",13,"Philadelphia Eagles",7,20,6,TRUE,"10/21/1990",1990,"October","1990s",55,75,9
"5340","199010210nyg","New York Giants",20,"Phoenix Cardinals",19,39,1,TRUE,"10/21/1990",1990,"October","1990s",57,62,10
"5341","199010210ram","Los Angeles Rams",44,"Atlanta Falcons",24,68,20,TRUE,"10/21/1990",1990,"October","1990s",70,32,9
"5342","199010210clt","Indianapolis Colts",17,"Denver Broncos",27,44,-10,FALSE,"10/21/1990",1990,"October","1990s",72,NA,NA
"5343","199010210buf","Buffalo Bills",30,"New York Jets",27,57,3,TRUE,"10/21/1990",1990,"October","1990s",53,53,12
"5344","199010210oti","Houston Oilers",23,"New Orleans Saints",10,33,13,TRUE,"10/21/1990",1990,"October","1990s",72,NA,NA
"5345","199010210sdg","San Diego Chargers",9,"Los Angeles Raiders",24,33,-15,FALSE,"10/21/1990",1990,"October","1990s",68,35,10
"5346","199010210sea","Seattle Seahawks",19,"Kansas City Chiefs",7,26,12,TRUE,"10/21/1990",1990,"October","1990s",72,NA,NA
"5347","199010210sfo","San Francisco 49ers",27,"Pittsburgh Steelers",7,34,20,TRUE,"10/21/1990",1990,"October","1990s",59,57,10
"5348","199010210tam","Tampa Bay Buccaneers",13,"Dallas Cowboys",17,30,-4,FALSE,"10/21/1990",1990,"October","1990s",79,78,7
"5349","199010220cle","Cleveland Browns",13,"Cincinnati Bengals",34,47,-21,FALSE,"10/22/1990",1990,"October","1990s",55,88,8
"5350","199010280gnb","Green Bay Packers",24,"Minnesota Vikings",10,34,14,TRUE,"10/28/1990",1990,"October","1990s",43,59,15
"5351","199010280nyg","New York Giants",21,"Washington Redskins",10,31,11,TRUE,"10/28/1990",1990,"October","1990s",50,53,12
"5352","199010280crd","Phoenix Cardinals",21,"Chicago Bears",31,52,-10,FALSE,"10/28/1990",1990,"October","1990s",80,21,8
"5353","199010280nwe","New England Patriots",10,"Buffalo Bills",27,37,-17,FALSE,"10/28/1990",1990,"October","1990s",45,64,12
"5354","199010280clt","Indianapolis Colts",7,"Miami Dolphins",27,34,-20,FALSE,"10/28/1990",1990,"October","1990s",72,NA,NA
"5355","199010280atl","Atlanta Falcons",38,"Cincinnati Bengals",17,55,21,TRUE,"10/28/1990",1990,"October","1990s",56,46,12
"5356","199010280nor","New Orleans Saints",10,"Detroit Lions",27,37,-17,FALSE,"10/28/1990",1990,"October","1990s",72,NA,NA
"5357","199010280dal","Dallas Cowboys",20,"Philadelphia Eagles",21,41,-1,FALSE,"10/28/1990",1990,"October","1990s",66,65,6
"5358","199010280oti","Houston Oilers",12,"New York Jets",17,29,-5,FALSE,"10/28/1990",1990,"October","1990s",72,NA,NA
"5359","199010280sdg","San Diego Chargers",41,"Tampa Bay Buccaneers",10,51,31,TRUE,"10/28/1990",1990,"October","1990s",63,88,8
"5360","199010280sfo","San Francisco 49ers",20,"Cleveland Browns",17,37,3,TRUE,"10/28/1990",1990,"October","1990s",59,76,11
"5361","199010290pit","Pittsburgh Steelers",41,"Los Angeles Rams",10,51,31,TRUE,"10/29/1990",1990,"October","1990s",42,54,10
"5362","199011040det","Detroit Lions",38,"Washington Redskins",41,79,-3,FALSE,"11/4/1990",1990,"November","1990s",72,NA,NA
"5363","199011040pit","Pittsburgh Steelers",21,"Atlanta Falcons",9,30,12,TRUE,"11/4/1990",1990,"November","1990s",58,60,8
"5364","199011040min","Minnesota Vikings",27,"Denver Broncos",22,49,5,TRUE,"11/4/1990",1990,"November","1990s",72,NA,NA
"5365","199011040cle","Cleveland Browns",0,"Buffalo Bills",42,42,-42,FALSE,"11/4/1990",1990,"November","1990s",58,68,12
"5366","199011040tam","Tampa Bay Buccaneers",6,"Chicago Bears",26,32,-20,FALSE,"11/4/1990",1990,"November","1990s",74,72,8
"5367","199011040gnb","Green Bay Packers",20,"San Francisco 49ers",24,44,-4,FALSE,"11/4/1990",1990,"November","1990s",38,77,10
"5368","199011040phi","Philadelphia Eagles",48,"New England Patriots",20,68,28,TRUE,"11/4/1990",1990,"November","1990s",60,78,8
"5369","199011040kan","Kansas City Chiefs",9,"Los Angeles Raiders",7,16,2,TRUE,"11/4/1990",1990,"November","1990s",36,89,22
"5370","199011040mia","Miami Dolphins",23,"Phoenix Cardinals",3,26,20,TRUE,"11/4/1990",1990,"November","1990s",77,67,11
"5371","199011040sea","Seattle Seahawks",14,"San Diego Chargers",31,45,-17,FALSE,"11/4/1990",1990,"November","1990s",72,NA,NA
"5372","199011040nyj","New York Jets",24,"Dallas Cowboys",9,33,15,TRUE,"11/4/1990",1990,"November","1990s",67,50,11
"5373","199011040cin","Cincinnati Bengals",7,"New Orleans Saints",21,28,-14,FALSE,"11/4/1990",1990,"November","1990s",61,64,12
"5374","199011040ram","Los Angeles Rams",17,"Houston Oilers",13,30,4,TRUE,"11/4/1990",1990,"November","1990s",62,42,8
"5375","199011050clt","Indianapolis Colts",7,"New York Giants",24,31,-17,FALSE,"11/5/1990",1990,"November","1990s",72,NA,NA
"5376","199011110nyj","New York Jets",3,"Miami Dolphins",17,20,-14,FALSE,"11/11/1990",1990,"November","1990s",47,51,25
"5377","199011110ram","Los Angeles Rams",7,"New York Giants",31,38,-24,FALSE,"11/11/1990",1990,"November","1990s",70,32,8
"5378","199011110sdg","San Diego Chargers",19,"Denver Broncos",7,26,12,TRUE,"11/11/1990",1990,"November","1990s",69,39,5
"5379","199011110rai","Los Angeles Raiders",16,"Green Bay Packers",29,45,-13,FALSE,"11/11/1990",1990,"November","1990s",70,32,8
"5380","199011110nor","New Orleans Saints",35,"Tampa Bay Buccaneers",7,42,28,TRUE,"11/11/1990",1990,"November","1990s",72,NA,NA
"5381","199011110det","Detroit Lions",7,"Minnesota Vikings",17,24,-10,FALSE,"11/11/1990",1990,"November","1990s",72,NA,NA
"5382","199011110kan","Kansas City Chiefs",16,"Seattle Seahawks",17,33,-1,FALSE,"11/11/1990",1990,"November","1990s",50,64,11
"5383","199011110buf","Buffalo Bills",45,"Phoenix Cardinals",14,59,31,TRUE,"11/11/1990",1990,"November","1990s",37,66,27
"5384","199011110nwe","New England Patriots",10,"Indianapolis Colts",13,23,-3,FALSE,"11/11/1990",1990,"November","1990s",46,59,28
"5385","199011110chi","Chicago Bears",30,"Atlanta Falcons",24,54,6,TRUE,"11/11/1990",1990,"November","1990s",35,58,14
"5386","199011110dal","Dallas Cowboys",6,"San Francisco 49ers",24,30,-18,FALSE,"11/11/1990",1990,"November","1990s",58,57,8
"5387","199011120phi","Philadelphia Eagles",28,"Washington Redskins",14,42,14,TRUE,"11/12/1990",1990,"November","1990s",44,49,26
"5388","199011180cle","Cleveland Browns",23,"Houston Oilers",35,58,-12,FALSE,"11/18/1990",1990,"November","1990s",37,69,6
"5389","199011180crd","Phoenix Cardinals",21,"Green Bay Packers",24,45,-3,FALSE,"11/18/1990",1990,"November","1990s",70,35,5
"5390","199011180nyg","New York Giants",20,"Detroit Lions",0,20,20,TRUE,"11/18/1990",1990,"November","1990s",40,62,25
"5391","199011180cin","Cincinnati Bengals",27,"Pittsburgh Steelers",3,30,24,TRUE,"11/18/1990",1990,"November","1990s",39,66,8
"5392","199011180sea","Seattle Seahawks",21,"Minnesota Vikings",24,45,-3,FALSE,"11/18/1990",1990,"November","1990s",72,NA,NA
"5393","199011180clt","Indianapolis Colts",17,"New York Jets",14,31,3,TRUE,"11/18/1990",1990,"November","1990s",72,NA,NA
"5394","199011180was","Washington Redskins",31,"New Orleans Saints",17,48,14,TRUE,"11/18/1990",1990,"November","1990s",42,47,16
"5395","199011180buf","Buffalo Bills",14,"New England Patriots",0,14,14,TRUE,"11/18/1990",1990,"November","1990s",31,64,8
"5396","199011180den","Denver Broncos",13,"Chicago Bears",16,29,-3,FALSE,"11/18/1990",1990,"November","1990s",47,45,6
"5397","199011180kan","Kansas City Chiefs",27,"San Diego Chargers",10,37,17,TRUE,"11/18/1990",1990,"November","1990s",49,54,11
"5398","199011180sfo","San Francisco 49ers",31,"Tampa Bay Buccaneers",7,38,24,TRUE,"11/18/1990",1990,"November","1990s",55,85,11
"5399","199011180atl","Atlanta Falcons",23,"Philadelphia Eagles",24,47,-1,FALSE,"11/18/1990",1990,"November","1990s",49,50,8
"5400","199011180ram","Los Angeles Rams",21,"Dallas Cowboys",24,45,-3,FALSE,"11/18/1990",1990,"November","1990s",62,80,8
"5401","199011190mia","Miami Dolphins",10,"Los Angeles Raiders",13,23,-3,FALSE,"11/19/1990",1990,"November","1990s",70,61,8
"5402","199011220det","Detroit Lions",40,"Denver Broncos",27,67,13,TRUE,"11/22/1990",1990,"November","1990s",72,NA,NA
"5403","199011220dal","Dallas Cowboys",27,"Washington Redskins",17,44,10,TRUE,"11/22/1990",1990,"November","1990s",63,96,10
"5404","199011250gnb","Green Bay Packers",20,"Tampa Bay Buccaneers",10,30,10,TRUE,"11/25/1990",1990,"November","1990s",44,49,14
"5405","199011250min","Minnesota Vikings",41,"Chicago Bears",13,54,28,TRUE,"11/25/1990",1990,"November","1990s",72,NA,NA
"5406","199011250phi","Philadelphia Eagles",31,"New York Giants",13,44,18,TRUE,"11/25/1990",1990,"November","1990s",52,63,13
"5407","199011250rai","Los Angeles Raiders",24,"Kansas City Chiefs",27,51,-3,FALSE,"11/25/1990",1990,"November","1990s",60,86,7
"5408","199011250cle","Cleveland Browns",13,"Miami Dolphins",30,43,-17,FALSE,"11/25/1990",1990,"November","1990s",48,63,12
"5409","199011250sfo","San Francisco 49ers",17,"Los Angeles Rams",28,45,-11,FALSE,"11/25/1990",1990,"November","1990s",55,82,16
"5410","199011250crd","Phoenix Cardinals",34,"New England Patriots",14,48,20,TRUE,"11/25/1990",1990,"November","1990s",68,43,6
"5411","199011250nor","New Orleans Saints",10,"Atlanta Falcons",7,17,3,TRUE,"11/25/1990",1990,"November","1990s",72,NA,NA
"5412","199011250cin","Cincinnati Bengals",20,"Indianapolis Colts",34,54,-14,FALSE,"11/25/1990",1990,"November","1990s",56,56,11
"5413","199011250sdg","San Diego Chargers",10,"Seattle Seahawks",13,23,-3,FALSE,"11/25/1990",1990,"November","1990s",60,76,5
"5414","199011250nyj","New York Jets",7,"Pittsburgh Steelers",24,31,-17,FALSE,"11/25/1990",1990,"November","1990s",52,47,14
"5415","199011260oti","Houston Oilers",27,"Buffalo Bills",24,51,3,TRUE,"11/26/1990",1990,"November","1990s",72,NA,NA
"5416","199012020pit","Pittsburgh Steelers",12,"Cincinnati Bengals",16,28,-4,FALSE,"12/2/1990",1990,"December","1990s",44,50,7
"5417","199012020chi","Chicago Bears",23,"Detroit Lions",17,40,6,TRUE,"12/2/1990",1990,"December","1990s",34,58,16
"5418","199012020was","Washington Redskins",42,"Miami Dolphins",20,62,22,TRUE,"12/2/1990",1990,"December","1990s",47,59,8
"5419","199012020nwe","New England Patriots",7,"Kansas City Chiefs",37,44,-30,FALSE,"12/2/1990",1990,"December","1990s",48,42,13
"5420","199012020den","Denver Broncos",20,"Los Angeles Raiders",23,43,-3,FALSE,"12/2/1990",1990,"December","1990s",25,67,11
"5421","199012020tam","Tampa Bay Buccaneers",23,"Atlanta Falcons",17,40,6,TRUE,"12/2/1990",1990,"December","1990s",68,72,8
"5422","199012020crd","Phoenix Cardinals",20,"Indianapolis Colts",17,37,3,TRUE,"12/2/1990",1990,"December","1990s",56,40,5
"5423","199012020min","Minnesota Vikings",23,"Green Bay Packers",7,30,16,TRUE,"12/2/1990",1990,"December","1990s",72,NA,NA
"5424","199012020sea","Seattle Seahawks",13,"Houston Oilers",10,23,3,TRUE,"12/2/1990",1990,"December","1990s",72,NA,NA
"5425","199012020buf","Buffalo Bills",30,"Philadelphia Eagles",23,53,7,TRUE,"12/2/1990",1990,"December","1990s",42,62,16
"5426","199012020cle","Cleveland Browns",23,"Los Angeles Rams",38,61,-15,FALSE,"12/2/1990",1990,"December","1990s",42,65,10
"5427","199012020sdg","San Diego Chargers",38,"New York Jets",17,55,21,TRUE,"12/2/1990",1990,"December","1990s",58,57,7
"5428","199012020dal","Dallas Cowboys",17,"New Orleans Saints",13,30,4,TRUE,"12/2/1990",1990,"December","1990s",52,72,7
"5429","199012030sfo","San Francisco 49ers",7,"New York Giants",3,10,4,TRUE,"12/3/1990",1990,"December","1990s",49,60,3
"5430","199012090ram","Los Angeles Rams",20,"New Orleans Saints",24,44,-4,FALSE,"12/9/1990",1990,"December","1990s",64,21,8
"5431","199012090atl","Atlanta Falcons",13,"Phoenix Cardinals",24,37,-11,FALSE,"12/9/1990",1990,"December","1990s",45,40,12
"5432","199012090gnb","Green Bay Packers",14,"Seattle Seahawks",20,34,-6,FALSE,"12/9/1990",1990,"December","1990s",38,71,17
"5433","199012090nyg","New York Giants",23,"Minnesota Vikings",15,38,8,TRUE,"12/9/1990",1990,"December","1990s",43,55,14
"5434","199012090pit","Pittsburgh Steelers",24,"New England Patriots",3,27,21,TRUE,"12/9/1990",1990,"December","1990s",35,78,11
"5435","199012090was","Washington Redskins",10,"Chicago Bears",9,19,1,TRUE,"12/9/1990",1990,"December","1990s",43,54,11
"5436","199012090clt","Indianapolis Colts",7,"Buffalo Bills",31,38,-24,FALSE,"12/9/1990",1990,"December","1990s",72,NA,NA
"5437","199012090cin","Cincinnati Bengals",17,"San Francisco 49ers",20,37,-3,FALSE,"12/9/1990",1990,"December","1990s",36,71,7
"5438","199012090oti","Houston Oilers",58,"Cleveland Browns",14,72,44,TRUE,"12/9/1990",1990,"December","1990s",72,NA,NA
"5439","199012090kan","Kansas City Chiefs",31,"Denver Broncos",20,51,11,TRUE,"12/9/1990",1990,"December","1990s",44,53,11
"5440","199012090mia","Miami Dolphins",23,"Philadelphia Eagles",20,43,3,TRUE,"12/9/1990",1990,"December","1990s",59,67,11
"5441","199012100det","Detroit Lions",31,"Los Angeles Raiders",38,69,-7,FALSE,"12/10/1990",1990,"December","1990s",72,NA,NA
"5442","199012150nwe","New England Patriots",10,"Washington Redskins",25,35,-15,FALSE,"12/15/1990",1990,"December","1990s",33,59,10
"5443","199012150nyg","New York Giants",13,"Buffalo Bills",17,30,-4,FALSE,"12/15/1990",1990,"December","1990s",37,60,10
"5444","199012160det","Detroit Lions",38,"Chicago Bears",21,59,17,TRUE,"12/16/1990",1990,"December","1990s",72,NA,NA
"5445","199012160nyj","New York Jets",21,"Indianapolis Colts",29,50,-8,FALSE,"12/16/1990",1990,"December","1990s",45,74,19
"5446","199012160kan","Kansas City Chiefs",10,"Houston Oilers",27,37,-17,FALSE,"12/16/1990",1990,"December","1990s",33,79,9
"5447","199012160cle","Cleveland Browns",13,"Atlanta Falcons",10,23,3,TRUE,"12/16/1990",1990,"December","1990s",39,79,15
"5448","199012160dal","Dallas Cowboys",41,"Phoenix Cardinals",10,51,31,TRUE,"12/16/1990",1990,"December","1990s",48,67,10
"5449","199012160phi","Philadelphia Eagles",31,"Green Bay Packers",0,31,31,TRUE,"12/16/1990",1990,"December","1990s",45,83,15
"5450","199012160nor","New Orleans Saints",6,"Pittsburgh Steelers",9,15,-3,FALSE,"12/16/1990",1990,"December","1990s",72,NA,NA
"5451","199012160tam","Tampa Bay Buccaneers",26,"Minnesota Vikings",13,39,13,TRUE,"12/16/1990",1990,"December","1990s",67,74,6
"5452","199012160mia","Miami Dolphins",24,"Seattle Seahawks",17,41,7,TRUE,"12/16/1990",1990,"December","1990s",71,70,7
"5453","199012160den","Denver Broncos",20,"San Diego Chargers",10,30,10,TRUE,"12/16/1990",1990,"December","1990s",32,38,4
"5454","199012160rai","Los Angeles Raiders",24,"Cincinnati Bengals",7,31,17,TRUE,"12/16/1990",1990,"December","1990s",53,53,12
"5455","199012170ram","Los Angeles Rams",10,"San Francisco 49ers",26,36,-16,FALSE,"12/17/1990",1990,"December","1990s",52,43,11
"5456","199012220gnb","Green Bay Packers",17,"Detroit Lions",24,41,-7,FALSE,"12/22/1990",1990,"December","1990s",14,82,14
"5457","199012220min","Minnesota Vikings",24,"Los Angeles Raiders",28,52,-4,FALSE,"12/22/1990",1990,"December","1990s",72,NA,NA
"5458","199012220clt","Indianapolis Colts",35,"Washington Redskins",28,63,7,TRUE,"12/22/1990",1990,"December","1990s",72,NA,NA
"5459","199012230crd","Phoenix Cardinals",21,"New York Giants",24,45,-3,FALSE,"12/23/1990",1990,"December","1990s",36,31,8
"5460","199012230buf","Buffalo Bills",24,"Miami Dolphins",14,38,10,TRUE,"12/23/1990",1990,"December","1990s",39,95,12
"5461","199012230phi","Philadelphia Eagles",17,"Dallas Cowboys",3,20,14,TRUE,"12/23/1990",1990,"December","1990s",63,99,15
"5462","199012230atl","Atlanta Falcons",20,"Los Angeles Rams",13,33,7,TRUE,"12/23/1990",1990,"December","1990s",67,86,17
"5463","199012230sea","Seattle Seahawks",17,"Denver Broncos",12,29,5,TRUE,"12/23/1990",1990,"December","1990s",72,NA,NA
"5464","199012230pit","Pittsburgh Steelers",35,"Cleveland Browns",0,35,35,TRUE,"12/23/1990",1990,"December","1990s",47,93,20
"5465","199012230nyj","New York Jets",42,"New England Patriots",7,49,35,TRUE,"12/23/1990",1990,"December","1990s",59,92,12
"5466","199012230cin","Cincinnati Bengals",40,"Houston Oilers",20,60,20,TRUE,"12/23/1990",1990,"December","1990s",31,92,10
"5467","199012230chi","Chicago Bears",27,"Tampa Bay Buccaneers",14,41,13,TRUE,"12/23/1990",1990,"December","1990s",8,68,12
"5468","199012230sfo","San Francisco 49ers",10,"New Orleans Saints",13,23,-3,FALSE,"12/23/1990",1990,"December","1990s",34,49,10
"5469","199012230sdg","San Diego Chargers",21,"Kansas City Chiefs",24,45,-3,FALSE,"12/23/1990",1990,"December","1990s",45,35,7
"5470","199012290chi","Chicago Bears",10,"Kansas City Chiefs",21,31,-11,FALSE,"12/29/1990",1990,"December","1990s",38,91,13
"5471","199012290crd","Phoenix Cardinals",21,"Philadelphia Eagles",23,44,-2,FALSE,"12/29/1990",1990,"December","1990s",49,89,5
"5472","199012300sea","Seattle Seahawks",30,"Detroit Lions",10,40,20,TRUE,"12/30/1990",1990,"December","1990s",72,NA,NA
"5473","199012300atl","Atlanta Falcons",26,"Dallas Cowboys",7,33,19,TRUE,"12/30/1990",1990,"December","1990s",57,96,11
"5474","199012300rai","Los Angeles Raiders",17,"San Diego Chargers",12,29,5,TRUE,"12/30/1990",1990,"December","1990s",53,42,5
"5475","199012300cin","Cincinnati Bengals",21,"Cleveland Browns",14,35,7,TRUE,"12/30/1990",1990,"December","1990s",52,92,13
"5476","199012300mia","Miami Dolphins",23,"Indianapolis Colts",17,40,6,TRUE,"12/30/1990",1990,"December","1990s",77,79,14
"5477","199012300oti","Houston Oilers",34,"Pittsburgh Steelers",14,48,20,TRUE,"12/30/1990",1990,"December","1990s",72,NA,NA
"5478","199012300min","Minnesota Vikings",17,"San Francisco 49ers",20,37,-3,FALSE,"12/30/1990",1990,"December","1990s",72,NA,NA
"5479","199012300tam","Tampa Bay Buccaneers",14,"New York Jets",16,30,-2,FALSE,"12/30/1990",1990,"December","1990s",75,82,8
"5480","199012300den","Denver Broncos",22,"Green Bay Packers",13,35,9,TRUE,"12/30/1990",1990,"December","1990s",9,57,8
"5481","199012300was","Washington Redskins",29,"Buffalo Bills",14,43,15,TRUE,"12/30/1990",1990,"December","1990s",58,87,17
"5482","199012300nwe","New England Patriots",10,"New York Giants",13,23,-3,FALSE,"12/30/1990",1990,"December","1990s",49,88,21
"5483","199012310nor","New Orleans Saints",20,"Los Angeles Rams",17,37,3,TRUE,"12/31/1990",1990,"December","1990s",72,NA,NA
"5484","199101050mia","Miami Dolphins",17,"Kansas City Chiefs",16,33,1,TRUE,"1/5/1991",1991,"January","1990s",75,80,12
"5485","199101050phi","Philadelphia Eagles",6,"Washington Redskins",20,26,-14,FALSE,"1/5/1991",1991,"January","1990s",31,60,5
"5486","199101060cin","Cincinnati Bengals",41,"Houston Oilers",14,55,27,TRUE,"1/6/1991",1991,"January","1990s",38,95,8
"5487","199101060chi","Chicago Bears",16,"New Orleans Saints",6,22,10,TRUE,"1/6/1991",1991,"January","1990s",21,76,13
"5488","199101120sfo","San Francisco 49ers",28,"Washington Redskins",10,38,18,TRUE,"1/12/1991",1991,"January","1990s",51,85,5
"5489","199101120buf","Buffalo Bills",44,"Miami Dolphins",34,78,10,TRUE,"1/12/1991",1991,"January","1990s",31,88,12
"5490","199101130rai","Los Angeles Raiders",20,"Cincinnati Bengals",10,30,10,TRUE,"1/13/1991",1991,"January","1990s",60,62,5
"5491","199101130nyg","New York Giants",31,"Chicago Bears",3,34,28,TRUE,"1/13/1991",1991,"January","1990s",34,72,14
"5492","199101200buf","Buffalo Bills",51,"Los Angeles Raiders",3,54,48,TRUE,"1/20/1991",1991,"January","1990s",38,75,18
"5493","199101200sfo","San Francisco 49ers",13,"New York Giants",15,28,-2,FALSE,"1/20/1991",1991,"January","1990s",51,69,7
"5494","199101270buf","Buffalo Bills",19,"New York Giants",20,39,-1,FALSE,"1/27/1991",1991,"January","1990s",62,76,8
"5495","199109010den","Denver Broncos",45,"Cincinnati Bengals",14,59,31,TRUE,"9/1/1991",1991,"September","1990s",71,40,10
"5496","199109010clt","Indianapolis Colts",7,"New England Patriots",16,23,-9,FALSE,"9/1/1991",1991,"September","1990s",72,NA,NA
"5497","199109010buf","Buffalo Bills",35,"Miami Dolphins",31,66,4,TRUE,"9/1/1991",1991,"September","1990s",59,58,9
"5498","199109010oti","Houston Oilers",47,"Los Angeles Raiders",17,64,30,TRUE,"9/1/1991",1991,"September","1990s",72,NA,NA
"5499","199109010ram","Los Angeles Rams",14,"Phoenix Cardinals",24,38,-10,FALSE,"9/1/1991",1991,"September","1990s",66,77,9
"5500","199109010cle","Cleveland Browns",14,"Dallas Cowboys",26,40,-12,FALSE,"9/1/1991",1991,"September","1990s",65,62,14
"5501","199109010nyj","New York Jets",16,"Tampa Bay Buccaneers",13,29,3,TRUE,"9/1/1991",1991,"September","1990s",66,47,18
"5502","199109010pit","Pittsburgh Steelers",26,"San Diego Chargers",20,46,6,TRUE,"9/1/1991",1991,"September","1990s",68,46,13
"5503","199109010chi","Chicago Bears",10,"Minnesota Vikings",6,16,4,TRUE,"9/1/1991",1991,"September","1990s",67,69,14
"5504","199109010nor","New Orleans Saints",27,"Seattle Seahawks",24,51,3,TRUE,"9/1/1991",1991,"September","1990s",72,NA,NA
"5505","199109010kan","Kansas City Chiefs",14,"Atlanta Falcons",3,17,11,TRUE,"9/1/1991",1991,"September","1990s",75,80,10
"5506","199109010was","Washington Redskins",45,"Detroit Lions",0,45,45,TRUE,"9/1/1991",1991,"September","1990s",76,50,15
"5507","199109010gnb","Green Bay Packers",3,"Philadelphia Eagles",20,23,-17,FALSE,"9/1/1991",1991,"September","1990s",60,66,11
"5508","199109020nyg","New York Giants",16,"San Francisco 49ers",14,30,2,TRUE,"9/2/1991",1991,"September","1990s",65,53,12
"5509","199109080cin","Cincinnati Bengals",7,"Houston Oilers",30,37,-23,FALSE,"9/8/1991",1991,"September","1990s",73,61,8
"5510","199109080mia","Miami Dolphins",17,"Indianapolis Colts",6,23,11,TRUE,"9/8/1991",1991,"September","1990s",82,77,8
"5511","199109080nyg","New York Giants",13,"Los Angeles Rams",19,32,-6,FALSE,"9/8/1991",1991,"September","1990s",78,52,8
"5512","199109080sea","Seattle Seahawks",20,"New York Jets",13,33,7,TRUE,"9/8/1991",1991,"September","1990s",72,NA,NA
"5513","199109080nwe","New England Patriots",0,"Cleveland Browns",20,20,-20,FALSE,"9/8/1991",1991,"September","1990s",70,62,10
"5514","199109080det","Detroit Lions",23,"Green Bay Packers",14,37,9,TRUE,"9/8/1991",1991,"September","1990s",72,NA,NA
"5515","199109080phi","Philadelphia Eagles",10,"Phoenix Cardinals",26,36,-16,FALSE,"9/8/1991",1991,"September","1990s",76,56,8
"5516","199109080buf","Buffalo Bills",52,"Pittsburgh Steelers",34,86,18,TRUE,"9/8/1991",1991,"September","1990s",73,55,8
"5517","199109080rai","Los Angeles Raiders",16,"Denver Broncos",13,29,3,TRUE,"9/8/1991",1991,"September","1990s",65,78,9
"5518","199109080sfo","San Francisco 49ers",34,"San Diego Chargers",14,48,20,TRUE,"9/8/1991",1991,"September","1990s",62,75,12
"5519","199109080kan","Kansas City Chiefs",10,"New Orleans Saints",17,27,-7,FALSE,"9/8/1991",1991,"September","1990s",77,83,17
"5520","199109080tam","Tampa Bay Buccaneers",20,"Chicago Bears",21,41,-1,FALSE,"9/8/1991",1991,"September","1990s",80,82,12
"5521","199109080atl","Atlanta Falcons",19,"Minnesota Vikings",20,39,-1,FALSE,"9/8/1991",1991,"September","1990s",78,76,10
"5522","199109090dal","Dallas Cowboys",31,"Washington Redskins",33,64,-2,FALSE,"9/9/1991",1991,"September","1990s",81,68,11
"5523","199109150cle","Cleveland Browns",14,"Cincinnati Bengals",13,27,1,TRUE,"9/15/1991",1991,"September","1990s",81,64,14
"5524","199109150chi","Chicago Bears",20,"New York Giants",17,37,3,TRUE,"9/15/1991",1991,"September","1990s",82,65,15
"5525","199109150sdg","San Diego Chargers",10,"Atlanta Falcons",13,23,-3,FALSE,"9/15/1991",1991,"September","1990s",67,74,9
"5526","199109150gnb","Green Bay Packers",15,"Tampa Bay Buccaneers",13,28,2,TRUE,"9/15/1991",1991,"September","1990s",75,88,14
"5527","199109150det","Detroit Lions",17,"Miami Dolphins",13,30,4,TRUE,"9/15/1991",1991,"September","1990s",72,NA,NA
"5528","199109150dal","Dallas Cowboys",0,"Philadelphia Eagles",24,24,-24,FALSE,"9/15/1991",1991,"September","1990s",81,77,13
"5529","199109150den","Denver Broncos",16,"Seattle Seahawks",10,26,6,TRUE,"9/15/1991",1991,"September","1990s",58,43,9
"5530","199109150was","Washington Redskins",34,"Phoenix Cardinals",0,34,34,TRUE,"9/15/1991",1991,"September","1990s",76,81,8
"5531","199109150nyj","New York Jets",20,"Buffalo Bills",23,43,-3,FALSE,"9/15/1991",1991,"September","1990s",70,81,10
"5532","199109150pit","Pittsburgh Steelers",20,"New England Patriots",6,26,14,TRUE,"9/15/1991",1991,"September","1990s",78,71,10
"5533","199109150rai","Los Angeles Raiders",16,"Indianapolis Colts",0,16,16,TRUE,"9/15/1991",1991,"September","1990s",66,77,9
"5534","199109150nor","New Orleans Saints",24,"Los Angeles Rams",7,31,17,TRUE,"9/15/1991",1991,"September","1990s",72,NA,NA
"5535","199109150min","Minnesota Vikings",17,"San Francisco 49ers",14,31,3,TRUE,"9/15/1991",1991,"September","1990s",72,NA,NA
"5536","199109160oti","Houston Oilers",17,"Kansas City Chiefs",7,24,10,TRUE,"9/16/1991",1991,"September","1990s",72,NA,NA
"5537","199109220nyg","New York Giants",13,"Cleveland Browns",10,23,3,TRUE,"9/22/1991",1991,"September","1990s",61,51,10
"5538","199109220clt","Indianapolis Colts",24,"Detroit Lions",33,57,-9,FALSE,"9/22/1991",1991,"September","1990s",72,NA,NA
"5539","199109220tam","Tampa Bay Buccaneers",10,"Buffalo Bills",17,27,-7,FALSE,"9/22/1991",1991,"September","1990s",80,78,10
"5540","199109220sfo","San Francisco 49ers",27,"Los Angeles Rams",10,37,17,TRUE,"9/22/1991",1991,"September","1990s",61,81,13
"5541","199109220nor","New Orleans Saints",26,"Minnesota Vikings",0,26,26,TRUE,"9/22/1991",1991,"September","1990s",72,NA,NA
"5542","199109220den","Denver Broncos",27,"San Diego Chargers",19,46,8,TRUE,"9/22/1991",1991,"September","1990s",53,46,10
"5543","199109220nwe","New England Patriots",24,"Houston Oilers",20,44,4,TRUE,"9/22/1991",1991,"September","1990s",55,59,9
"5544","199109220cin","Cincinnati Bengals",27,"Washington Redskins",34,61,-7,FALSE,"9/22/1991",1991,"September","1990s",59,64,10
"5545","199109220crd","Phoenix Cardinals",9,"Dallas Cowboys",17,26,-8,FALSE,"9/22/1991",1991,"September","1990s",86,43,7
"5546","199109220mia","Miami Dolphins",16,"Green Bay Packers",13,29,3,TRUE,"9/22/1991",1991,"September","1990s",82,82,7
"5547","199109220atl","Atlanta Falcons",21,"Los Angeles Raiders",17,38,4,TRUE,"9/22/1991",1991,"September","1990s",64,57,11
"5548","199109220phi","Philadelphia Eagles",23,"Pittsburgh Steelers",14,37,9,TRUE,"9/22/1991",1991,"September","1990s",59,55,9
"5549","199109220kan","Kansas City Chiefs",20,"Seattle Seahawks",13,33,7,TRUE,"9/22/1991",1991,"September","1990s",58,68,13
"5550","199109230chi","Chicago Bears",19,"New York Jets",13,32,6,TRUE,"9/23/1991",1991,"September","1990s",55,63,12
"5551","199109290crd","Phoenix Cardinals",24,"New England Patriots",10,34,14,TRUE,"9/29/1991",1991,"September","1990s",87,25,6
"5552","199109290ram","Los Angeles Rams",23,"Green Bay Packers",21,44,2,TRUE,"9/29/1991",1991,"September","1990s",66,86,10
"5553","199109290dal","Dallas Cowboys",21,"New York Giants",16,37,5,TRUE,"9/29/1991",1991,"September","1990s",66,61,6
"5554","199109290sea","Seattle Seahawks",31,"Indianapolis Colts",3,34,28,TRUE,"9/29/1991",1991,"September","1990s",72,NA,NA
"5555","199109290rai","Los Angeles Raiders",12,"San Francisco 49ers",6,18,6,TRUE,"9/29/1991",1991,"September","1990s",66,86,10
"5556","199109290atl","Atlanta Falcons",6,"New Orleans Saints",27,33,-21,FALSE,"9/29/1991",1991,"September","1990s",66,51,11
"5557","199109290min","Minnesota Vikings",6,"Denver Broncos",13,19,-7,FALSE,"9/29/1991",1991,"September","1990s",72,NA,NA
"5558","199109290nyj","New York Jets",41,"Miami Dolphins",23,64,18,TRUE,"9/29/1991",1991,"September","1990s",61,52,12
"5559","199109290sdg","San Diego Chargers",13,"Kansas City Chiefs",14,27,-1,FALSE,"9/29/1991",1991,"September","1990s",68,81,9
"5560","199109290det","Detroit Lions",31,"Tampa Bay Buccaneers",3,34,28,TRUE,"9/29/1991",1991,"September","1990s",72,NA,NA
"5561","199109290buf","Buffalo Bills",35,"Chicago Bears",20,55,15,TRUE,"9/29/1991",1991,"September","1990s",47,66,11
"5562","199109300was","Washington Redskins",23,"Philadelphia Eagles",0,23,23,TRUE,"9/30/1991",1991,"September","1990s",64,62,8
"5563","199110060cin","Cincinnati Bengals",7,"Seattle Seahawks",13,20,-6,FALSE,"10/6/1991",1991,"October","1990s",45,69,12
"5564","199110060cle","Cleveland Browns",14,"New York Jets",17,31,-3,FALSE,"10/6/1991",1991,"October","1990s",46,66,16
"5565","199110060clt","Indianapolis Colts",3,"Pittsburgh Steelers",21,24,-18,FALSE,"10/6/1991",1991,"October","1990s",72,NA,NA
"5566","199110060nyg","New York Giants",20,"Phoenix Cardinals",9,29,11,TRUE,"10/6/1991",1991,"October","1990s",64,88,17
"5567","199110060gnb","Green Bay Packers",17,"Dallas Cowboys",20,37,-3,FALSE,"10/6/1991",1991,"October","1990s",44,60,17
"5568","199110060det","Detroit Lions",24,"Minnesota Vikings",20,44,4,TRUE,"10/6/1991",1991,"October","1990s",72,NA,NA
"5569","199110060nwe","New England Patriots",10,"Miami Dolphins",20,30,-10,FALSE,"10/6/1991",1991,"October","1990s",64,94,13
"5570","199110060oti","Houston Oilers",42,"Denver Broncos",14,56,28,TRUE,"10/6/1991",1991,"October","1990s",72,NA,NA
"5571","199110060chi","Chicago Bears",7,"Washington Redskins",20,27,-13,FALSE,"10/6/1991",1991,"October","1990s",43,64,16
"5572","199110060tam","Tampa Bay Buccaneers",14,"Philadelphia Eagles",13,27,1,TRUE,"10/6/1991",1991,"October","1990s",77,89,8
"5573","199110060rai","Los Angeles Raiders",13,"San Diego Chargers",21,34,-8,FALSE,"10/6/1991",1991,"October","1990s",65,84,9
"5574","199110070kan","Kansas City Chiefs",33,"Buffalo Bills",6,39,27,TRUE,"10/7/1991",1991,"October","1990s",52,46,13
"5575","199110130dal","Dallas Cowboys",35,"Cincinnati Bengals",23,58,12,TRUE,"10/13/1991",1991,"October","1990s",74,48,7
"5576","199110130was","Washington Redskins",42,"Cleveland Browns",17,59,25,TRUE,"10/13/1991",1991,"October","1990s",55,66,9
"5577","199110130ram","Los Angeles Rams",30,"San Diego Chargers",24,54,6,TRUE,"10/13/1991",1991,"October","1990s",68,81,7
"5578","199110130phi","Philadelphia Eagles",6,"New Orleans Saints",13,19,-7,FALSE,"10/13/1991",1991,"October","1990s",53,68,11
"5579","199110130sfo","San Francisco 49ers",34,"Atlanta Falcons",39,73,-5,FALSE,"10/13/1991",1991,"October","1990s",60,78,12
"5580","199110130sea","Seattle Seahawks",20,"Los Angeles Raiders",23,43,-3,FALSE,"10/13/1991",1991,"October","1990s",72,NA,NA
"5581","199110130nyj","New York Jets",20,"Houston Oilers",23,43,-3,FALSE,"10/13/1991",1991,"October","1990s",55,58,11
"5582","199110130min","Minnesota Vikings",34,"Phoenix Cardinals",7,41,27,TRUE,"10/13/1991",1991,"October","1990s",72,NA,NA
"5583","199110130kan","Kansas City Chiefs",42,"Miami Dolphins",7,49,35,TRUE,"10/13/1991",1991,"October","1990s",62,46,14
"5584","199110130buf","Buffalo Bills",42,"Indianapolis Colts",6,48,36,TRUE,"10/13/1991",1991,"October","1990s",44,78,10
"5585","199110140pit","Pittsburgh Steelers",20,"New York Giants",23,43,-3,FALSE,"10/14/1991",1991,"October","1990s",47,65,10
"5586","199110170gnb","Green Bay Packers",0,"Chicago Bears",10,10,-10,FALSE,"10/17/1991",1991,"October","1990s",58,52,20
"5587","199110200nor","New Orleans Saints",23,"Tampa Bay Buccaneers",7,30,16,TRUE,"10/20/1991",1991,"October","1990s",72,NA,NA
"5588","199110200sfo","San Francisco 49ers",35,"Detroit Lions",3,38,32,TRUE,"10/20/1991",1991,"October","1990s",69,46,9
"5589","199110200crd","Phoenix Cardinals",16,"Atlanta Falcons",10,26,6,TRUE,"10/20/1991",1991,"October","1990s",83,21,7
"5590","199110200den","Denver Broncos",19,"Kansas City Chiefs",16,35,3,TRUE,"10/20/1991",1991,"October","1990s",48,38,6
"5591","199110200pit","Pittsburgh Steelers",7,"Seattle Seahawks",27,34,-20,FALSE,"10/20/1991",1991,"October","1990s",41,75,7
"5592","199110200sdg","San Diego Chargers",24,"Cleveland Browns",30,54,-6,FALSE,"10/20/1991",1991,"October","1990s",62,90,9
"5593","199110200rai","Los Angeles Raiders",20,"Los Angeles Rams",17,37,3,TRUE,"10/20/1991",1991,"October","1990s",66,85,8
"5594","199110200nwe","New England Patriots",26,"Minnesota Vikings",23,49,3,TRUE,"10/20/1991",1991,"October","1990s",48,49,18
"5595","199110200mia","Miami Dolphins",13,"Houston Oilers",17,30,-4,FALSE,"10/20/1991",1991,"October","1990s",78,85,8
"5596","199110200clt","Indianapolis Colts",6,"New York Jets",17,23,-11,FALSE,"10/20/1991",1991,"October","1990s",72,NA,NA
"5597","199110210buf","Buffalo Bills",35,"Cincinnati Bengals",16,51,19,TRUE,"10/21/1991",1991,"October","1990s",47,57,9
"5598","199110270det","Detroit Lions",34,"Dallas Cowboys",10,44,24,TRUE,"10/27/1991",1991,"October","1990s",72,NA,NA
"5599","199110270nwe","New England Patriots",6,"Denver Broncos",9,15,-3,FALSE,"10/27/1991",1991,"October","1990s",65,78,13
"5600","199110270nyg","New York Giants",13,"Washington Redskins",17,30,-4,FALSE,"10/27/1991",1991,"October","1990s",64,89,9
"5601","199110270oti","Houston Oilers",35,"Cincinnati Bengals",3,38,32,TRUE,"10/27/1991",1991,"October","1990s",72,NA,NA
"5602","199110270cle","Cleveland Browns",17,"Pittsburgh Steelers",14,31,3,TRUE,"10/27/1991",1991,"October","1990s",64,78,9
"5603","199110270nor","New Orleans Saints",17,"Chicago Bears",20,37,-3,FALSE,"10/27/1991",1991,"October","1990s",72,NA,NA
"5604","199110270atl","Atlanta Falcons",31,"Los Angeles Rams",14,45,17,TRUE,"10/27/1991",1991,"October","1990s",71,68,10
"5605","199110270phi","Philadelphia Eagles",7,"San Francisco 49ers",23,30,-16,FALSE,"10/27/1991",1991,"October","1990s",61,94,7
"5606","199110270tam","Tampa Bay Buccaneers",0,"Green Bay Packers",27,27,-27,FALSE,"10/27/1991",1991,"October","1990s",76,76,9
"5607","199110270crd","Phoenix Cardinals",0,"Minnesota Vikings",28,28,-28,FALSE,"10/27/1991",1991,"October","1990s",65,49,8
"5608","199110270sea","Seattle Seahawks",20,"San Diego Chargers",9,29,11,TRUE,"10/27/1991",1991,"October","1990s",72,NA,NA
"5609","199110280kan","Kansas City Chiefs",24,"Los Angeles Raiders",21,45,3,TRUE,"10/28/1991",1991,"October","1990s",65,83,21
"5610","199111030nyj","New York Jets",19,"Green Bay Packers",16,35,3,TRUE,"11/3/1991",1991,"November","1990s",54,55,13
"5611","199111030den","Denver Broncos",20,"Pittsburgh Steelers",13,33,7,TRUE,"11/3/1991",1991,"November","1990s",16,54,8
"5612","199111030buf","Buffalo Bills",22,"New England Patriots",17,39,5,TRUE,"11/3/1991",1991,"November","1990s",33,74,18
"5613","199111030ram","Los Angeles Rams",17,"New Orleans Saints",24,41,-7,FALSE,"11/3/1991",1991,"November","1990s",62,69,7
"5614","199111030atl","Atlanta Falcons",17,"San Francisco 49ers",14,31,3,TRUE,"11/3/1991",1991,"November","1990s",43,57,12
"5615","199111030clt","Indianapolis Colts",6,"Miami Dolphins",10,16,-4,FALSE,"11/3/1991",1991,"November","1990s",72,NA,NA
"5616","199111030was","Washington Redskins",16,"Houston Oilers",13,29,3,TRUE,"11/3/1991",1991,"November","1990s",48,51,10
"5617","199111030chi","Chicago Bears",20,"Detroit Lions",10,30,10,TRUE,"11/3/1991",1991,"November","1990s",18,71,19
"5618","199111030cin","Cincinnati Bengals",23,"Cleveland Browns",21,44,2,TRUE,"11/3/1991",1991,"November","1990s",28,57,12
"5619","199111030min","Minnesota Vikings",28,"Tampa Bay Buccaneers",13,41,15,TRUE,"11/3/1991",1991,"November","1990s",72,NA,NA
"5620","199111030dal","Dallas Cowboys",27,"Phoenix Cardinals",7,34,20,TRUE,"11/3/1991",1991,"November","1990s",33,49,17
"5621","199111040phi","Philadelphia Eagles",30,"New York Giants",7,37,23,TRUE,"11/4/1991",1991,"November","1990s",42,39,12
"5622","199111100sdg","San Diego Chargers",17,"Seattle Seahawks",14,31,3,TRUE,"11/10/1991",1991,"November","1990s",63,71,8
"5623","199111100cin","Cincinnati Bengals",27,"Pittsburgh Steelers",33,60,-6,FALSE,"11/10/1991",1991,"November","1990s",32,60,10
"5624","199111100den","Denver Broncos",16,"Los Angeles Raiders",17,33,-1,FALSE,"11/10/1991",1991,"November","1990s",45,78,9
"5625","199111100tam","Tampa Bay Buccaneers",30,"Detroit Lions",21,51,9,TRUE,"11/10/1991",1991,"November","1990s",51,73,8
"5626","199111100oti","Houston Oilers",26,"Dallas Cowboys",23,49,3,TRUE,"11/10/1991",1991,"November","1990s",72,NA,NA
"5627","199111100mia","Miami Dolphins",30,"New England Patriots",20,50,10,TRUE,"11/10/1991",1991,"November","1990s",59,63,9
"5628","199111100was","Washington Redskins",56,"Atlanta Falcons",17,73,39,TRUE,"11/10/1991",1991,"November","1990s",40,75,16
"5629","199111100ram","Los Angeles Rams",20,"Kansas City Chiefs",27,47,-7,FALSE,"11/10/1991",1991,"November","1990s",62,74,8
"5630","199111100nyj","New York Jets",27,"Indianapolis Colts",28,55,-1,FALSE,"11/10/1991",1991,"November","1990s",40,63,22
"5631","199111100nor","New Orleans Saints",10,"San Francisco 49ers",3,13,7,TRUE,"11/10/1991",1991,"November","1990s",72,NA,NA
"5632","199111100gnb","Green Bay Packers",24,"Buffalo Bills",34,58,-10,FALSE,"11/10/1991",1991,"November","1990s",32,56,8
"5633","199111100cle","Cleveland Browns",30,"Philadelphia Eagles",32,62,-2,FALSE,"11/10/1991",1991,"November","1990s",31,76,10
"5634","199111100crd","Phoenix Cardinals",14,"New York Giants",21,35,-7,FALSE,"11/10/1991",1991,"November","1990s",74,39,9
"5635","199111110min","Minnesota Vikings",17,"Chicago Bears",34,51,-17,FALSE,"11/11/1991",1991,"November","1990s",72,NA,NA
"5636","199111170gnb","Green Bay Packers",21,"Minnesota Vikings",35,56,-14,FALSE,"11/17/1991",1991,"November","1990s",32,84,9
"5637","199111170clt","Indianapolis Colts",17,"Chicago Bears",31,48,-14,FALSE,"11/17/1991",1991,"November","1990s",72,NA,NA
"5638","199111170det","Detroit Lions",21,"Los Angeles Rams",10,31,11,TRUE,"11/17/1991",1991,"November","1990s",72,NA,NA
"5639","199111170nwe","New England Patriots",21,"New York Jets",28,49,-7,FALSE,"11/17/1991",1991,"November","1990s",37,42,22
"5640","199111170kan","Kansas City Chiefs",20,"Denver Broncos",24,44,-4,FALSE,"11/17/1991",1991,"November","1990s",51,86,17
"5641","199111170oti","Houston Oilers",28,"Cleveland Browns",24,52,4,TRUE,"11/17/1991",1991,"November","1990s",72,NA,NA
"5642","199111170nyg","New York Giants",22,"Dallas Cowboys",9,31,13,TRUE,"11/17/1991",1991,"November","1990s",41,42,20
"5643","199111170sdg","San Diego Chargers",24,"New Orleans Saints",21,45,3,TRUE,"11/17/1991",1991,"November","1990s",58,69,9
"5644","199111170phi","Philadelphia Eagles",17,"Cincinnati Bengals",10,27,7,TRUE,"11/17/1991",1991,"November","1990s",43,42,12
"5645","199111170atl","Atlanta Falcons",43,"Tampa Bay Buccaneers",7,50,36,TRUE,"11/17/1991",1991,"November","1990s",63,70,12
"5646","199111170pit","Pittsburgh Steelers",14,"Washington Redskins",41,55,-27,FALSE,"11/17/1991",1991,"November","1990s",39,60,8
"5647","199111170rai","Los Angeles Raiders",31,"Seattle Seahawks",7,38,24,TRUE,"11/17/1991",1991,"November","1990s",57,75,8
"5648","199111170sfo","San Francisco 49ers",14,"Phoenix Cardinals",10,24,4,TRUE,"11/17/1991",1991,"November","1990s",59,60,18
"5649","199111180mia","Miami Dolphins",27,"Buffalo Bills",41,68,-14,FALSE,"11/18/1991",1991,"November","1990s",75,71,10
"5650","199111240tam","Tampa Bay Buccaneers",14,"New York Giants",21,35,-7,FALSE,"11/24/1991",1991,"November","1990s",60,78,11
"5651","199111240pit","Pittsburgh Steelers",26,"Houston Oilers",14,40,12,TRUE,"11/24/1991",1991,"November","1990s",37,77,18
"5652","199111240nor","New Orleans Saints",20,"Atlanta Falcons",23,43,-3,FALSE,"11/24/1991",1991,"November","1990s",72,NA,NA
"5653","199111240cle","Cleveland Browns",20,"Kansas City Chiefs",15,35,5,TRUE,"11/24/1991",1991,"November","1990s",34,72,20
"5654","199111240was","Washington Redskins",21,"Dallas Cowboys",24,45,-3,FALSE,"11/24/1991",1991,"November","1990s",52,71,12
"5655","199111240cin","Cincinnati Bengals",14,"Los Angeles Raiders",38,52,-24,FALSE,"11/24/1991",1991,"November","1990s",31,68,20
"5656","199111240nyj","New York Jets",24,"San Diego Chargers",3,27,21,TRUE,"11/24/1991",1991,"November","1990s",54,88,15
"5657","199111240nwe","New England Patriots",16,"Buffalo Bills",13,29,3,TRUE,"11/24/1991",1991,"November","1990s",47,94,9
"5658","199111240gnb","Green Bay Packers",14,"Indianapolis Colts",10,24,4,TRUE,"11/24/1991",1991,"November","1990s",28,80,18
"5659","199111240sea","Seattle Seahawks",13,"Denver Broncos",10,23,3,TRUE,"11/24/1991",1991,"November","1990s",72,NA,NA
"5660","199111240chi","Chicago Bears",13,"Miami Dolphins",16,29,-3,FALSE,"11/24/1991",1991,"November","1990s",25,82,17
"5661","199111240min","Minnesota Vikings",14,"Detroit Lions",34,48,-20,FALSE,"11/24/1991",1991,"November","1990s",72,NA,NA
"5662","199111240crd","Phoenix Cardinals",14,"Philadelphia Eagles",34,48,-20,FALSE,"11/24/1991",1991,"November","1990s",58,18,6
"5663","199111250ram","Los Angeles Rams",10,"San Francisco 49ers",33,43,-23,FALSE,"11/25/1991",1991,"November","1990s",62,38,6
"5664","199111280dal","Dallas Cowboys",20,"Pittsburgh Steelers",10,30,10,TRUE,"11/28/1991",1991,"November","1990s",68,77,19
"5665","199111280det","Detroit Lions",16,"Chicago Bears",6,22,10,TRUE,"11/28/1991",1991,"November","1990s",72,NA,NA
"5666","199112010ram","Los Angeles Rams",6,"Washington Redskins",27,33,-21,FALSE,"12/1/1991",1991,"December","1990s",55,15,9
"5667","199112010cin","Cincinnati Bengals",27,"New York Giants",24,51,3,TRUE,"12/1/1991",1991,"December","1990s",39,86,10
"5668","199112010atl","Atlanta Falcons",35,"Green Bay Packers",31,66,4,TRUE,"12/1/1991",1991,"December","1990s",71,84,14
"5669","199112010clt","Indianapolis Colts",0,"Cleveland Browns",31,31,-31,FALSE,"12/1/1991",1991,"December","1990s",72,NA,NA
"5670","199112010sfo","San Francisco 49ers",38,"New Orleans Saints",24,62,14,TRUE,"12/1/1991",1991,"December","1990s",56,40,12
"5671","199112010sea","Seattle Seahawks",6,"Kansas City Chiefs",19,25,-13,FALSE,"12/1/1991",1991,"December","1990s",72,NA,NA
"5672","199112010buf","Buffalo Bills",24,"New York Jets",13,37,11,TRUE,"12/1/1991",1991,"December","1990s",40,73,14
"5673","199112010sdg","San Diego Chargers",7,"Los Angeles Raiders",9,16,-2,FALSE,"12/1/1991",1991,"December","1990s",53,25,10
"5674","199112010mia","Miami Dolphins",33,"Tampa Bay Buccaneers",14,47,19,TRUE,"12/1/1991",1991,"December","1990s",79,82,10
"5675","199112010den","Denver Broncos",20,"New England Patriots",3,23,17,TRUE,"12/1/1991",1991,"December","1990s",14,65,6
"5676","199112020oti","Houston Oilers",6,"Philadelphia Eagles",13,19,-7,FALSE,"12/2/1991",1991,"December","1990s",72,NA,NA
"5677","199112080sea","Seattle Seahawks",22,"San Francisco 49ers",24,46,-2,FALSE,"12/8/1991",1991,"December","1990s",72,NA,NA
"5678","199112080nyg","New York Giants",14,"Philadelphia Eagles",19,33,-5,FALSE,"12/8/1991",1991,"December","1990s",52,59,11
"5679","199112080ram","Los Angeles Rams",14,"Atlanta Falcons",31,45,-17,FALSE,"12/8/1991",1991,"December","1990s",54,79,8
"5680","199112080rai","Los Angeles Raiders",27,"Buffalo Bills",30,57,-3,FALSE,"12/8/1991",1991,"December","1990s",54,79,8
"5681","199112080cle","Cleveland Browns",7,"Denver Broncos",17,24,-10,FALSE,"12/8/1991",1991,"December","1990s",54,73,16
"5682","199112080oti","Houston Oilers",31,"Pittsburgh Steelers",6,37,25,TRUE,"12/8/1991",1991,"December","1990s",72,NA,NA
"5683","199112080chi","Chicago Bears",27,"Green Bay Packers",13,40,14,TRUE,"12/8/1991",1991,"December","1990s",53,94,15
"5684","199112080dal","Dallas Cowboys",23,"New Orleans Saints",14,37,9,TRUE,"12/8/1991",1991,"December","1990s",70,84,14
"5685","199112080det","Detroit Lions",34,"New York Jets",20,54,14,TRUE,"12/8/1991",1991,"December","1990s",72,NA,NA
"5686","199112080kan","Kansas City Chiefs",20,"San Diego Chargers",17,37,3,TRUE,"12/8/1991",1991,"December","1990s",58,78,22
"5687","199112080nwe","New England Patriots",23,"Indianapolis Colts",17,40,6,TRUE,"12/8/1991",1991,"December","1990s",44,66,14
"5688","199112080crd","Phoenix Cardinals",14,"Washington Redskins",20,34,-6,FALSE,"12/8/1991",1991,"December","1990s",59,45,6
"5689","199112080tam","Tampa Bay Buccaneers",24,"Minnesota Vikings",26,50,-2,FALSE,"12/8/1991",1991,"December","1990s",69,71,7
"5690","199112090mia","Miami Dolphins",37,"Cincinnati Bengals",13,50,24,TRUE,"12/9/1991",1991,"December","1990s",73,74,7
"5691","199112140sfo","San Francisco 49ers",28,"Kansas City Chiefs",14,42,14,TRUE,"12/14/1991",1991,"December","1990s",47,74,10
"5692","199112140chi","Chicago Bears",27,"Tampa Bay Buccaneers",0,27,27,TRUE,"12/14/1991",1991,"December","1990s",32,73,22
"5693","199112150atl","Atlanta Falcons",26,"Seattle Seahawks",13,39,13,TRUE,"12/15/1991",1991,"December","1990s",42,34,16
"5694","199112150sdg","San Diego Chargers",38,"Miami Dolphins",30,68,8,TRUE,"12/15/1991",1991,"December","1990s",60,47,8
"5695","199112150was","Washington Redskins",34,"New York Giants",17,51,17,TRUE,"12/15/1991",1991,"December","1990s",40,31,19
"5696","199112150clt","Indianapolis Colts",7,"Buffalo Bills",35,42,-28,FALSE,"12/15/1991",1991,"December","1990s",72,NA,NA
"5697","199112150pit","Pittsburgh Steelers",17,"Cincinnati Bengals",10,27,7,TRUE,"12/15/1991",1991,"December","1990s",29,53,23
"5698","199112150den","Denver Broncos",24,"Phoenix Cardinals",19,43,5,TRUE,"12/15/1991",1991,"December","1990s",34,39,8
"5699","199112150gnb","Green Bay Packers",17,"Detroit Lions",21,38,-4,FALSE,"12/15/1991",1991,"December","1990s",10,62,15
"5700","199112150nyj","New York Jets",3,"New England Patriots",6,9,-3,FALSE,"12/15/1991",1991,"December","1990s",39,38,30
"5701","199112150cle","Cleveland Browns",14,"Houston Oilers",17,31,-3,FALSE,"12/15/1991",1991,"December","1990s",28,59,21
"5702","199112150phi","Philadelphia Eagles",13,"Dallas Cowboys",25,38,-12,FALSE,"12/15/1991",1991,"December","1990s",38,40,22
"5703","199112150min","Minnesota Vikings",20,"Los Angeles Rams",14,34,6,TRUE,"12/15/1991",1991,"December","1990s",72,NA,NA
"5704","199112160nor","New Orleans Saints",27,"Los Angeles Raiders",0,27,27,TRUE,"12/16/1991",1991,"December","1990s",72,NA,NA
"5705","199112210min","Minnesota Vikings",7,"Green Bay Packers",27,34,-20,FALSE,"12/21/1991",1991,"December","1990s",72,NA,NA
"5706","199112210nyg","New York Giants",24,"Houston Oilers",20,44,4,TRUE,"12/21/1991",1991,"December","1990s",39,49,20
"5707","199112220dal","Dallas Cowboys",31,"Atlanta Falcons",27,58,4,TRUE,"12/22/1991",1991,"December","1990s",48,97,8
"5708","199112220rai","Los Angeles Raiders",21,"Kansas City Chiefs",27,48,-6,FALSE,"12/22/1991",1991,"December","1990s",58,60,9
"5709","199112220sea","Seattle Seahawks",23,"Los Angeles Rams",9,32,14,TRUE,"12/22/1991",1991,"December","1990s",72,NA,NA
"5710","199112220buf","Buffalo Bills",14,"Detroit Lions",17,31,-3,FALSE,"12/22/1991",1991,"December","1990s",35,74,22
"5711","199112220pit","Pittsburgh Steelers",17,"Cleveland Browns",10,27,7,TRUE,"12/22/1991",1991,"December","1990s",32,82,15
"5712","199112220tam","Tampa Bay Buccaneers",17,"Indianapolis Colts",3,20,14,TRUE,"12/22/1991",1991,"December","1990s",62,72,5
"5713","199112220crd","Phoenix Cardinals",3,"New Orleans Saints",27,30,-24,FALSE,"12/22/1991",1991,"December","1990s",55,73,5
"5714","199112220sdg","San Diego Chargers",14,"Denver Broncos",17,31,-3,FALSE,"12/22/1991",1991,"December","1990s",57,55,6
"5715","199112220phi","Philadelphia Eagles",24,"Washington Redskins",22,46,2,TRUE,"12/22/1991",1991,"December","1990s",37,57,11
"5716","199112220cin","Cincinnati Bengals",29,"New England Patriots",7,36,22,TRUE,"12/22/1991",1991,"December","1990s",34,96,10
"5717","199112220mia","Miami Dolphins",20,"New York Jets",23,43,-3,FALSE,"12/22/1991",1991,"December","1990s",71,64,6
"5718","199112230sfo","San Francisco 49ers",52,"Chicago Bears",14,66,38,TRUE,"12/23/1991",1991,"December","1990s",48,74,5
"5719","199112280nor","New Orleans Saints",20,"Atlanta Falcons",27,47,-7,FALSE,"12/28/1991",1991,"December","1990s",72,NA,NA
"5720","199112280kan","Kansas City Chiefs",10,"Los Angeles Raiders",6,16,4,TRUE,"12/28/1991",1991,"December","1990s",35,90,8
"5721","199112290oti","Houston Oilers",17,"New York Jets",10,27,7,TRUE,"12/29/1991",1991,"December","1990s",72,NA,NA
"5722","199112290chi","Chicago Bears",13,"Dallas Cowboys",17,30,-4,FALSE,"12/29/1991",1991,"December","1990s",34,94,9
"5723","199201040den","Denver Broncos",26,"Houston Oilers",24,50,2,TRUE,"1/4/1992",1992,"January","1990s",30,63,7
"5724","199201040was","Washington Redskins",24,"Atlanta Falcons",7,31,17,TRUE,"1/4/1992",1992,"January","1990s",49,94,25
"5725","199201050buf","Buffalo Bills",37,"Kansas City Chiefs",14,51,23,TRUE,"1/5/1992",1992,"January","1990s",37,91,11
"5726","199201050det","Detroit Lions",38,"Dallas Cowboys",6,44,32,TRUE,"1/5/1992",1992,"January","1990s",72,NA,NA
"5727","199201120was","Washington Redskins",41,"Detroit Lions",10,51,31,TRUE,"1/12/1992",1992,"January","1990s",40,68,8
"5728","199201120buf","Buffalo Bills",10,"Denver Broncos",7,17,3,TRUE,"1/12/1992",1992,"January","1990s",33,78,12
"5729","199201260buf","Buffalo Bills",24,"Washington Redskins",37,61,-13,FALSE,"1/26/1992",1992,"January","1990s",72,NA,NA
"5730","199209060atl","Atlanta Falcons",20,"New York Jets",17,37,3,TRUE,"9/6/1992",1992,"September","1990s",72,NA,NA
"5731","199209060tam","Tampa Bay Buccaneers",23,"Phoenix Cardinals",7,30,16,TRUE,"9/6/1992",1992,"September","1990s",81,75,6
"5732","199209060den","Denver Broncos",17,"Los Angeles Raiders",13,30,4,TRUE,"9/6/1992",1992,"September","1990s",64,34,9
"5733","199209060sea","Seattle Seahawks",3,"Cincinnati Bengals",21,24,-18,FALSE,"9/6/1992",1992,"September","1990s",72,NA,NA
"5734","199209060oti","Houston Oilers",24,"Pittsburgh Steelers",29,53,-5,FALSE,"9/6/1992",1992,"September","1990s",72,NA,NA
"5735","199209060phi","Philadelphia Eagles",15,"New Orleans Saints",13,28,2,TRUE,"9/6/1992",1992,"September","1990s",68,84,12
"5736","199209060chi","Chicago Bears",27,"Detroit Lions",24,51,3,TRUE,"9/6/1992",1992,"September","1990s",74,77,12
"5737","199209060clt","Indianapolis Colts",14,"Cleveland Browns",3,17,11,TRUE,"9/6/1992",1992,"September","1990s",72,NA,NA
"5738","199209060buf","Buffalo Bills",40,"Los Angeles Rams",7,47,33,TRUE,"9/6/1992",1992,"September","1990s",73,74,11
"5739","199209060sdg","San Diego Chargers",10,"Kansas City Chiefs",24,34,-14,FALSE,"9/6/1992",1992,"September","1990s",70,77,10
"5740","199209060nyg","New York Giants",14,"San Francisco 49ers",31,45,-17,FALSE,"9/6/1992",1992,"September","1990s",68,75,12
"5741","199209060gnb","Green Bay Packers",20,"Minnesota Vikings",23,43,-3,FALSE,"9/6/1992",1992,"September","1990s",68,88,9
"5742","199209070dal","Dallas Cowboys",23,"Washington Redskins",10,33,13,TRUE,"9/7/1992",1992,"September","1990s",83,67,11
"5743","199209130ram","Los Angeles Rams",14,"New England Patriots",0,14,14,TRUE,"9/13/1992",1992,"September","1990s",68,80,10
"5744","199209130cin","Cincinnati Bengals",24,"Los Angeles Raiders",21,45,3,TRUE,"9/13/1992",1992,"September","1990s",63,73,5
"5745","199209130nyg","New York Giants",28,"Dallas Cowboys",34,62,-6,FALSE,"9/13/1992",1992,"September","1990s",64,59,9
"5746","199209130crd","Phoenix Cardinals",14,"Philadelphia Eagles",31,45,-17,FALSE,"9/13/1992",1992,"September","1990s",92,30,7
"5747","199209130pit","Pittsburgh Steelers",27,"New York Jets",10,37,17,TRUE,"9/13/1992",1992,"September","1990s",60,67,7
"5748","199209130sfo","San Francisco 49ers",31,"Buffalo Bills",34,65,-3,FALSE,"9/13/1992",1992,"September","1990s",65,60,13
"5749","199209130clt","Indianapolis Colts",10,"Houston Oilers",20,30,-10,FALSE,"9/13/1992",1992,"September","1990s",72,NA,NA
"5750","199209130den","Denver Broncos",21,"San Diego Chargers",13,34,8,TRUE,"9/13/1992",1992,"September","1990s",74,28,11
"5751","199209130tam","Tampa Bay Buccaneers",31,"Green Bay Packers",3,34,28,TRUE,"9/13/1992",1992,"September","1990s",80,78,10
"5752","199209130nor","New Orleans Saints",28,"Chicago Bears",6,34,22,TRUE,"9/13/1992",1992,"September","1990s",72,NA,NA
"5753","199209130was","Washington Redskins",24,"Atlanta Falcons",17,41,7,TRUE,"9/13/1992",1992,"September","1990s",64,66,6
"5754","199209130kan","Kansas City Chiefs",26,"Seattle Seahawks",7,33,19,TRUE,"9/13/1992",1992,"September","1990s",74,69,20
"5755","199209130det","Detroit Lions",31,"Minnesota Vikings",17,48,14,TRUE,"9/13/1992",1992,"September","1990s",72,NA,NA
"5756","199209140cle","Cleveland Browns",23,"Miami Dolphins",27,50,-4,FALSE,"9/14/1992",1992,"September","1990s",66,71,9
"5757","199209200nwe","New England Patriots",6,"Seattle Seahawks",10,16,-4,FALSE,"9/20/1992",1992,"September","1990s",59,63,10
"5758","199209200mia","Miami Dolphins",26,"Los Angeles Rams",10,36,16,TRUE,"9/20/1992",1992,"September","1990s",82,78,6
"5759","199209200atl","Atlanta Falcons",7,"New Orleans Saints",10,17,-3,FALSE,"9/20/1992",1992,"September","1990s",72,NA,NA
"5760","199209200rai","Los Angeles Raiders",16,"Cleveland Browns",28,44,-12,FALSE,"9/20/1992",1992,"September","1990s",68,84,9
"5761","199209200buf","Buffalo Bills",38,"Indianapolis Colts",0,38,38,TRUE,"9/20/1992",1992,"September","1990s",56,64,6
"5762","199209200dal","Dallas Cowboys",31,"Phoenix Cardinals",20,51,11,TRUE,"9/20/1992",1992,"September","1990s",84,62,13
"5763","199209200min","Minnesota Vikings",26,"Tampa Bay Buccaneers",20,46,6,TRUE,"9/20/1992",1992,"September","1990s",72,NA,NA
"5764","199209200was","Washington Redskins",13,"Detroit Lions",10,23,3,TRUE,"9/20/1992",1992,"September","1990s",68,61,9
"5765","199209200nyj","New York Jets",14,"San Francisco 49ers",31,45,-17,FALSE,"9/20/1992",1992,"September","1990s",66,48,10
"5766","199209200phi","Philadelphia Eagles",30,"Denver Broncos",0,30,30,TRUE,"9/20/1992",1992,"September","1990s",67,50,9
"5767","199209200gnb","Green Bay Packers",24,"Cincinnati Bengals",23,47,1,TRUE,"9/20/1992",1992,"September","1990s",56,68,11
"5768","199209200oti","Houston Oilers",23,"Kansas City Chiefs",20,43,3,TRUE,"9/20/1992",1992,"September","1990s",72,NA,NA
"5769","199209200sdg","San Diego Chargers",6,"Pittsburgh Steelers",23,29,-17,FALSE,"9/20/1992",1992,"September","1990s",70,80,8
"5770","199209210chi","Chicago Bears",14,"New York Giants",27,41,-13,FALSE,"9/21/1992",1992,"September","1990s",63,96,10
"5771","199209270sea","Seattle Seahawks",17,"Miami Dolphins",19,36,-2,FALSE,"9/27/1992",1992,"September","1990s",72,NA,NA
"5772","199209270cin","Cincinnati Bengals",7,"Minnesota Vikings",42,49,-35,FALSE,"9/27/1992",1992,"September","1990s",63,79,12
"5773","199209270cle","Cleveland Browns",0,"Denver Broncos",12,12,-12,FALSE,"9/27/1992",1992,"September","1990s",66,74,14
"5774","199209270nor","New Orleans Saints",10,"San Francisco 49ers",16,26,-6,FALSE,"9/27/1992",1992,"September","1990s",72,NA,NA
"5775","199209270oti","Houston Oilers",27,"San Diego Chargers",0,27,27,TRUE,"9/27/1992",1992,"September","1990s",72,NA,NA
"5776","199209270chi","Chicago Bears",41,"Atlanta Falcons",31,72,10,TRUE,"9/27/1992",1992,"September","1990s",60,70,14
"5777","199209270det","Detroit Lions",23,"Tampa Bay Buccaneers",27,50,-4,FALSE,"9/27/1992",1992,"September","1990s",72,NA,NA
"5778","199209270ram","Los Angeles Rams",18,"New York Jets",10,28,8,TRUE,"9/27/1992",1992,"September","1990s",69,83,9
"5779","199209270gnb","Green Bay Packers",17,"Pittsburgh Steelers",3,20,14,TRUE,"9/27/1992",1992,"September","1990s",56,75,12
"5780","199209270nwe","New England Patriots",7,"Buffalo Bills",41,48,-34,FALSE,"9/27/1992",1992,"September","1990s",66,87,12
"5781","199209280kan","Kansas City Chiefs",27,"Los Angeles Raiders",7,34,20,TRUE,"9/28/1992",1992,"September","1990s",58,60,13
"5782","199210040crd","Phoenix Cardinals",27,"Washington Redskins",24,51,3,TRUE,"10/4/1992",1992,"October","1990s",82,22,7
"5783","199210040nyj","New York Jets",30,"New England Patriots",21,51,9,TRUE,"10/4/1992",1992,"October","1990s",65,61,13
"5784","199210040tam","Tampa Bay Buccaneers",14,"Indianapolis Colts",24,38,-10,FALSE,"10/4/1992",1992,"October","1990s",81,81,14
"5785","199210040rai","Los Angeles Raiders",13,"New York Giants",10,23,3,TRUE,"10/4/1992",1992,"October","1990s",66,72,8
"5786","199210040sdg","San Diego Chargers",17,"Seattle Seahawks",6,23,11,TRUE,"10/4/1992",1992,"October","1990s",68,73,7
"5787","199210040min","Minnesota Vikings",21,"Chicago Bears",20,41,1,TRUE,"10/4/1992",1992,"October","1990s",72,NA,NA
"5788","199210040atl","Atlanta Falcons",24,"Green Bay Packers",10,34,14,TRUE,"10/4/1992",1992,"October","1990s",72,NA,NA
"5789","199210040sfo","San Francisco 49ers",27,"Los Angeles Rams",24,51,3,TRUE,"10/4/1992",1992,"October","1990s",64,66,12
"5790","199210040buf","Buffalo Bills",10,"Miami Dolphins",37,47,-27,FALSE,"10/4/1992",1992,"October","1990s",53,58,9
"5791","199210040den","Denver Broncos",20,"Kansas City Chiefs",19,39,1,TRUE,"10/4/1992",1992,"October","1990s",64,24,12
"5792","199210040det","Detroit Lions",7,"New Orleans Saints",13,20,-6,FALSE,"10/4/1992",1992,"October","1990s",72,NA,NA
"5793","199210050phi","Philadelphia Eagles",31,"Dallas Cowboys",7,38,24,TRUE,"10/5/1992",1992,"October","1990s",56,48,16
"5794","199210110nyg","New York Giants",31,"Phoenix Cardinals",21,52,10,TRUE,"10/11/1992",1992,"October","1990s",63,77,6
"5795","199210110cle","Cleveland Browns",17,"Pittsburgh Steelers",9,26,8,TRUE,"10/11/1992",1992,"October","1990s",51,92,10
"5796","199210110clt","Indianapolis Colts",6,"New York Jets",3,9,3,TRUE,"10/11/1992",1992,"October","1990s",72,NA,NA
"5797","199210110dal","Dallas Cowboys",27,"Seattle Seahawks",0,27,27,TRUE,"10/11/1992",1992,"October","1990s",66,48,4
"5798","199210110cin","Cincinnati Bengals",24,"Houston Oilers",38,62,-14,FALSE,"10/11/1992",1992,"October","1990s",50,81,10
"5799","199210110nwe","New England Patriots",12,"San Francisco 49ers",24,36,-12,FALSE,"10/11/1992",1992,"October","1990s",59,95,6
"5800","199210110rai","Los Angeles Raiders",20,"Buffalo Bills",3,23,17,TRUE,"10/11/1992",1992,"October","1990s",64,88,10
"5801","199210110kan","Kansas City Chiefs",24,"Philadelphia Eagles",17,41,7,TRUE,"10/11/1992",1992,"October","1990s",50,57,10
"5802","199210110mia","Miami Dolphins",21,"Atlanta Falcons",17,38,4,TRUE,"10/11/1992",1992,"October","1990s",83,74,9
"5803","199210110nor","New Orleans Saints",13,"Los Angeles Rams",10,23,3,TRUE,"10/11/1992",1992,"October","1990s",72,NA,NA
"5804","199210120was","Washington Redskins",34,"Denver Broncos",3,37,31,TRUE,"10/12/1992",1992,"October","1990s",57,63,11
"5805","199210150min","Minnesota Vikings",31,"Detroit Lions",14,45,17,TRUE,"10/15/1992",1992,"October","1990s",72,NA,NA
"5806","199210180crd","Phoenix Cardinals",21,"New Orleans Saints",30,51,-9,FALSE,"10/18/1992",1992,"October","1990s",79,20,6
"5807","199210180was","Washington Redskins",16,"Philadelphia Eagles",12,28,4,TRUE,"10/18/1992",1992,"October","1990s",48,55,9
"5808","199210180chi","Chicago Bears",31,"Tampa Bay Buccaneers",14,45,17,TRUE,"10/18/1992",1992,"October","1990s",41,54,13
"5809","199210180ram","Los Angeles Rams",38,"New York Giants",17,55,21,TRUE,"10/18/1992",1992,"October","1990s",66,80,8
"5810","199210180clt","Indianapolis Colts",14,"San Diego Chargers",34,48,-20,FALSE,"10/18/1992",1992,"October","1990s",72,NA,NA
"5811","199210180mia","Miami Dolphins",38,"New England Patriots",17,55,21,TRUE,"10/18/1992",1992,"October","1990s",80,76,7
"5812","199210180cle","Cleveland Browns",17,"Green Bay Packers",6,23,11,TRUE,"10/18/1992",1992,"October","1990s",38,84,11
"5813","199210180dal","Dallas Cowboys",17,"Kansas City Chiefs",10,27,7,TRUE,"10/18/1992",1992,"October","1990s",60,71,5
"5814","199210180sfo","San Francisco 49ers",56,"Atlanta Falcons",17,73,39,TRUE,"10/18/1992",1992,"October","1990s",60,81,12
"5815","199210180den","Denver Broncos",27,"Houston Oilers",21,48,6,TRUE,"10/18/1992",1992,"October","1990s",47,37,8
"5816","199210180sea","Seattle Seahawks",0,"Los Angeles Raiders",19,19,-19,FALSE,"10/18/1992",1992,"October","1990s",72,NA,NA
"5817","199210190pit","Pittsburgh Steelers",20,"Cincinnati Bengals",0,20,20,TRUE,"10/19/1992",1992,"October","1990s",36,76,16
"5818","199210250tam","Tampa Bay Buccaneers",7,"Detroit Lions",38,45,-31,FALSE,"10/25/1992",1992,"October","1990s",66,78,8
"5819","199210250phi","Philadelphia Eagles",7,"Phoenix Cardinals",3,10,4,TRUE,"10/25/1992",1992,"October","1990s",51,54,13
"5820","199210250mia","Miami Dolphins",20,"Indianapolis Colts",31,51,-11,FALSE,"10/25/1992",1992,"October","1990s",76,71,9
"5821","199210250min","Minnesota Vikings",13,"Washington Redskins",15,28,-2,FALSE,"10/25/1992",1992,"October","1990s",72,NA,NA
"5822","199210250nwe","New England Patriots",17,"Cleveland Browns",19,36,-2,FALSE,"10/25/1992",1992,"October","1990s",48,82,17
"5823","199210250nyg","New York Giants",23,"Seattle Seahawks",10,33,13,TRUE,"10/25/1992",1992,"October","1990s",50,68,20
"5824","199210250gnb","Green Bay Packers",10,"Chicago Bears",30,40,-20,FALSE,"10/25/1992",1992,"October","1990s",48,86,8
"5825","199210250oti","Houston Oilers",26,"Cincinnati Bengals",10,36,16,TRUE,"10/25/1992",1992,"October","1990s",72,NA,NA
"5826","199210250rai","Los Angeles Raiders",13,"Dallas Cowboys",28,41,-15,FALSE,"10/25/1992",1992,"October","1990s",67,80,9
"5827","199210250kan","Kansas City Chiefs",3,"Pittsburgh Steelers",27,30,-24,FALSE,"10/25/1992",1992,"October","1990s",61,58,9
"5828","199210250sdg","San Diego Chargers",24,"Denver Broncos",21,45,3,TRUE,"10/25/1992",1992,"October","1990s",67,76,8
"5829","199210260nyj","New York Jets",20,"Buffalo Bills",24,44,-4,FALSE,"10/26/1992",1992,"October","1990s",46,49,19
"5830","199211010pit","Pittsburgh Steelers",21,"Houston Oilers",20,41,1,TRUE,"11/1/1992",1992,"November","1990s",42,86,12
"5831","199211010dal","Dallas Cowboys",20,"Philadelphia Eagles",10,30,10,TRUE,"11/1/1992",1992,"November","1990s",68,71,22
"5832","199211010buf","Buffalo Bills",16,"New England Patriots",7,23,9,TRUE,"11/1/1992",1992,"November","1990s",37,64,11
"5833","199211010nyj","New York Jets",26,"Miami Dolphins",14,40,12,TRUE,"11/1/1992",1992,"November","1990s",46,60,13
"5834","199211010cin","Cincinnati Bengals",30,"Cleveland Browns",10,40,20,TRUE,"11/1/1992",1992,"November","1990s",52,85,12
"5835","199211010sdg","San Diego Chargers",26,"Indianapolis Colts",0,26,26,TRUE,"11/1/1992",1992,"November","1990s",66,65,9
"5836","199211010atl","Atlanta Falcons",30,"Los Angeles Rams",28,58,2,TRUE,"11/1/1992",1992,"November","1990s",72,NA,NA
"5837","199211010det","Detroit Lions",13,"Green Bay Packers",27,40,-14,FALSE,"11/1/1992",1992,"November","1990s",72,NA,NA
"5838","199211010was","Washington Redskins",7,"New York Giants",24,31,-17,FALSE,"11/1/1992",1992,"November","1990s",46,97,10
"5839","199211010nor","New Orleans Saints",23,"Tampa Bay Buccaneers",21,44,2,TRUE,"11/1/1992",1992,"November","1990s",72,NA,NA
"5840","199211010crd","Phoenix Cardinals",24,"San Francisco 49ers",14,38,10,TRUE,"11/1/1992",1992,"November","1990s",68,29,8
"5841","199211020chi","Chicago Bears",10,"Minnesota Vikings",38,48,-28,FALSE,"11/2/1992",1992,"November","1990s",50,90,18
"5842","199211080sea","Seattle Seahawks",3,"Washington Redskins",16,19,-13,FALSE,"11/8/1992",1992,"November","1990s",72,NA,NA
"5843","199211080den","Denver Broncos",27,"New York Jets",16,43,11,TRUE,"11/8/1992",1992,"November","1990s",43,47,10
"5844","199211080nyg","New York Giants",27,"Green Bay Packers",7,34,20,TRUE,"11/8/1992",1992,"November","1990s",37,53,12
"5845","199211080buf","Buffalo Bills",28,"Pittsburgh Steelers",20,48,8,TRUE,"11/8/1992",1992,"November","1990s",27,67,5
"5846","199211080kan","Kansas City Chiefs",16,"San Diego Chargers",14,30,2,TRUE,"11/8/1992",1992,"November","1990s",43,72,18
"5847","199211080oti","Houston Oilers",14,"Cleveland Browns",24,38,-10,FALSE,"11/8/1992",1992,"November","1990s",72,NA,NA
"5848","199211080tam","Tampa Bay Buccaneers",7,"Minnesota Vikings",35,42,-28,FALSE,"11/8/1992",1992,"November","1990s",59,74,10
"5849","199211080nwe","New England Patriots",14,"New Orleans Saints",31,45,-17,FALSE,"11/8/1992",1992,"November","1990s",34,52,14
"5850","199211080phi","Philadelphia Eagles",31,"Los Angeles Raiders",10,41,21,TRUE,"11/8/1992",1992,"November","1990s",39,47,11
"5851","199211080clt","Indianapolis Colts",0,"Miami Dolphins",28,28,-28,FALSE,"11/8/1992",1992,"November","1990s",72,NA,NA
"5852","199211080det","Detroit Lions",3,"Dallas Cowboys",37,40,-34,FALSE,"11/8/1992",1992,"November","1990s",72,NA,NA
"5853","199211080chi","Chicago Bears",28,"Cincinnati Bengals",31,59,-3,FALSE,"11/8/1992",1992,"November","1990s",36,84,10
"5854","199211080ram","Los Angeles Rams",14,"Phoenix Cardinals",20,34,-6,FALSE,"11/8/1992",1992,"November","1990s",64,81,8
"5855","199211090atl","Atlanta Falcons",3,"San Francisco 49ers",41,44,-38,FALSE,"11/9/1992",1992,"November","1990s",72,NA,NA
"5856","199211150min","Minnesota Vikings",13,"Houston Oilers",17,30,-4,FALSE,"11/15/1992",1992,"November","1990s",72,NA,NA
"5857","199211150sfo","San Francisco 49ers",21,"New Orleans Saints",20,41,1,TRUE,"11/15/1992",1992,"November","1990s",56,74,8
"5858","199211150kan","Kansas City Chiefs",35,"Washington Redskins",16,51,19,TRUE,"11/15/1992",1992,"November","1990s",40,64,9
"5859","199211150clt","Indianapolis Colts",34,"New England Patriots",37,71,-3,FALSE,"11/15/1992",1992,"November","1990s",72,NA,NA
"5860","199211150pit","Pittsburgh Steelers",17,"Detroit Lions",14,31,3,TRUE,"11/15/1992",1992,"November","1990s",30,79,14
"5861","199211150cle","Cleveland Browns",13,"San Diego Chargers",14,27,-1,FALSE,"11/15/1992",1992,"November","1990s",28,76,11
"5862","199211150atl","Atlanta Falcons",20,"Phoenix Cardinals",17,37,3,TRUE,"11/15/1992",1992,"November","1990s",72,NA,NA
"5863","199211150gnb","Green Bay Packers",27,"Philadelphia Eagles",24,51,3,TRUE,"11/15/1992",1992,"November","1990s",30,54,11
"5864","199211150nyj","New York Jets",17,"Cincinnati Bengals",14,31,3,TRUE,"11/15/1992",1992,"November","1990s",38,46,16
"5865","199211150den","Denver Broncos",27,"New York Giants",13,40,14,TRUE,"11/15/1992",1992,"November","1990s",46,42,9
"5866","199211150rai","Los Angeles Raiders",20,"Seattle Seahawks",3,23,17,TRUE,"11/15/1992",1992,"November","1990s",63,67,7
"5867","199211150tam","Tampa Bay Buccaneers",20,"Chicago Bears",17,37,3,TRUE,"11/15/1992",1992,"November","1990s",58,46,10
"5868","199211150dal","Dallas Cowboys",23,"Los Angeles Rams",27,50,-4,FALSE,"11/15/1992",1992,"November","1990s",56,54,8
"5869","199211160mia","Miami Dolphins",20,"Buffalo Bills",26,46,-6,FALSE,"11/16/1992",1992,"November","1990s",70,68,14
"5870","199211220sea","Seattle Seahawks",14,"Kansas City Chiefs",24,38,-10,FALSE,"11/22/1992",1992,"November","1990s",72,NA,NA
"5871","199211220nwe","New England Patriots",24,"New York Jets",3,27,21,TRUE,"11/22/1992",1992,"November","1990s",58,87,16
"5872","199211220sdg","San Diego Chargers",29,"Tampa Bay Buccaneers",14,43,15,TRUE,"11/22/1992",1992,"November","1990s",58,42,8
"5873","199211220mia","Miami Dolphins",19,"Houston Oilers",16,35,3,TRUE,"11/22/1992",1992,"November","1990s",79,85,19
"5874","199211220ram","Los Angeles Rams",10,"San Francisco 49ers",27,37,-17,FALSE,"11/22/1992",1992,"November","1990s",57,35,9
"5875","199211220rai","Los Angeles Raiders",24,"Denver Broncos",0,24,24,TRUE,"11/22/1992",1992,"November","1990s",57,35,9
"5876","199211220nyg","New York Giants",34,"Philadelphia Eagles",47,81,-13,FALSE,"11/22/1992",1992,"November","1990s",60,88,13
"5877","199211220min","Minnesota Vikings",17,"Cleveland Browns",13,30,4,TRUE,"11/22/1992",1992,"November","1990s",72,NA,NA
"5878","199211220cin","Cincinnati Bengals",13,"Detroit Lions",19,32,-6,FALSE,"11/22/1992",1992,"November","1990s",60,91,13
"5879","199211220pit","Pittsburgh Steelers",30,"Indianapolis Colts",14,44,16,TRUE,"11/22/1992",1992,"November","1990s",58,97,8
"5880","199211220buf","Buffalo Bills",41,"Atlanta Falcons",14,55,27,TRUE,"11/22/1992",1992,"November","1990s",50,87,11
"5881","199211220chi","Chicago Bears",3,"Green Bay Packers",17,20,-14,FALSE,"11/22/1992",1992,"November","1990s",42,89,18
"5882","199211220crd","Phoenix Cardinals",10,"Dallas Cowboys",16,26,-6,FALSE,"11/22/1992",1992,"November","1990s",56,29,4
"5883","199211230nor","New Orleans Saints",20,"Washington Redskins",3,23,17,TRUE,"11/23/1992",1992,"November","1990s",72,NA,NA
"5884","199211260dal","Dallas Cowboys",30,"New York Giants",3,33,27,TRUE,"11/26/1992",1992,"November","1990s",38,64,15
"5885","199211260det","Detroit Lions",21,"Houston Oilers",24,45,-3,FALSE,"11/26/1992",1992,"November","1990s",72,NA,NA
"5886","199211290nor","New Orleans Saints",24,"Miami Dolphins",13,37,11,TRUE,"11/29/1992",1992,"November","1990s",72,NA,NA
"5887","199211290ram","Los Angeles Rams",17,"Minnesota Vikings",31,48,-14,FALSE,"11/29/1992",1992,"November","1990s",62,30,7
"5888","199211290clt","Indianapolis Colts",16,"Buffalo Bills",13,29,3,TRUE,"11/29/1992",1992,"November","1990s",72,NA,NA
"5889","199211290cin","Cincinnati Bengals",9,"Pittsburgh Steelers",21,30,-12,FALSE,"11/29/1992",1992,"November","1990s",31,72,9
"5890","199211290nyj","New York Jets",7,"Kansas City Chiefs",23,30,-16,FALSE,"11/29/1992",1992,"November","1990s",44,66,10
"5891","199211290was","Washington Redskins",41,"Phoenix Cardinals",3,44,38,TRUE,"11/29/1992",1992,"November","1990s",44,62,11
"5892","199211290sdg","San Diego Chargers",27,"Los Angeles Raiders",3,30,24,TRUE,"11/29/1992",1992,"November","1990s",62,37,8
"5893","199211290gnb","Green Bay Packers",19,"Tampa Bay Buccaneers",14,33,5,TRUE,"11/29/1992",1992,"November","1990s",32,81,12
"5894","199211290sfo","San Francisco 49ers",20,"Philadelphia Eagles",14,34,6,TRUE,"11/29/1992",1992,"November","1990s",53,55,9
"5895","199211290cle","Cleveland Browns",27,"Chicago Bears",14,41,13,TRUE,"11/29/1992",1992,"November","1990s",33,76,11
"5896","199211290atl","Atlanta Falcons",34,"New England Patriots",0,34,34,TRUE,"11/29/1992",1992,"November","1990s",72,NA,NA
"5897","199211300sea","Seattle Seahawks",16,"Denver Broncos",13,29,3,TRUE,"11/30/1992",1992,"November","1990s",72,NA,NA
"5898","199212030nor","New Orleans Saints",22,"Atlanta Falcons",14,36,8,TRUE,"12/3/1992",1992,"December","1990s",72,NA,NA
"5899","199212060buf","Buffalo Bills",17,"New York Jets",24,41,-7,FALSE,"12/6/1992",1992,"December","1990s",26,71,22
"5900","199212060nyg","New York Giants",10,"Washington Redskins",28,38,-18,FALSE,"12/6/1992",1992,"December","1990s",31,53,24
"5901","199212060phi","Philadelphia Eagles",28,"Minnesota Vikings",17,45,11,TRUE,"12/6/1992",1992,"December","1990s",33,50,20
"5902","199212060pit","Pittsburgh Steelers",20,"Seattle Seahawks",14,34,6,TRUE,"12/6/1992",1992,"December","1990s",22,75,13
"5903","199212060nwe","New England Patriots",0,"Indianapolis Colts",6,6,-6,FALSE,"12/6/1992",1992,"December","1990s",26,48,23
"5904","199212060cle","Cleveland Browns",37,"Cincinnati Bengals",21,58,16,TRUE,"12/6/1992",1992,"December","1990s",25,67,13
"5905","199212060tam","Tampa Bay Buccaneers",27,"Los Angeles Rams",31,58,-4,FALSE,"12/6/1992",1992,"December","1990s",60,69,8
"5906","199212060den","Denver Broncos",27,"Dallas Cowboys",31,58,-4,FALSE,"12/6/1992",1992,"December","1990s",15,77,7
"5907","199212060rai","Los Angeles Raiders",28,"Kansas City Chiefs",7,35,21,TRUE,"12/6/1992",1992,"December","1990s",57,69,8
"5908","199212060sfo","San Francisco 49ers",27,"Miami Dolphins",3,30,24,TRUE,"12/6/1992",1992,"December","1990s",53,82,19
"5909","199212060crd","Phoenix Cardinals",21,"San Diego Chargers",27,48,-6,FALSE,"12/6/1992",1992,"December","1990s",52,65,3
"5910","199212060gnb","Green Bay Packers",38,"Detroit Lions",10,48,28,TRUE,"12/6/1992",1992,"December","1990s",21,70,12
"5911","199212070oti","Houston Oilers",24,"Chicago Bears",7,31,17,TRUE,"12/7/1992",1992,"December","1990s",72,NA,NA
"5912","199212120crd","Phoenix Cardinals",19,"New York Giants",0,19,19,TRUE,"12/12/1992",1992,"December","1990s",56,61,10
"5913","199212120buf","Buffalo Bills",27,"Denver Broncos",17,44,10,TRUE,"12/12/1992",1992,"December","1990s",31,90,12
"5914","199212130ram","Los Angeles Rams",14,"New Orleans Saints",37,51,-23,FALSE,"12/13/1992",1992,"December","1990s",55,30,15
"5915","199212130chi","Chicago Bears",30,"Pittsburgh Steelers",6,36,24,TRUE,"12/13/1992",1992,"December","1990s",34,89,12
"5916","199212130was","Washington Redskins",20,"Dallas Cowboys",17,37,3,TRUE,"12/13/1992",1992,"December","1990s",41,69,17
"5917","199212130kan","Kansas City Chiefs",27,"New England Patriots",20,47,7,TRUE,"12/13/1992",1992,"December","1990s",42,69,13
"5918","199212130tam","Tampa Bay Buccaneers",7,"Atlanta Falcons",35,42,-28,FALSE,"12/13/1992",1992,"December","1990s",50,74,6
"5919","199212130det","Detroit Lions",24,"Cleveland Browns",14,38,10,TRUE,"12/13/1992",1992,"December","1990s",72,NA,NA
"5920","199212130nyj","New York Jets",6,"Indianapolis Colts",10,16,-4,FALSE,"12/13/1992",1992,"December","1990s",37,80,21
"5921","199212130min","Minnesota Vikings",17,"San Francisco 49ers",20,37,-3,FALSE,"12/13/1992",1992,"December","1990s",72,NA,NA
"5922","199212130sea","Seattle Seahawks",17,"Philadelphia Eagles",20,37,-3,FALSE,"12/13/1992",1992,"December","1990s",72,NA,NA
"5923","199212130oti","Houston Oilers",14,"Green Bay Packers",16,30,-2,FALSE,"12/13/1992",1992,"December","1990s",72,NA,NA
"5924","199212130sdg","San Diego Chargers",27,"Cincinnati Bengals",10,37,17,TRUE,"12/13/1992",1992,"December","1990s",53,46,10
"5925","199212140mia","Miami Dolphins",20,"Los Angeles Raiders",7,27,13,TRUE,"12/14/1992",1992,"December","1990s",67,71,10
"5926","199212190sfo","San Francisco 49ers",21,"Tampa Bay Buccaneers",14,35,7,TRUE,"12/19/1992",1992,"December","1990s",44,68,6
"5927","199212190nyg","New York Giants",35,"Kansas City Chiefs",21,56,14,TRUE,"12/19/1992",1992,"December","1990s",40,66,11
"5928","199212200cin","Cincinnati Bengals",20,"New England Patriots",10,30,10,TRUE,"12/20/1992",1992,"December","1990s",38,73,11
"5929","199212200pit","Pittsburgh Steelers",3,"Minnesota Vikings",6,9,-3,FALSE,"12/20/1992",1992,"December","1990s",42,67,16
"5930","199212200phi","Philadelphia Eagles",17,"Washington Redskins",13,30,4,TRUE,"12/20/1992",1992,"December","1990s",46,74,14
"5931","199212200rai","Los Angeles Raiders",14,"San Diego Chargers",36,50,-22,FALSE,"12/20/1992",1992,"December","1990s",50,31,8
"5932","199212200clt","Indianapolis Colts",16,"Phoenix Cardinals",13,29,3,TRUE,"12/20/1992",1992,"December","1990s",72,NA,NA
"5933","199212200cle","Cleveland Browns",14,"Houston Oilers",17,31,-3,FALSE,"12/20/1992",1992,"December","1990s",37,71,13
"5934","199212200mia","Miami Dolphins",19,"New York Jets",17,36,2,TRUE,"12/20/1992",1992,"December","1990s",76,64,13
"5935","199212200det","Detroit Lions",16,"Chicago Bears",3,19,13,TRUE,"12/20/1992",1992,"December","1990s",72,NA,NA
"5936","199212200den","Denver Broncos",10,"Seattle Seahawks",6,16,4,TRUE,"12/20/1992",1992,"December","1990s",13,67,6
"5937","199212200nor","New Orleans Saints",16,"Buffalo Bills",20,36,-4,FALSE,"12/20/1992",1992,"December","1990s",72,NA,NA
"5938","199212200gnb","Green Bay Packers",28,"Los Angeles Rams",13,41,15,TRUE,"12/20/1992",1992,"December","1990s",10,63,12
"5939","199212210atl","Atlanta Falcons",17,"Dallas Cowboys",41,58,-24,FALSE,"12/21/1992",1992,"December","1990s",72,NA,NA
"5940","199212260was","Washington Redskins",20,"Los Angeles Raiders",21,41,-1,FALSE,"12/26/1992",1992,"December","1990s",38,32,16
"5941","199212260nyj","New York Jets",0,"New Orleans Saints",20,20,-20,FALSE,"12/26/1992",1992,"December","1990s",33,48,20
"5942","199212270sea","Seattle Seahawks",14,"San Diego Chargers",31,45,-17,FALSE,"12/27/1992",1992,"December","1990s",72,NA,NA
"5943","199212270ram","Los Angeles Rams",38,"Atlanta Falcons",27,65,11,TRUE,"12/27/1992",1992,"December","1990s",55,42,6
"5944","199212270oti","Houston Oilers",27,"Buffalo Bills",3,30,24,TRUE,"12/27/1992",1992,"December","1990s",72,NA,NA
"5945","199212270pit","Pittsburgh Steelers",23,"Cleveland Browns",13,36,10,TRUE,"12/27/1992",1992,"December","1990s",20,58,9
"5946","199212270min","Minnesota Vikings",27,"Green Bay Packers",7,34,20,TRUE,"12/27/1992",1992,"December","1990s",72,NA,NA
"5947","199212270kan","Kansas City Chiefs",42,"Denver Broncos",20,62,22,TRUE,"12/27/1992",1992,"December","1990s",38,49,17
"5948","199212270phi","Philadelphia Eagles",20,"New York Giants",10,30,10,TRUE,"12/27/1992",1992,"December","1990s",27,40,11
"5949","199212270dal","Dallas Cowboys",27,"Chicago Bears",14,41,13,TRUE,"12/27/1992",1992,"December","1990s",48,76,8
"5950","199212270cin","Cincinnati Bengals",17,"Indianapolis Colts",21,38,-4,FALSE,"12/27/1992",1992,"December","1990s",26,54,9
"5951","199212270nwe","New England Patriots",13,"Miami Dolphins",16,29,-3,FALSE,"12/27/1992",1992,"December","1990s",21,32,13
"5952","199212270crd","Phoenix Cardinals",3,"Tampa Bay Buccaneers",7,10,-4,FALSE,"12/27/1992",1992,"December","1990s",56,52,6
"5953","199212280sfo","San Francisco 49ers",24,"Detroit Lions",6,30,18,TRUE,"12/28/1992",1992,"December","1990s",50,86,19
"5954","199301020min","Minnesota Vikings",7,"Washington Redskins",24,31,-17,FALSE,"1/2/1993",1993,"January","1990s",72,NA,NA
"5955","199301020sdg","San Diego Chargers",17,"Kansas City Chiefs",0,17,17,TRUE,"1/2/1993",1993,"January","1990s",53,86,8
"5956","199301030nor","New Orleans Saints",20,"Philadelphia Eagles",36,56,-16,FALSE,"1/3/1993",1993,"January","1990s",72,NA,NA
"5957","199301030buf","Buffalo Bills",41,"Houston Oilers",38,79,3,TRUE,"1/3/1993",1993,"January","1990s",34,69,14
"5958","199301090sfo","San Francisco 49ers",20,"Washington Redskins",13,33,7,TRUE,"1/9/1993",1993,"January","1990s",46,86,11
"5959","199301090pit","Pittsburgh Steelers",3,"Buffalo Bills",24,27,-21,FALSE,"1/9/1993",1993,"January","1990s",31,75,14
"5960","199301100dal","Dallas Cowboys",34,"Philadelphia Eagles",10,44,24,TRUE,"1/10/1993",1993,"January","1990s",34,81,19
"5961","199301100mia","Miami Dolphins",31,"San Diego Chargers",0,31,31,TRUE,"1/10/1993",1993,"January","1990s",74,87,11
"5962","199301170sfo","San Francisco 49ers",20,"Dallas Cowboys",30,50,-10,FALSE,"1/17/1993",1993,"January","1990s",49,89,7
"5963","199301170mia","Miami Dolphins",10,"Buffalo Bills",29,39,-19,FALSE,"1/17/1993",1993,"January","1990s",64,66,9
"5964","199301310buf","Buffalo Bills",17,"Dallas Cowboys",52,69,-35,FALSE,"1/31/1993",1993,"January","1990s",56,63,10
"5965","199309050det","Detroit Lions",30,"Atlanta Falcons",13,43,17,TRUE,"9/5/1993",1993,"September","1990s",72,NA,NA
"5966","199309050nor","New Orleans Saints",33,"Houston Oilers",21,54,12,TRUE,"9/5/1993",1993,"September","1990s",72,NA,NA
"5967","199309050buf","Buffalo Bills",38,"New England Patriots",14,52,24,TRUE,"9/5/1993",1993,"September","1990s",66,73,12
"5968","199309050tam","Tampa Bay Buccaneers",3,"Kansas City Chiefs",27,30,-24,FALSE,"9/5/1993",1993,"September","1990s",82,74,6
"5969","199309050cle","Cleveland Browns",27,"Cincinnati Bengals",14,41,13,TRUE,"9/5/1993",1993,"September","1990s",66,74,8
"5970","199309050pit","Pittsburgh Steelers",13,"San Francisco 49ers",24,37,-11,FALSE,"9/5/1993",1993,"September","1990s",67,64,7
"5971","199309050phi","Philadelphia Eagles",23,"Phoenix Cardinals",17,40,6,TRUE,"9/5/1993",1993,"September","1990s",75,60,10
"5972","199309050gnb","Green Bay Packers",36,"Los Angeles Rams",6,42,30,TRUE,"9/5/1993",1993,"September","1990s",67,68,10
"5973","199309050chi","Chicago Bears",20,"New York Giants",26,46,-6,FALSE,"9/5/1993",1993,"September","1990s",66,80,10
"5974","199309050sdg","San Diego Chargers",18,"Seattle Seahawks",12,30,6,TRUE,"9/5/1993",1993,"September","1990s",70,82,8
"5975","199309050rai","Los Angeles Raiders",24,"Minnesota Vikings",7,31,17,TRUE,"9/5/1993",1993,"September","1990s",68,83,10
"5976","199309050clt","Indianapolis Colts",20,"Miami Dolphins",24,44,-4,FALSE,"9/5/1993",1993,"September","1990s",72,NA,NA
"5977","199309050nyj","New York Jets",20,"Denver Broncos",26,46,-6,FALSE,"9/5/1993",1993,"September","1990s",76,67,7
"5978","199309060was","Washington Redskins",35,"Dallas Cowboys",16,51,19,TRUE,"9/6/1993",1993,"September","1990s",77,72,7
"5979","199309120sea","Seattle Seahawks",13,"Los Angeles Raiders",17,30,-4,FALSE,"9/12/1993",1993,"September","1990s",72,NA,NA
"5980","199309120den","Denver Broncos",34,"San Diego Chargers",17,51,17,TRUE,"9/12/1993",1993,"September","1990s",76,20,11
"5981","199309120gnb","Green Bay Packers",17,"Philadelphia Eagles",20,37,-3,FALSE,"9/12/1993",1993,"September","1990s",64,78,12
"5982","199309120was","Washington Redskins",10,"Phoenix Cardinals",17,27,-7,FALSE,"9/12/1993",1993,"September","1990s",66,52,10
"5983","199309120cin","Cincinnati Bengals",6,"Indianapolis Colts",9,15,-3,FALSE,"9/12/1993",1993,"September","1990s",60,69,9
"5984","199309120nyg","New York Giants",23,"Tampa Bay Buccaneers",7,30,16,TRUE,"9/12/1993",1993,"September","1990s",65,53,12
"5985","199309120nwe","New England Patriots",16,"Detroit Lions",19,35,-3,FALSE,"9/12/1993",1993,"September","1990s",61,56,12
"5986","199309120oti","Houston Oilers",30,"Kansas City Chiefs",0,30,30,TRUE,"9/12/1993",1993,"September","1990s",72,NA,NA
"5987","199309120dal","Dallas Cowboys",10,"Buffalo Bills",13,23,-3,FALSE,"9/12/1993",1993,"September","1990s",85,52,16
"5988","199309120atl","Atlanta Falcons",31,"New Orleans Saints",34,65,-3,FALSE,"9/12/1993",1993,"September","1990s",72,NA,NA
"5989","199309120ram","Los Angeles Rams",27,"Pittsburgh Steelers",0,27,27,TRUE,"9/12/1993",1993,"September","1990s",67,84,8
"5990","199309120min","Minnesota Vikings",10,"Chicago Bears",7,17,3,TRUE,"9/12/1993",1993,"September","1990s",72,NA,NA
"5991","199309120mia","Miami Dolphins",14,"New York Jets",24,38,-10,FALSE,"9/12/1993",1993,"September","1990s",81,78,10
"5992","199309130cle","Cleveland Browns",23,"San Francisco 49ers",13,36,10,TRUE,"9/13/1993",1993,"September","1990s",74,54,16
"5993","199309190nyg","New York Giants",20,"Los Angeles Rams",10,30,10,TRUE,"9/19/1993",1993,"September","1990s",65,66,14
"5994","199309190sfo","San Francisco 49ers",37,"Atlanta Falcons",30,67,7,TRUE,"9/19/1993",1993,"September","1990s",59,74,13
"5995","199309190nwe","New England Patriots",14,"Seattle Seahawks",17,31,-3,FALSE,"9/19/1993",1993,"September","1990s",62,62,14
"5996","199309190sdg","San Diego Chargers",18,"Houston Oilers",17,35,1,TRUE,"9/19/1993",1993,"September","1990s",66,76,7
"5997","199309190phi","Philadelphia Eagles",34,"Washington Redskins",31,65,3,TRUE,"9/19/1993",1993,"September","1990s",63,68,12
"5998","199309190rai","Los Angeles Raiders",16,"Cleveland Browns",19,35,-3,FALSE,"9/19/1993",1993,"September","1990s",66,80,10
"5999","199309190pit","Pittsburgh Steelers",34,"Cincinnati Bengals",7,41,27,TRUE,"9/19/1993",1993,"September","1990s",61,62,8
"6000","199309190nor","New Orleans Saints",14,"Detroit Lions",3,17,11,TRUE,"9/19/1993",1993,"September","1990s",72,NA,NA
"6001","199309190crd","Phoenix Cardinals",10,"Dallas Cowboys",17,27,-7,FALSE,"9/19/1993",1993,"September","1990s",80,23,3
"6002","199309200kan","Kansas City Chiefs",15,"Denver Broncos",7,22,8,TRUE,"9/20/1993",1993,"September","1990s",64,83,9
"6003","199309260min","Minnesota Vikings",15,"Green Bay Packers",13,28,2,TRUE,"9/26/1993",1993,"September","1990s",72,NA,NA
"6004","199309260chi","Chicago Bears",47,"Tampa Bay Buccaneers",17,64,30,TRUE,"9/26/1993",1993,"September","1990s",57,82,14
"6005","199309260buf","Buffalo Bills",13,"Miami Dolphins",22,35,-9,FALSE,"9/26/1993",1993,"September","1990s",61,82,16
"6006","199309260cin","Cincinnati Bengals",10,"Seattle Seahawks",19,29,-9,FALSE,"9/26/1993",1993,"September","1990s",64,84,16
"6007","199309260nor","New Orleans Saints",16,"San Francisco 49ers",13,29,3,TRUE,"9/26/1993",1993,"September","1990s",72,NA,NA
"6008","199309260oti","Houston Oilers",13,"Los Angeles Rams",28,41,-15,FALSE,"9/26/1993",1993,"September","1990s",72,NA,NA
"6009","199309260nyj","New York Jets",45,"New England Patriots",7,52,38,TRUE,"9/26/1993",1993,"September","1990s",68,84,14
"6010","199309260clt","Indianapolis Colts",23,"Cleveland Browns",10,33,13,TRUE,"9/26/1993",1993,"September","1990s",72,NA,NA
"6011","199309260det","Detroit Lions",26,"Phoenix Cardinals",20,46,6,TRUE,"9/26/1993",1993,"September","1990s",72,NA,NA
"6012","199309270atl","Atlanta Falcons",17,"Pittsburgh Steelers",45,62,-28,FALSE,"9/27/1993",1993,"September","1990s",72,NA,NA
"6013","199310030sfo","San Francisco 49ers",38,"Minnesota Vikings",19,57,19,TRUE,"10/3/1993",1993,"October","1990s",55,89,16
"6014","199310030kan","Kansas City Chiefs",24,"Los Angeles Raiders",9,33,15,TRUE,"10/3/1993",1993,"October","1990s",58,61,13
"6015","199310030sea","Seattle Seahawks",31,"San Diego Chargers",14,45,17,TRUE,"10/3/1993",1993,"October","1990s",72,NA,NA
"6016","199310030buf","Buffalo Bills",17,"New York Giants",14,31,3,TRUE,"10/3/1993",1993,"October","1990s",47,61,15
"6017","199310030den","Denver Broncos",35,"Indianapolis Colts",13,48,22,TRUE,"10/3/1993",1993,"October","1990s",59,41,8
"6018","199310030nyj","New York Jets",30,"Philadelphia Eagles",35,65,-5,FALSE,"10/3/1993",1993,"October","1990s",61,62,17
"6019","199310030dal","Dallas Cowboys",36,"Green Bay Packers",14,50,22,TRUE,"10/3/1993",1993,"October","1990s",68,86,8
"6020","199310030chi","Chicago Bears",6,"Atlanta Falcons",0,6,6,TRUE,"10/3/1993",1993,"October","1990s",50,54,17
"6021","199310030ram","Los Angeles Rams",6,"New Orleans Saints",37,43,-31,FALSE,"10/3/1993",1993,"October","1990s",69,83,7
"6022","199310030tam","Tampa Bay Buccaneers",27,"Detroit Lions",10,37,17,TRUE,"10/3/1993",1993,"October","1990s",78,63,7
"6023","199310040mia","Miami Dolphins",17,"Washington Redskins",10,27,7,TRUE,"10/4/1993",1993,"October","1990s",77,86,8
"6024","199310100was","Washington Redskins",7,"New York Giants",41,48,-34,FALSE,"10/10/1993",1993,"October","1990s",57,70,15
"6025","199310100phi","Philadelphia Eagles",6,"Chicago Bears",17,23,-11,FALSE,"10/10/1993",1993,"October","1990s",56,57,18
"6026","199310100cle","Cleveland Browns",14,"Miami Dolphins",24,38,-10,FALSE,"10/10/1993",1993,"October","1990s",42,60,12
"6027","199310100gnb","Green Bay Packers",30,"Denver Broncos",27,57,3,TRUE,"10/10/1993",1993,"October","1990s",36,64,9
"6028","199310100rai","Los Angeles Raiders",24,"New York Jets",20,44,4,TRUE,"10/10/1993",1993,"October","1990s",67,80,10
"6029","199310100min","Minnesota Vikings",15,"Tampa Bay Buccaneers",0,15,15,TRUE,"10/10/1993",1993,"October","1990s",72,NA,NA
"6030","199310100kan","Kansas City Chiefs",17,"Cincinnati Bengals",15,32,2,TRUE,"10/10/1993",1993,"October","1990s",41,68,5
"6031","199310100crd","Phoenix Cardinals",21,"New England Patriots",23,44,-2,FALSE,"10/10/1993",1993,"October","1990s",79,43,7
"6032","199310100pit","Pittsburgh Steelers",16,"San Diego Chargers",3,19,13,TRUE,"10/10/1993",1993,"October","1990s",42,58,12
"6033","199310100clt","Indianapolis Colts",3,"Dallas Cowboys",27,30,-24,FALSE,"10/10/1993",1993,"October","1990s",72,NA,NA
"6034","199310110buf","Buffalo Bills",35,"Houston Oilers",7,42,28,TRUE,"10/11/1993",1993,"October","1990s",41,53,9
"6035","199310140atl","Atlanta Falcons",30,"Los Angeles Rams",24,54,6,TRUE,"10/14/1993",1993,"October","1990s",72,NA,NA
"6036","199310170crd","Phoenix Cardinals",36,"Washington Redskins",6,42,30,TRUE,"10/17/1993",1993,"October","1990s",66,71,7
"6037","199310170sdg","San Diego Chargers",14,"Kansas City Chiefs",17,31,-3,FALSE,"10/17/1993",1993,"October","1990s",64,75,9
"6038","199310170dal","Dallas Cowboys",26,"San Francisco 49ers",17,43,9,TRUE,"10/17/1993",1993,"October","1990s",69,85,10
"6039","199310170cin","Cincinnati Bengals",17,"Cleveland Browns",28,45,-11,FALSE,"10/17/1993",1993,"October","1990s",64,87,13
"6040","199310170pit","Pittsburgh Steelers",37,"New Orleans Saints",14,51,23,TRUE,"10/17/1993",1993,"October","1990s",60,90,13
"6041","199310170nwe","New England Patriots",14,"Houston Oilers",28,42,-14,FALSE,"10/17/1993",1993,"October","1990s",53,98,8
"6042","199310170det","Detroit Lions",30,"Seattle Seahawks",10,40,20,TRUE,"10/17/1993",1993,"October","1990s",72,NA,NA
"6043","199310170nyg","New York Giants",21,"Philadelphia Eagles",10,31,11,TRUE,"10/17/1993",1993,"October","1990s",60,90,9
"6044","199310180den","Denver Broncos",20,"Los Angeles Raiders",23,43,-3,FALSE,"10/18/1993",1993,"October","1990s",44,93,12
"6045","199310240mia","Miami Dolphins",41,"Indianapolis Colts",27,68,14,TRUE,"10/24/1993",1993,"October","1990s",80,78,11
"6046","199310240nyj","New York Jets",10,"Buffalo Bills",19,29,-9,FALSE,"10/24/1993",1993,"October","1990s",55,47,14
"6047","199310240tam","Tampa Bay Buccaneers",14,"Green Bay Packers",37,51,-23,FALSE,"10/24/1993",1993,"October","1990s",74,79,9
"6048","199310240sea","Seattle Seahawks",10,"New England Patriots",9,19,1,TRUE,"10/24/1993",1993,"October","1990s",72,NA,NA
"6049","199310240sfo","San Francisco 49ers",28,"Phoenix Cardinals",14,42,14,TRUE,"10/24/1993",1993,"October","1990s",62,70,12
"6050","199310240ram","Los Angeles Rams",13,"Detroit Lions",16,29,-3,FALSE,"10/24/1993",1993,"October","1990s",65,84,9
"6051","199310240nor","New Orleans Saints",15,"Atlanta Falcons",26,41,-11,FALSE,"10/24/1993",1993,"October","1990s",72,NA,NA
"6052","199310240oti","Houston Oilers",28,"Cincinnati Bengals",12,40,16,TRUE,"10/24/1993",1993,"October","1990s",72,NA,NA
"6053","199310240cle","Cleveland Browns",28,"Pittsburgh Steelers",23,51,5,TRUE,"10/24/1993",1993,"October","1990s",54,43,14
"6054","199310250chi","Chicago Bears",12,"Minnesota Vikings",19,31,-7,FALSE,"10/25/1993",1993,"October","1990s",56,55,11
"6055","199310310phi","Philadelphia Eagles",10,"Dallas Cowboys",23,33,-13,FALSE,"10/31/1993",1993,"October","1990s",47,93,17
"6056","199310310gnb","Green Bay Packers",17,"Chicago Bears",3,20,14,TRUE,"10/31/1993",1993,"October","1990s",33,69,12
"6057","199310310mia","Miami Dolphins",30,"Kansas City Chiefs",10,40,20,TRUE,"10/31/1993",1993,"October","1990s",76,79,17
"6058","199310310den","Denver Broncos",28,"Seattle Seahawks",17,45,11,TRUE,"10/31/1993",1993,"October","1990s",40,48,10
"6059","199310310clt","Indianapolis Colts",9,"New England Patriots",6,15,3,TRUE,"10/31/1993",1993,"October","1990s",72,NA,NA
"6060","199310310rai","Los Angeles Raiders",23,"San Diego Chargers",30,53,-7,FALSE,"10/31/1993",1993,"October","1990s",66,84,9
"6061","199310310nyg","New York Giants",6,"New York Jets",10,16,-4,FALSE,"10/31/1993",1993,"October","1990s",44,98,21
"6062","199310310sfo","San Francisco 49ers",40,"Los Angeles Rams",17,57,23,TRUE,"10/31/1993",1993,"October","1990s",61,78,10
"6063","199310310atl","Atlanta Falcons",24,"Tampa Bay Buccaneers",31,55,-7,FALSE,"10/31/1993",1993,"October","1990s",72,NA,NA
"6064","199310310crd","Phoenix Cardinals",17,"New Orleans Saints",20,37,-3,FALSE,"10/31/1993",1993,"October","1990s",65,18,7
"6065","199310310min","Minnesota Vikings",27,"Detroit Lions",30,57,-3,FALSE,"10/31/1993",1993,"October","1990s",72,NA,NA
"6066","199311010buf","Buffalo Bills",24,"Washington Redskins",10,34,14,TRUE,"11/1/1993",1993,"November","1990s",32,84,13
"6067","199311070dal","Dallas Cowboys",31,"New York Giants",9,40,22,TRUE,"11/7/1993",1993,"November","1990s",41,48,9
"6068","199311070cle","Cleveland Browns",14,"Denver Broncos",29,43,-15,FALSE,"11/7/1993",1993,"November","1990s",32,71,12
"6069","199311070nyj","New York Jets",27,"Miami Dolphins",10,37,17,TRUE,"11/7/1993",1993,"November","1990s",43,54,20
"6070","199311070nwe","New England Patriots",10,"Buffalo Bills",13,23,-3,FALSE,"11/7/1993",1993,"November","1990s",43,49,15
"6071","199311070oti","Houston Oilers",24,"Seattle Seahawks",14,38,10,TRUE,"11/7/1993",1993,"November","1990s",72,NA,NA
"6072","199311070chi","Chicago Bears",14,"Los Angeles Raiders",16,30,-2,FALSE,"11/7/1993",1993,"November","1990s",28,62,16
"6073","199311070min","Minnesota Vikings",17,"San Diego Chargers",30,47,-13,FALSE,"11/7/1993",1993,"November","1990s",72,NA,NA
"6074","199311070cin","Cincinnati Bengals",16,"Pittsburgh Steelers",24,40,-8,FALSE,"11/7/1993",1993,"November","1990s",30,74,10
"6075","199311070was","Washington Redskins",30,"Indianapolis Colts",24,54,6,TRUE,"11/7/1993",1993,"November","1990s",42,61,11
"6076","199311070crd","Phoenix Cardinals",16,"Philadelphia Eagles",3,19,13,TRUE,"11/7/1993",1993,"November","1990s",64,23,4
"6077","199311070det","Detroit Lions",23,"Tampa Bay Buccaneers",0,23,23,TRUE,"11/7/1993",1993,"November","1990s",72,NA,NA
"6078","199311080kan","Kansas City Chiefs",23,"Green Bay Packers",16,39,7,TRUE,"11/8/1993",1993,"November","1990s",43,47,13
"6079","199311140rai","Los Angeles Raiders",20,"Kansas City Chiefs",31,51,-11,FALSE,"11/14/1993",1993,"November","1990s",59,53,15
"6080","199311140den","Denver Broncos",23,"Minnesota Vikings",26,49,-3,FALSE,"11/14/1993",1993,"November","1990s",32,85,10
"6081","199311140phi","Philadelphia Eagles",14,"Miami Dolphins",19,33,-5,FALSE,"11/14/1993",1993,"November","1990s",61,86,10
"6082","199311140tam","Tampa Bay Buccaneers",21,"San Francisco 49ers",45,66,-24,FALSE,"11/14/1993",1993,"November","1990s",79,73,9
"6083","199311140nyg","New York Giants",20,"Washington Redskins",6,26,14,TRUE,"11/14/1993",1993,"November","1990s",60,81,14
"6084","199311140nor","New Orleans Saints",17,"Green Bay Packers",19,36,-2,FALSE,"11/14/1993",1993,"November","1990s",72,NA,NA
"6085","199311140cin","Cincinnati Bengals",3,"Houston Oilers",38,41,-35,FALSE,"11/14/1993",1993,"November","1990s",63,92,14
"6086","199311140ram","Los Angeles Rams",0,"Atlanta Falcons",13,13,-13,FALSE,"11/14/1993",1993,"November","1990s",59,53,15
"6087","199311140clt","Indianapolis Colts",17,"New York Jets",31,48,-14,FALSE,"11/14/1993",1993,"November","1990s",72,NA,NA
"6088","199311140sdg","San Diego Chargers",13,"Chicago Bears",16,29,-3,FALSE,"11/14/1993",1993,"November","1990s",60,65,12
"6089","199311140sea","Seattle Seahawks",22,"Cleveland Browns",5,27,17,TRUE,"11/14/1993",1993,"November","1990s",72,NA,NA
"6090","199311140dal","Dallas Cowboys",20,"Phoenix Cardinals",15,35,5,TRUE,"11/14/1993",1993,"November","1990s",66,72,15
"6091","199311150pit","Pittsburgh Steelers",23,"Buffalo Bills",0,23,23,TRUE,"11/15/1993",1993,"November","1990s",61,81,16
"6092","199311210nyj","New York Jets",17,"Cincinnati Bengals",12,29,5,TRUE,"11/21/1993",1993,"November","1990s",40,44,16
"6093","199311210buf","Buffalo Bills",23,"Indianapolis Colts",9,32,14,TRUE,"11/21/1993",1993,"November","1990s",37,49,20
"6094","199311210gnb","Green Bay Packers",26,"Detroit Lions",17,43,9,TRUE,"11/21/1993",1993,"November","1990s",42,62,19
"6095","199311210phi","Philadelphia Eagles",3,"New York Giants",7,10,-4,FALSE,"11/21/1993",1993,"November","1990s",40,44,12
"6096","199311210atl","Atlanta Falcons",27,"Dallas Cowboys",14,41,13,TRUE,"11/21/1993",1993,"November","1990s",72,NA,NA
"6097","199311210sdg","San Diego Chargers",7,"Los Angeles Raiders",12,19,-5,FALSE,"11/21/1993",1993,"November","1990s",61,35,4
"6098","199311210tam","Tampa Bay Buccaneers",23,"Minnesota Vikings",10,33,13,TRUE,"11/21/1993",1993,"November","1990s",66,73,9
"6099","199311210kan","Kansas City Chiefs",17,"Chicago Bears",19,36,-2,FALSE,"11/21/1993",1993,"November","1990s",44,53,17
"6100","199311210den","Denver Broncos",37,"Pittsburgh Steelers",13,50,24,TRUE,"11/21/1993",1993,"November","1990s",42,40,10
"6101","199311210mia","Miami Dolphins",17,"New England Patriots",13,30,4,TRUE,"11/21/1993",1993,"November","1990s",76,74,9
"6102","199311210ram","Los Angeles Rams",10,"Washington Redskins",6,16,4,TRUE,"11/21/1993",1993,"November","1990s",64,20,9
"6103","199311210cle","Cleveland Browns",20,"Houston Oilers",27,47,-7,FALSE,"11/21/1993",1993,"November","1990s",39,54,16
"6104","199311220sfo","San Francisco 49ers",42,"New Orleans Saints",7,49,35,TRUE,"11/22/1993",1993,"November","1990s",54,79,10
"6105","199311250dal","Dallas Cowboys",14,"Miami Dolphins",16,30,-2,FALSE,"11/25/1993",1993,"November","1990s",32,63,15
"6106","199311250det","Detroit Lions",6,"Chicago Bears",10,16,-4,FALSE,"11/25/1993",1993,"November","1990s",72,NA,NA
"6107","199311280was","Washington Redskins",14,"Philadelphia Eagles",17,31,-3,FALSE,"11/28/1993",1993,"November","1990s",58,86,14
"6108","199311280ram","Los Angeles Rams",10,"San Francisco 49ers",35,45,-25,FALSE,"11/28/1993",1993,"November","1990s",66,16,8
"6109","199311280nwe","New England Patriots",0,"New York Jets",6,6,-6,FALSE,"11/28/1993",1993,"November","1990s",54,90,23
"6110","199311280cin","Cincinnati Bengals",16,"Los Angeles Raiders",10,26,6,TRUE,"11/28/1993",1993,"November","1990s",29,89,15
"6111","199311280nyg","New York Giants",19,"Phoenix Cardinals",17,36,2,TRUE,"11/28/1993",1993,"November","1990s",60,84,26
"6112","199311280gnb","Green Bay Packers",13,"Tampa Bay Buccaneers",10,23,3,TRUE,"11/28/1993",1993,"November","1990s",23,79,7
"6113","199311280atl","Atlanta Falcons",17,"Cleveland Browns",14,31,3,TRUE,"11/28/1993",1993,"November","1990s",72,NA,NA
"6114","199311280kan","Kansas City Chiefs",23,"Buffalo Bills",7,30,16,TRUE,"11/28/1993",1993,"November","1990s",29,74,11
"6115","199311280oti","Houston Oilers",23,"Pittsburgh Steelers",3,26,20,TRUE,"11/28/1993",1993,"November","1990s",72,NA,NA
"6116","199311280sea","Seattle Seahawks",9,"Denver Broncos",17,26,-8,FALSE,"11/28/1993",1993,"November","1990s",72,NA,NA
"6117","199311280min","Minnesota Vikings",14,"New Orleans Saints",17,31,-3,FALSE,"11/28/1993",1993,"November","1990s",72,NA,NA
"6118","199311290clt","Indianapolis Colts",0,"San Diego Chargers",31,31,-31,FALSE,"11/29/1993",1993,"November","1990s",72,NA,NA
"6119","199312050sfo","San Francisco 49ers",21,"Cincinnati Bengals",8,29,13,TRUE,"12/5/1993",1993,"December","1990s",50,81,10
"6120","199312050pit","Pittsburgh Steelers",17,"New England Patriots",14,31,3,TRUE,"12/5/1993",1993,"December","1990s",45,85,14
"6121","199312050chi","Chicago Bears",30,"Green Bay Packers",17,47,13,TRUE,"12/5/1993",1993,"December","1990s",37,86,9
"6122","199312050oti","Houston Oilers",33,"Atlanta Falcons",17,50,16,TRUE,"12/5/1993",1993,"December","1990s",72,NA,NA
"6123","199312050cle","Cleveland Browns",17,"New Orleans Saints",13,30,4,TRUE,"12/5/1993",1993,"December","1990s",41,84,13
"6124","199312050sea","Seattle Seahawks",16,"Kansas City Chiefs",31,47,-15,FALSE,"12/5/1993",1993,"December","1990s",72,NA,NA
"6125","199312050mia","Miami Dolphins",14,"New York Giants",19,33,-5,FALSE,"12/5/1993",1993,"December","1990s",74,76,11
"6126","199312050det","Detroit Lions",0,"Minnesota Vikings",13,13,-13,FALSE,"12/5/1993",1993,"December","1990s",72,NA,NA
"6127","199312050crd","Phoenix Cardinals",38,"Los Angeles Rams",10,48,28,TRUE,"12/5/1993",1993,"December","1990s",55,31,5
"6128","199312050nyj","New York Jets",6,"Indianapolis Colts",9,15,-3,FALSE,"12/5/1993",1993,"December","1990s",52,94,20
"6129","199312050buf","Buffalo Bills",24,"Los Angeles Raiders",25,49,-1,FALSE,"12/5/1993",1993,"December","1990s",37,89,13
"6130","199312050sdg","San Diego Chargers",13,"Denver Broncos",10,23,3,TRUE,"12/5/1993",1993,"December","1990s",56,74,6
"6131","199312050tam","Tampa Bay Buccaneers",17,"Washington Redskins",23,40,-6,FALSE,"12/5/1993",1993,"December","1990s",67,76,12
"6132","199312060dal","Dallas Cowboys",23,"Philadelphia Eagles",17,40,6,TRUE,"12/6/1993",1993,"December","1990s",50,44,8
"6133","199312110was","Washington Redskins",0,"New York Jets",3,3,-3,FALSE,"12/11/1993",1993,"December","1990s",43,70,20
"6134","199312110atl","Atlanta Falcons",27,"San Francisco 49ers",24,51,3,TRUE,"12/11/1993",1993,"December","1990s",72,NA,NA
"6135","199312120nor","New Orleans Saints",20,"Los Angeles Rams",23,43,-3,FALSE,"12/12/1993",1993,"December","1990s",72,NA,NA
"6136","199312120nwe","New England Patriots",7,"Cincinnati Bengals",2,9,5,TRUE,"12/12/1993",1993,"December","1990s",29,69,22
"6137","199312120tam","Tampa Bay Buccaneers",13,"Chicago Bears",10,23,3,TRUE,"12/12/1993",1993,"December","1990s",49,45,9
"6138","199312120crd","Phoenix Cardinals",14,"Detroit Lions",21,35,-7,FALSE,"12/12/1993",1993,"December","1990s",60,46,13
"6139","199312120nyg","New York Giants",20,"Indianapolis Colts",6,26,14,TRUE,"12/12/1993",1993,"December","1990s",28,61,22
"6140","199312120phi","Philadelphia Eagles",7,"Buffalo Bills",10,17,-3,FALSE,"12/12/1993",1993,"December","1990s",30,44,21
"6141","199312120sdg","San Diego Chargers",13,"Green Bay Packers",20,33,-7,FALSE,"12/12/1993",1993,"December","1990s",56,78,12
"6142","199312120oti","Houston Oilers",19,"Cleveland Browns",17,36,2,TRUE,"12/12/1993",1993,"December","1990s",72,NA,NA
"6143","199312120min","Minnesota Vikings",20,"Dallas Cowboys",37,57,-17,FALSE,"12/12/1993",1993,"December","1990s",72,NA,NA
"6144","199312120rai","Los Angeles Raiders",27,"Seattle Seahawks",23,50,4,TRUE,"12/12/1993",1993,"December","1990s",55,60,12
"6145","199312120den","Denver Broncos",27,"Kansas City Chiefs",21,48,6,TRUE,"12/12/1993",1993,"December","1990s",48,36,14
"6146","199312130mia","Miami Dolphins",20,"Pittsburgh Steelers",21,41,-1,FALSE,"12/13/1993",1993,"December","1990s",61,64,10
"6147","199312180nyj","New York Jets",7,"Dallas Cowboys",28,35,-21,FALSE,"12/18/1993",1993,"December","1990s",38,63,10
"6148","199312180chi","Chicago Bears",3,"Denver Broncos",13,16,-10,FALSE,"12/18/1993",1993,"December","1990s",39,92,11
"6149","199312190kan","Kansas City Chiefs",28,"San Diego Chargers",24,52,4,TRUE,"12/19/1993",1993,"December","1990s",34,80,8
"6150","199312190det","Detroit Lions",17,"San Francisco 49ers",55,72,-38,FALSE,"12/19/1993",1993,"December","1990s",72,NA,NA
"6151","199312190rai","Los Angeles Raiders",27,"Tampa Bay Buccaneers",20,47,7,TRUE,"12/19/1993",1993,"December","1990s",56,67,7
"6152","199312190cle","Cleveland Browns",17,"New England Patriots",20,37,-3,FALSE,"12/19/1993",1993,"December","1990s",37,83,10
"6153","199312190sea","Seattle Seahawks",27,"Phoenix Cardinals",30,57,-3,FALSE,"12/19/1993",1993,"December","1990s",72,NA,NA
"6154","199312190clt","Indianapolis Colts",10,"Philadelphia Eagles",20,30,-10,FALSE,"12/19/1993",1993,"December","1990s",72,NA,NA
"6155","199312190was","Washington Redskins",30,"Atlanta Falcons",17,47,13,TRUE,"12/19/1993",1993,"December","1990s",45,69,13
"6156","199312190gnb","Green Bay Packers",17,"Minnesota Vikings",21,38,-4,FALSE,"12/19/1993",1993,"December","1990s",36,78,11
"6157","199312190pit","Pittsburgh Steelers",17,"Houston Oilers",26,43,-9,FALSE,"12/19/1993",1993,"December","1990s",36,84,11
"6158","199312190cin","Cincinnati Bengals",15,"Los Angeles Rams",3,18,12,TRUE,"12/19/1993",1993,"December","1990s",35,83,11
"6159","199312190mia","Miami Dolphins",34,"Buffalo Bills",47,81,-13,FALSE,"12/19/1993",1993,"December","1990s",71,73,7
"6160","199312200nor","New Orleans Saints",14,"New York Giants",24,38,-10,FALSE,"12/20/1993",1993,"December","1990s",72,NA,NA
"6161","199312250sfo","San Francisco 49ers",7,"Houston Oilers",10,17,-3,FALSE,"12/25/1993",1993,"December","1990s",45,76,6
"6162","199312260dal","Dallas Cowboys",38,"Washington Redskins",3,41,35,TRUE,"12/26/1993",1993,"December","1990s",49,51,17
"6163","199312260ram","Los Angeles Rams",14,"Cleveland Browns",42,56,-28,FALSE,"12/26/1993",1993,"December","1990s",60,40,8
"6164","199312260buf","Buffalo Bills",16,"New York Jets",14,30,2,TRUE,"12/26/1993",1993,"December","1990s",9,63,23
"6165","199312260sea","Seattle Seahawks",16,"Pittsburgh Steelers",6,22,10,TRUE,"12/26/1993",1993,"December","1990s",72,NA,NA
"6166","199312260gnb","Green Bay Packers",28,"Los Angeles Raiders",0,28,28,TRUE,"12/26/1993",1993,"December","1990s",-3,54,11
"6167","199312260nwe","New England Patriots",38,"Indianapolis Colts",0,38,38,TRUE,"12/26/1993",1993,"December","1990s",24,48,23
"6168","199312260cin","Cincinnati Bengals",21,"Atlanta Falcons",17,38,4,TRUE,"12/26/1993",1993,"December","1990s",16,68,10
"6169","199312260chi","Chicago Bears",14,"Detroit Lions",20,34,-6,FALSE,"12/26/1993",1993,"December","1990s",8,56,13
"6170","199312260den","Denver Broncos",10,"Tampa Bay Buccaneers",17,27,-7,FALSE,"12/26/1993",1993,"December","1990s",41,38,10
"6171","199312260min","Minnesota Vikings",30,"Kansas City Chiefs",10,40,20,TRUE,"12/26/1993",1993,"December","1990s",72,NA,NA
"6172","199312260phi","Philadelphia Eagles",37,"New Orleans Saints",26,63,11,TRUE,"12/26/1993",1993,"December","1990s",26,50,23
"6173","199312260crd","Phoenix Cardinals",17,"New York Giants",6,23,11,TRUE,"12/26/1993",1993,"December","1990s",57,26,8
"6174","199312270sdg","San Diego Chargers",45,"Miami Dolphins",20,65,25,TRUE,"12/27/1993",1993,"December","1990s",60,50,6
"6175","199312310was","Washington Redskins",9,"Minnesota Vikings",14,23,-5,FALSE,"12/31/1993",1993,"December","1990s",23,56,8
"6176","199401020tam","Tampa Bay Buccaneers",17,"San Diego Chargers",32,49,-15,FALSE,"1/2/1994",1994,"January","1990s",68,90,9
"6177","199401020nyg","New York Giants",13,"Dallas Cowboys",16,29,-3,FALSE,"1/2/1994",1994,"January","1990s",41,62,13
"6178","199401020nor","New Orleans Saints",20,"Cincinnati Bengals",13,33,7,TRUE,"1/2/1994",1994,"January","1990s",72,NA,NA
"6179","199401020atl","Atlanta Falcons",10,"Phoenix Cardinals",27,37,-17,FALSE,"1/2/1994",1994,"January","1990s",72,NA,NA
"6180","199401020rai","Los Angeles Raiders",33,"Denver Broncos",30,63,3,TRUE,"1/2/1994",1994,"January","1990s",58,66,6
"6181","199401020det","Detroit Lions",30,"Green Bay Packers",20,50,10,TRUE,"1/2/1994",1994,"January","1990s",72,NA,NA
"6182","199401020ram","Los Angeles Rams",20,"Chicago Bears",6,26,14,TRUE,"1/2/1994",1994,"January","1990s",58,66,6
"6183","199401020kan","Kansas City Chiefs",34,"Seattle Seahawks",24,58,10,TRUE,"1/2/1994",1994,"January","1990s",32,81,8
"6184","199401020clt","Indianapolis Colts",10,"Buffalo Bills",30,40,-20,FALSE,"1/2/1994",1994,"January","1990s",72,NA,NA
"6185","199401020nwe","New England Patriots",33,"Miami Dolphins",27,60,6,TRUE,"1/2/1994",1994,"January","1990s",41,66,14
"6186","199401020oti","Houston Oilers",24,"New York Jets",0,24,24,TRUE,"1/2/1994",1994,"January","1990s",72,NA,NA
"6187","199401020pit","Pittsburgh Steelers",16,"Cleveland Browns",9,25,7,TRUE,"1/2/1994",1994,"January","1990s",34,83,12
"6188","199401030sfo","San Francisco 49ers",34,"Philadelphia Eagles",37,71,-3,FALSE,"1/3/1994",1994,"January","1990s",50,85,10
"6189","199401080kan","Kansas City Chiefs",27,"Pittsburgh Steelers",24,51,3,TRUE,"1/8/1994",1994,"January","1990s",18,59,6
"6190","199401080det","Detroit Lions",24,"Green Bay Packers",28,52,-4,FALSE,"1/8/1994",1994,"January","1990s",72,NA,NA
"6191","199401090rai","Los Angeles Raiders",42,"Denver Broncos",24,66,18,TRUE,"1/9/1994",1994,"January","1990s",54,68,8
"6192","199401090nyg","New York Giants",17,"Minnesota Vikings",10,27,7,TRUE,"1/9/1994",1994,"January","1990s",20,54,21
"6193","199401150buf","Buffalo Bills",29,"Los Angeles Raiders",23,52,6,TRUE,"1/15/1994",1994,"January","1990s",3,71,12
"6194","199401150sfo","San Francisco 49ers",44,"New York Giants",3,47,41,TRUE,"1/15/1994",1994,"January","1990s",49,85,5
"6195","199401160dal","Dallas Cowboys",27,"Green Bay Packers",17,44,10,TRUE,"1/16/1994",1994,"January","1990s",44,69,10
"6196","199401160oti","Houston Oilers",20,"Kansas City Chiefs",28,48,-8,FALSE,"1/16/1994",1994,"January","1990s",72,NA,NA
"6197","199401230dal","Dallas Cowboys",38,"San Francisco 49ers",21,59,17,TRUE,"1/23/1994",1994,"January","1990s",49,92,8
"6198","199401230buf","Buffalo Bills",30,"Kansas City Chiefs",13,43,17,TRUE,"1/23/1994",1994,"January","1990s",22,79,9
"6199","199401300buf","Buffalo Bills",13,"Dallas Cowboys",30,43,-17,FALSE,"1/30/1994",1994,"January","1990s",72,NA,NA
"6200","199409040det","Detroit Lions",31,"Atlanta Falcons",28,59,3,TRUE,"9/4/1994",1994,"September","1990s",72,NA,NA
"6201","199409040chi","Chicago Bears",21,"Tampa Bay Buccaneers",9,30,12,TRUE,"9/4/1994",1994,"September","1990s",60,72,10
"6202","199409040nyg","New York Giants",28,"Philadelphia Eagles",23,51,5,TRUE,"9/4/1994",1994,"September","1990s",65,56,16
"6203","199409040cin","Cincinnati Bengals",20,"Cleveland Browns",28,48,-8,FALSE,"9/4/1994",1994,"September","1990s",61,69,8
"6204","199409040buf","Buffalo Bills",3,"New York Jets",23,26,-20,FALSE,"9/4/1994",1994,"September","1990s",57,70,8
"6205","199409040clt","Indianapolis Colts",45,"Houston Oilers",21,66,24,TRUE,"9/4/1994",1994,"September","1990s",72,NA,NA
"6206","199409040mia","Miami Dolphins",39,"New England Patriots",35,74,4,TRUE,"9/4/1994",1994,"September","1990s",83,69,12
"6207","199409040ram","Los Angeles Rams",14,"Arizona Cardinals",12,26,2,TRUE,"9/4/1994",1994,"September","1990s",70,77,8
"6208","199409040was","Washington Redskins",7,"Seattle Seahawks",28,35,-21,FALSE,"9/4/1994",1994,"September","1990s",67,56,11
"6209","199409040nor","New Orleans Saints",17,"Kansas City Chiefs",30,47,-13,FALSE,"9/4/1994",1994,"September","1990s",72,NA,NA
"6210","199409040pit","Pittsburgh Steelers",9,"Dallas Cowboys",26,35,-17,FALSE,"9/4/1994",1994,"September","1990s",62,62,11
"6211","199409040den","Denver Broncos",34,"San Diego Chargers",37,71,-3,FALSE,"9/4/1994",1994,"September","1990s",72,38,11
"6212","199409040gnb","Green Bay Packers",16,"Minnesota Vikings",10,26,6,TRUE,"9/4/1994",1994,"September","1990s",58,77,10
"6213","199409050sfo","San Francisco 49ers",44,"Los Angeles Raiders",14,58,30,TRUE,"9/5/1994",1994,"September","1990s",63,72,14
"6214","199409110min","Minnesota Vikings",10,"Detroit Lions",3,13,7,TRUE,"9/11/1994",1994,"September","1990s",72,NA,NA
"6215","199409110nyj","New York Jets",25,"Denver Broncos",22,47,3,TRUE,"9/11/1994",1994,"September","1990s",63,54,15
"6216","199409110sdg","San Diego Chargers",27,"Cincinnati Bengals",10,37,17,TRUE,"9/11/1994",1994,"September","1990s",69,79,8
"6217","199409110cle","Cleveland Browns",10,"Pittsburgh Steelers",17,27,-7,FALSE,"9/11/1994",1994,"September","1990s",58,69,6
"6218","199409110tam","Tampa Bay Buccaneers",24,"Indianapolis Colts",10,34,14,TRUE,"9/11/1994",1994,"September","1990s",78,85,8
"6219","199409110gnb","Green Bay Packers",14,"Miami Dolphins",24,38,-10,FALSE,"9/11/1994",1994,"September","1990s",69,89,7
"6220","199409110nor","New Orleans Saints",24,"Washington Redskins",38,62,-14,FALSE,"9/11/1994",1994,"September","1990s",72,NA,NA
"6221","199409110dal","Dallas Cowboys",20,"Houston Oilers",17,37,3,TRUE,"9/11/1994",1994,"September","1990s",77,71,7
"6222","199409110kan","Kansas City Chiefs",24,"San Francisco 49ers",17,41,7,TRUE,"9/11/1994",1994,"September","1990s",73,60,12
"6223","199409110crd","Arizona Cardinals",17,"New York Giants",20,37,-3,FALSE,"9/11/1994",1994,"September","1990s",86,45,11
"6224","199409110rai","Los Angeles Raiders",9,"Seattle Seahawks",38,47,-29,FALSE,"9/11/1994",1994,"September","1990s",68,72,11
"6225","199409110nwe","New England Patriots",35,"Buffalo Bills",38,73,-3,FALSE,"9/11/1994",1994,"September","1990s",62,57,15
"6226","199409110atl","Atlanta Falcons",31,"Los Angeles Rams",13,44,18,TRUE,"9/11/1994",1994,"September","1990s",72,NA,NA
"6227","199409120phi","Philadelphia Eagles",30,"Chicago Bears",22,52,8,TRUE,"9/12/1994",1994,"September","1990s",64,53,10
"6228","199409180nyg","New York Giants",31,"Washington Redskins",23,54,8,TRUE,"9/18/1994",1994,"September","1990s",70,68,16
"6229","199409180cin","Cincinnati Bengals",28,"New England Patriots",31,59,-3,FALSE,"9/18/1994",1994,"September","1990s",65,67,10
"6230","199409180atl","Atlanta Falcons",10,"Kansas City Chiefs",30,40,-20,FALSE,"9/18/1994",1994,"September","1990s",72,NA,NA
"6231","199409180oti","Houston Oilers",7,"Buffalo Bills",15,22,-8,FALSE,"9/18/1994",1994,"September","1990s",72,NA,NA
"6232","199409180tam","Tampa Bay Buccaneers",7,"New Orleans Saints",9,16,-2,FALSE,"9/18/1994",1994,"September","1990s",81,83,8
"6233","199409180phi","Philadelphia Eagles",13,"Green Bay Packers",7,20,6,TRUE,"9/18/1994",1994,"September","1990s",71,65,14
"6234","199409180pit","Pittsburgh Steelers",31,"Indianapolis Colts",21,52,10,TRUE,"9/18/1994",1994,"September","1990s",62,70,11
"6235","199409180chi","Chicago Bears",14,"Minnesota Vikings",42,56,-28,FALSE,"9/18/1994",1994,"September","1990s",66,59,6
"6236","199409180cle","Cleveland Browns",32,"Arizona Cardinals",0,32,32,TRUE,"9/18/1994",1994,"September","1990s",65,62,11
"6237","199409180ram","Los Angeles Rams",19,"San Francisco 49ers",34,53,-15,FALSE,"9/18/1994",1994,"September","1990s",67,81,8
"6238","199409180mia","Miami Dolphins",28,"New York Jets",14,42,14,TRUE,"9/18/1994",1994,"September","1990s",84,77,11
"6239","199409180sea","Seattle Seahawks",10,"San Diego Chargers",24,34,-14,FALSE,"9/18/1994",1994,"September","1990s",67,68,10
"6240","199409180den","Denver Broncos",16,"Los Angeles Raiders",48,64,-32,FALSE,"9/18/1994",1994,"September","1990s",68,30,9
"6241","199409190dal","Dallas Cowboys",17,"Detroit Lions",20,37,-3,FALSE,"9/19/1994",1994,"September","1990s",73,57,9
"6242","199409250min","Minnesota Vikings",38,"Miami Dolphins",35,73,3,TRUE,"9/25/1994",1994,"September","1990s",72,NA,NA
"6243","199409250gnb","Green Bay Packers",30,"Tampa Bay Buccaneers",3,33,27,TRUE,"9/25/1994",1994,"September","1990s",65,89,9
"6244","199409250sfo","San Francisco 49ers",24,"New Orleans Saints",13,37,11,TRUE,"9/25/1994",1994,"September","1990s",65,80,10
"6245","199409250kan","Kansas City Chiefs",0,"Los Angeles Rams",16,16,-16,FALSE,"9/25/1994",1994,"September","1990s",58,85,13
"6246","199409250oti","Houston Oilers",20,"Cincinnati Bengals",13,33,7,TRUE,"9/25/1994",1994,"September","1990s",72,NA,NA
"6247","199409250clt","Indianapolis Colts",14,"Cleveland Browns",21,35,-7,FALSE,"9/25/1994",1994,"September","1990s",72,NA,NA
"6248","199409250rai","Los Angeles Raiders",24,"San Diego Chargers",26,50,-2,FALSE,"9/25/1994",1994,"September","1990s",69,75,8
"6249","199409250det","Detroit Lions",17,"New England Patriots",23,40,-6,FALSE,"9/25/1994",1994,"September","1990s",72,NA,NA
"6250","199409250was","Washington Redskins",20,"Atlanta Falcons",27,47,-7,FALSE,"9/25/1994",1994,"September","1990s",72,87,6
"6251","199409250nyj","New York Jets",7,"Chicago Bears",19,26,-12,FALSE,"9/25/1994",1994,"September","1990s",70,77,8
"6252","199409250sea","Seattle Seahawks",30,"Pittsburgh Steelers",13,43,17,TRUE,"9/25/1994",1994,"September","1990s",65,68,8
"6253","199409260buf","Buffalo Bills",27,"Denver Broncos",20,47,7,TRUE,"9/26/1994",1994,"September","1990s",64,84,10
"6254","199410020sfo","San Francisco 49ers",8,"Philadelphia Eagles",40,48,-32,FALSE,"10/2/1994",1994,"October","1990s",60,81,14
"6255","199410020crd","Arizona Cardinals",17,"Minnesota Vikings",7,24,10,TRUE,"10/2/1994",1994,"October","1990s",80,26,7
"6256","199410020was","Washington Redskins",7,"Dallas Cowboys",34,41,-27,FALSE,"10/2/1994",1994,"October","1990s",66,80,11
"6257","199410020nwe","New England Patriots",17,"Green Bay Packers",16,33,1,TRUE,"10/2/1994",1994,"October","1990s",53,65,13
"6258","199410020chi","Chicago Bears",20,"Buffalo Bills",13,33,7,TRUE,"10/2/1994",1994,"October","1990s",56,66,16
"6259","199410020tam","Tampa Bay Buccaneers",24,"Detroit Lions",14,38,10,TRUE,"10/2/1994",1994,"October","1990s",78,88,15
"6260","199410020ram","Los Angeles Rams",5,"Atlanta Falcons",8,13,-3,FALSE,"10/2/1994",1994,"October","1990s",66,80,8
"6261","199410020nor","New Orleans Saints",27,"New York Giants",22,49,5,TRUE,"10/2/1994",1994,"October","1990s",72,NA,NA
"6262","199410020cle","Cleveland Browns",27,"New York Jets",7,34,20,TRUE,"10/2/1994",1994,"October","1990s",56,65,11
"6263","199410020cin","Cincinnati Bengals",7,"Miami Dolphins",23,30,-16,FALSE,"10/2/1994",1994,"October","1990s",65,74,10
"6264","199410020clt","Indianapolis Colts",17,"Seattle Seahawks",15,32,2,TRUE,"10/2/1994",1994,"October","1990s",72,NA,NA
"6265","199410030pit","Pittsburgh Steelers",30,"Houston Oilers",14,44,16,TRUE,"10/3/1994",1994,"October","1990s",52,54,11
"6266","199410090sdg","San Diego Chargers",20,"Kansas City Chiefs",6,26,14,TRUE,"10/9/1994",1994,"October","1990s",78,42,9
"6267","199410090phi","Philadelphia Eagles",21,"Washington Redskins",17,38,4,TRUE,"10/9/1994",1994,"October","1990s",66,77,12
"6268","199410090sea","Seattle Seahawks",9,"Denver Broncos",16,25,-7,FALSE,"10/9/1994",1994,"October","1990s",58,71,7
"6269","199410090dal","Dallas Cowboys",38,"Arizona Cardinals",3,41,35,TRUE,"10/9/1994",1994,"October","1990s",61,56,14
"6270","199410090det","Detroit Lions",21,"San Francisco 49ers",27,48,-6,FALSE,"10/9/1994",1994,"October","1990s",72,NA,NA
"6271","199410090nyj","New York Jets",16,"Indianapolis Colts",6,22,10,TRUE,"10/9/1994",1994,"October","1990s",66,77,12
"6272","199410090nwe","New England Patriots",17,"Los Angeles Raiders",21,38,-4,FALSE,"10/9/1994",1994,"October","1990s",63,76,17
"6273","199410090chi","Chicago Bears",17,"New Orleans Saints",7,24,10,TRUE,"10/9/1994",1994,"October","1990s",50,69,14
"6274","199410090buf","Buffalo Bills",21,"Miami Dolphins",11,32,10,TRUE,"10/9/1994",1994,"October","1990s",61,62,20
"6275","199410090gnb","Green Bay Packers",24,"Los Angeles Rams",17,41,7,TRUE,"10/9/1994",1994,"October","1990s",47,71,12
"6276","199410090atl","Atlanta Falcons",34,"Tampa Bay Buccaneers",13,47,21,TRUE,"10/9/1994",1994,"October","1990s",72,NA,NA
"6277","199410100nyg","New York Giants",10,"Minnesota Vikings",27,37,-17,FALSE,"10/10/1994",1994,"October","1990s",60,61,20
"6278","199410130oti","Houston Oilers",8,"Cleveland Browns",11,19,-3,FALSE,"10/13/1994",1994,"October","1990s",72,NA,NA
"6279","199410160dal","Dallas Cowboys",24,"Philadelphia Eagles",13,37,11,TRUE,"10/16/1994",1994,"October","1990s",68,97,12
"6280","199410160ram","Los Angeles Rams",17,"New York Giants",10,27,7,TRUE,"10/16/1994",1994,"October","1990s",65,43,11
"6281","199410160pit","Pittsburgh Steelers",14,"Cincinnati Bengals",10,24,4,TRUE,"10/16/1994",1994,"October","1990s",56,48,6
"6282","199410160was","Washington Redskins",16,"Arizona Cardinals",19,35,-3,FALSE,"10/16/1994",1994,"October","1990s",57,58,8
"6283","199410160atl","Atlanta Falcons",3,"San Francisco 49ers",42,45,-39,FALSE,"10/16/1994",1994,"October","1990s",72,NA,NA
"6284","199410160mia","Miami Dolphins",20,"Los Angeles Raiders",17,37,3,TRUE,"10/16/1994",1994,"October","1990s",77,72,15
"6285","199410160buf","Buffalo Bills",17,"Indianapolis Colts",27,44,-10,FALSE,"10/16/1994",1994,"October","1990s",46,64,6
"6286","199410160nyj","New York Jets",24,"New England Patriots",17,41,7,TRUE,"10/16/1994",1994,"October","1990s",55,40,16
"6287","199410160nor","New Orleans Saints",22,"San Diego Chargers",36,58,-14,FALSE,"10/16/1994",1994,"October","1990s",72,NA,NA
"6288","199410170den","Denver Broncos",28,"Kansas City Chiefs",31,59,-3,FALSE,"10/17/1994",1994,"October","1990s",43,80,7
"6289","199410200min","Minnesota Vikings",13,"Green Bay Packers",10,23,3,TRUE,"10/20/1994",1994,"October","1990s",72,NA,NA
"6290","199410230crd","Arizona Cardinals",21,"Dallas Cowboys",28,49,-7,FALSE,"10/23/1994",1994,"October","1990s",73,41,5
"6291","199410230sdg","San Diego Chargers",15,"Denver Broncos",20,35,-5,FALSE,"10/23/1994",1994,"October","1990s",64,80,5
"6292","199410230det","Detroit Lions",21,"Chicago Bears",16,37,5,TRUE,"10/23/1994",1994,"October","1990s",72,NA,NA
"6293","199410230nyg","New York Giants",6,"Pittsburgh Steelers",10,16,-4,FALSE,"10/23/1994",1994,"October","1990s",62,74,8
"6294","199410230kan","Kansas City Chiefs",38,"Seattle Seahawks",23,61,15,TRUE,"10/23/1994",1994,"October","1990s",50,52,7
"6295","199410230cle","Cleveland Browns",37,"Cincinnati Bengals",13,50,24,TRUE,"10/23/1994",1994,"October","1990s",55,61,11
"6296","199410230rai","Los Angeles Raiders",30,"Atlanta Falcons",17,47,13,TRUE,"10/23/1994",1994,"October","1990s",62,86,7
"6297","199410230clt","Indianapolis Colts",27,"Washington Redskins",41,68,-14,FALSE,"10/23/1994",1994,"October","1990s",72,NA,NA
"6298","199410230nor","New Orleans Saints",37,"Los Angeles Rams",34,71,3,TRUE,"10/23/1994",1994,"October","1990s",72,NA,NA
"6299","199410230sfo","San Francisco 49ers",41,"Tampa Bay Buccaneers",16,57,25,TRUE,"10/23/1994",1994,"October","1990s",60,62,8
"6300","199410240phi","Philadelphia Eagles",21,"Houston Oilers",6,27,15,TRUE,"10/24/1994",1994,"October","1990s",59,66,9
"6301","199410300crd","Arizona Cardinals",20,"Pittsburgh Steelers",17,37,3,TRUE,"10/30/1994",1994,"October","1990s",73,39,4
"6302","199410300cin","Cincinnati Bengals",20,"Dallas Cowboys",23,43,-3,FALSE,"10/30/1994",1994,"October","1990s",54,54,4
"6303","199410300den","Denver Broncos",26,"Cleveland Browns",14,40,12,TRUE,"10/30/1994",1994,"October","1990s",42,59,7
"6304","199410300nwe","New England Patriots",3,"Miami Dolphins",23,26,-20,FALSE,"10/30/1994",1994,"October","1990s",61,51,16
"6305","199410300tam","Tampa Bay Buccaneers",13,"Minnesota Vikings",36,49,-23,FALSE,"10/30/1994",1994,"October","1990s",75,88,9
"6306","199410300rai","Los Angeles Raiders",17,"Houston Oilers",14,31,3,TRUE,"10/30/1994",1994,"October","1990s",62,76,8
"6307","199410300buf","Buffalo Bills",44,"Kansas City Chiefs",10,54,34,TRUE,"10/30/1994",1994,"October","1990s",58,56,14
"6308","199410300sdg","San Diego Chargers",35,"Seattle Seahawks",15,50,20,TRUE,"10/30/1994",1994,"October","1990s",64,70,8
"6309","199410300nyg","New York Giants",25,"Detroit Lions",28,53,-3,FALSE,"10/30/1994",1994,"October","1990s",59,62,12
"6310","199410300was","Washington Redskins",29,"Philadelphia Eagles",31,60,-2,FALSE,"10/30/1994",1994,"October","1990s",61,70,6
"6311","199410300clt","Indianapolis Colts",28,"New York Jets",25,53,3,TRUE,"10/30/1994",1994,"October","1990s",72,NA,NA
"6312","199410310chi","Chicago Bears",6,"Green Bay Packers",33,39,-27,FALSE,"10/31/1994",1994,"October","1990s",49,83,15
"6313","199411060tam","Tampa Bay Buccaneers",6,"Chicago Bears",20,26,-14,FALSE,"11/6/1994",1994,"November","1990s",74,70,7
"6314","199411060oti","Houston Oilers",9,"Pittsburgh Steelers",12,21,-3,FALSE,"11/6/1994",1994,"November","1990s",72,NA,NA
"6315","199411060gnb","Green Bay Packers",38,"Detroit Lions",30,68,8,TRUE,"11/6/1994",1994,"November","1990s",48,79,21
"6316","199411060nyj","New York Jets",22,"Buffalo Bills",17,39,5,TRUE,"11/6/1994",1994,"November","1990s",65,72,16
"6317","199411060cle","Cleveland Browns",13,"New England Patriots",6,19,7,TRUE,"11/6/1994",1994,"November","1990s",58,83,19
"6318","199411060kan","Kansas City Chiefs",13,"Los Angeles Raiders",3,16,10,TRUE,"11/6/1994",1994,"November","1990s",46,68,8
"6319","199411060min","Minnesota Vikings",21,"New Orleans Saints",20,41,1,TRUE,"11/6/1994",1994,"November","1990s",72,NA,NA
"6320","199411060was","Washington Redskins",22,"San Francisco 49ers",37,59,-15,FALSE,"11/6/1994",1994,"November","1990s",67,78,15
"6321","199411060phi","Philadelphia Eagles",17,"Arizona Cardinals",7,24,10,TRUE,"11/6/1994",1994,"November","1990s",63,84,12
"6322","199411060atl","Atlanta Falcons",10,"San Diego Chargers",9,19,1,TRUE,"11/6/1994",1994,"November","1990s",72,NA,NA
"6323","199411060sea","Seattle Seahawks",17,"Cincinnati Bengals",20,37,-3,FALSE,"11/6/1994",1994,"November","1990s",72,NA,NA
"6324","199411060ram","Los Angeles Rams",27,"Denver Broncos",21,48,6,TRUE,"11/6/1994",1994,"November","1990s",58,52,8
"6325","199411060mia","Miami Dolphins",22,"Indianapolis Colts",21,43,1,TRUE,"11/6/1994",1994,"November","1990s",79,71,12
"6326","199411070dal","Dallas Cowboys",38,"New York Giants",10,48,28,TRUE,"11/7/1994",1994,"November","1990s",60,71,11
"6327","199411130nwe","New England Patriots",26,"Minnesota Vikings",20,46,6,TRUE,"11/13/1994",1994,"November","1990s",48,51,13
"6328","199411130ram","Los Angeles Rams",17,"Los Angeles Raiders",20,37,-3,FALSE,"11/13/1994",1994,"November","1990s",56,64,6
"6329","199411130kan","Kansas City Chiefs",13,"San Diego Chargers",14,27,-1,FALSE,"11/13/1994",1994,"November","1990s",56,76,18
"6330","199411130gnb","Green Bay Packers",17,"New York Jets",10,27,7,TRUE,"11/13/1994",1994,"November","1990s",51,92,12
"6331","199411130det","Detroit Lions",14,"Tampa Bay Buccaneers",9,23,5,TRUE,"11/13/1994",1994,"November","1990s",72,NA,NA
"6332","199411130cin","Cincinnati Bengals",34,"Houston Oilers",31,65,3,TRUE,"11/13/1994",1994,"November","1990s",56,75,9
"6333","199411130mia","Miami Dolphins",14,"Chicago Bears",17,31,-3,FALSE,"11/13/1994",1994,"November","1990s",75,85,13
"6334","199411130sfo","San Francisco 49ers",21,"Dallas Cowboys",14,35,7,TRUE,"11/13/1994",1994,"November","1990s",51,62,8
"6335","199411130den","Denver Broncos",17,"Seattle Seahawks",10,27,7,TRUE,"11/13/1994",1994,"November","1990s",48,37,10
"6336","199411130nyg","New York Giants",9,"Arizona Cardinals",10,19,-1,FALSE,"11/13/1994",1994,"November","1990s",52,51,12
"6337","199411130phi","Philadelphia Eagles",7,"Cleveland Browns",26,33,-19,FALSE,"11/13/1994",1994,"November","1990s",53,62,8
"6338","199411130nor","New Orleans Saints",33,"Atlanta Falcons",32,65,1,TRUE,"11/13/1994",1994,"November","1990s",72,NA,NA
"6339","199411140pit","Pittsburgh Steelers",23,"Buffalo Bills",10,33,13,TRUE,"11/14/1994",1994,"November","1990s",58,68,10
"6340","199411200min","Minnesota Vikings",21,"New York Jets",31,52,-10,FALSE,"11/20/1994",1994,"November","1990s",72,NA,NA
"6341","199411200chi","Chicago Bears",20,"Detroit Lions",10,30,10,TRUE,"11/20/1994",1994,"November","1990s",47,70,10
"6342","199411200dal","Dallas Cowboys",31,"Washington Redskins",7,38,24,TRUE,"11/20/1994",1994,"November","1990s",64,65,18
"6343","199411200crd","Arizona Cardinals",12,"Philadelphia Eagles",6,18,6,TRUE,"11/20/1994",1994,"November","1990s",45,48,8
"6344","199411200sea","Seattle Seahawks",22,"Tampa Bay Buccaneers",21,43,1,TRUE,"11/20/1994",1994,"November","1990s",72,NA,NA
"6345","199411200pit","Pittsburgh Steelers",16,"Miami Dolphins",13,29,3,TRUE,"11/20/1994",1994,"November","1990s",48,54,9
"6346","199411200sfo","San Francisco 49ers",31,"Los Angeles Rams",27,58,4,TRUE,"11/20/1994",1994,"November","1990s",46,76,5
"6347","199411200den","Denver Broncos",32,"Atlanta Falcons",28,60,4,TRUE,"11/20/1994",1994,"November","1990s",34,67,13
"6348","199411200buf","Buffalo Bills",29,"Green Bay Packers",20,49,9,TRUE,"11/20/1994",1994,"November","1990s",40,69,8
"6349","199411200kan","Kansas City Chiefs",20,"Cleveland Browns",13,33,7,TRUE,"11/20/1994",1994,"November","1990s",45,96,16
"6350","199411200cin","Cincinnati Bengals",13,"Indianapolis Colts",17,30,-4,FALSE,"11/20/1994",1994,"November","1990s",53,47,11
"6351","199411200rai","Los Angeles Raiders",24,"New Orleans Saints",19,43,5,TRUE,"11/20/1994",1994,"November","1990s",51,51,7
"6352","199411200nwe","New England Patriots",23,"San Diego Chargers",17,40,6,TRUE,"11/20/1994",1994,"November","1990s",47,46,13
"6353","199411210oti","Houston Oilers",10,"New York Giants",13,23,-3,FALSE,"11/21/1994",1994,"November","1990s",72,NA,NA
"6354","199411240det","Detroit Lions",35,"Buffalo Bills",21,56,14,TRUE,"11/24/1994",1994,"November","1990s",72,NA,NA
"6355","199411240dal","Dallas Cowboys",42,"Green Bay Packers",31,73,11,TRUE,"11/24/1994",1994,"November","1990s",47,74,10
"6356","199411270nyj","New York Jets",24,"Miami Dolphins",28,52,-4,FALSE,"11/27/1994",1994,"November","1990s",33,57,15
"6357","199411270min","Minnesota Vikings",17,"Tampa Bay Buccaneers",20,37,-3,FALSE,"11/27/1994",1994,"November","1990s",72,NA,NA
"6358","199411270rai","Los Angeles Raiders",3,"Pittsburgh Steelers",21,24,-18,FALSE,"11/27/1994",1994,"November","1990s",53,33,14
"6359","199411270sdg","San Diego Chargers",31,"Los Angeles Rams",17,48,14,TRUE,"11/27/1994",1994,"November","1990s",52,58,8
"6360","199411270clt","Indianapolis Colts",10,"New England Patriots",12,22,-2,FALSE,"11/27/1994",1994,"November","1990s",72,NA,NA
"6361","199411270den","Denver Broncos",15,"Cincinnati Bengals",13,28,2,TRUE,"11/27/1994",1994,"November","1990s",27,48,18
"6362","199411270atl","Atlanta Falcons",28,"Philadelphia Eagles",21,49,7,TRUE,"11/27/1994",1994,"November","1990s",72,NA,NA
"6363","199411270sea","Seattle Seahawks",10,"Kansas City Chiefs",9,19,1,TRUE,"11/27/1994",1994,"November","1990s",72,NA,NA
"6364","199411270cle","Cleveland Browns",34,"Houston Oilers",10,44,24,TRUE,"11/27/1994",1994,"November","1990s",37,66,17
"6365","199411270crd","Arizona Cardinals",16,"Chicago Bears",19,35,-3,FALSE,"11/27/1994",1994,"November","1990s",51,31,11
"6366","199411270was","Washington Redskins",19,"New York Giants",21,40,-2,FALSE,"11/27/1994",1994,"November","1990s",39,65,10
"6367","199411280nor","New Orleans Saints",14,"San Francisco 49ers",35,49,-21,FALSE,"11/28/1994",1994,"November","1990s",72,NA,NA
"6368","199412010min","Minnesota Vikings",33,"Chicago Bears",27,60,6,TRUE,"12/1/1994",1994,"December","1990s",72,NA,NA
"6369","199412040ram","Los Angeles Rams",15,"New Orleans Saints",31,46,-16,FALSE,"12/4/1994",1994,"December","1990s",56,84,6
"6370","199412040det","Detroit Lions",34,"Green Bay Packers",31,65,3,TRUE,"12/4/1994",1994,"December","1990s",72,NA,NA
"6371","199412040kan","Kansas City Chiefs",17,"Denver Broncos",20,37,-3,FALSE,"12/4/1994",1994,"December","1990s",53,88,9
"6372","199412040mia","Miami Dolphins",31,"Buffalo Bills",42,73,-11,FALSE,"12/4/1994",1994,"December","1990s",79,80,15
"6373","199412040tam","Tampa Bay Buccaneers",26,"Washington Redskins",21,47,5,TRUE,"12/4/1994",1994,"December","1990s",76,80,8
"6374","199412040phi","Philadelphia Eagles",19,"Dallas Cowboys",31,50,-12,FALSE,"12/4/1994",1994,"December","1990s",50,71,4
"6375","199412040nwe","New England Patriots",24,"New York Jets",13,37,11,TRUE,"12/4/1994",1994,"December","1990s",51,55,9
"6376","199412040cle","Cleveland Browns",13,"New York Giants",16,29,-3,FALSE,"12/4/1994",1994,"December","1990s",56,73,9
"6377","199412040oti","Houston Oilers",12,"Arizona Cardinals",30,42,-18,FALSE,"12/4/1994",1994,"December","1990s",72,NA,NA
"6378","199412040cin","Cincinnati Bengals",15,"Pittsburgh Steelers",38,53,-23,FALSE,"12/4/1994",1994,"December","1990s",53,93,9
"6379","199412040sea","Seattle Seahawks",19,"Indianapolis Colts",31,50,-12,FALSE,"12/4/1994",1994,"December","1990s",72,NA,NA
"6380","199412040sfo","San Francisco 49ers",50,"Atlanta Falcons",14,64,36,TRUE,"12/4/1994",1994,"December","1990s",51,78,14
"6381","199412050sdg","San Diego Chargers",17,"Los Angeles Raiders",24,41,-7,FALSE,"12/5/1994",1994,"December","1990s",58,74,7
"6382","199412100nyj","New York Jets",7,"Detroit Lions",18,25,-11,FALSE,"12/10/1994",1994,"December","1990s",43,75,15
"6383","199412100dal","Dallas Cowboys",14,"Cleveland Browns",19,33,-5,FALSE,"12/10/1994",1994,"December","1990s",42,69,20
"6384","199412110buf","Buffalo Bills",17,"Minnesota Vikings",21,38,-4,FALSE,"12/11/1994",1994,"December","1990s",30,81,16
"6385","199412110pit","Pittsburgh Steelers",14,"Philadelphia Eagles",3,17,11,TRUE,"12/11/1994",1994,"December","1990s",33,75,18
"6386","199412110oti","Houston Oilers",14,"Seattle Seahawks",16,30,-2,FALSE,"12/11/1994",1994,"December","1990s",72,NA,NA
"6387","199412110nyg","New York Giants",27,"Cincinnati Bengals",20,47,7,TRUE,"12/11/1994",1994,"December","1990s",45,72,21
"6388","199412110gnb","Green Bay Packers",40,"Chicago Bears",3,43,37,TRUE,"12/11/1994",1994,"December","1990s",17,55,10
"6389","199412110rai","Los Angeles Raiders",23,"Denver Broncos",13,36,10,TRUE,"12/11/1994",1994,"December","1990s",54,49,7
"6390","199412110sdg","San Diego Chargers",15,"San Francisco 49ers",38,53,-23,FALSE,"12/11/1994",1994,"December","1990s",54,62,7
"6391","199412110tam","Tampa Bay Buccaneers",24,"Los Angeles Rams",14,38,10,TRUE,"12/11/1994",1994,"December","1990s",68,89,13
"6392","199412110atl","Atlanta Falcons",20,"New Orleans Saints",29,49,-9,FALSE,"12/11/1994",1994,"December","1990s",72,NA,NA
"6393","199412110crd","Arizona Cardinals",17,"Washington Redskins",15,32,2,TRUE,"12/11/1994",1994,"December","1990s",52,38,5
"6394","199412110nwe","New England Patriots",28,"Indianapolis Colts",13,41,15,TRUE,"12/11/1994",1994,"December","1990s",43,76,19
"6395","199412120mia","Miami Dolphins",45,"Kansas City Chiefs",28,73,17,TRUE,"12/12/1994",1994,"December","1990s",70,74,11
"6396","199412170det","Detroit Lions",41,"Minnesota Vikings",19,60,22,TRUE,"12/17/1994",1994,"December","1990s",72,NA,NA
"6397","199412170sfo","San Francisco 49ers",42,"Denver Broncos",19,61,23,TRUE,"12/17/1994",1994,"December","1990s",47,86,8
"6398","199412180gnb","Green Bay Packers",21,"Atlanta Falcons",17,38,4,TRUE,"12/18/1994",1994,"December","1990s",34,78,13
"6399","199412180was","Washington Redskins",14,"Tampa Bay Buccaneers",17,31,-3,FALSE,"12/18/1994",1994,"December","1990s",46,78,8
"6400","199412180sea","Seattle Seahawks",16,"Los Angeles Raiders",17,33,-1,FALSE,"12/18/1994",1994,"December","1990s",72,NA,NA
"6401","199412180buf","Buffalo Bills",17,"New England Patriots",41,58,-24,FALSE,"12/18/1994",1994,"December","1990s",36,87,7
"6402","199412180clt","Indianapolis Colts",10,"Miami Dolphins",6,16,4,TRUE,"12/18/1994",1994,"December","1990s",72,NA,NA
"6403","199412180crd","Arizona Cardinals",28,"Cincinnati Bengals",7,35,21,TRUE,"12/18/1994",1994,"December","1990s",58,39,5
"6404","199412180chi","Chicago Bears",27,"Los Angeles Rams",13,40,14,TRUE,"12/18/1994",1994,"December","1990s",33,78,14
"6405","199412180pit","Pittsburgh Steelers",17,"Cleveland Browns",7,24,10,TRUE,"12/18/1994",1994,"December","1990s",36,81,9
"6406","199412180kan","Kansas City Chiefs",31,"Houston Oilers",9,40,22,TRUE,"12/18/1994",1994,"December","1990s",33,70,9
"6407","199412180phi","Philadelphia Eagles",13,"New York Giants",16,29,-3,FALSE,"12/18/1994",1994,"December","1990s",44,84,8
"6408","199412180nyj","New York Jets",6,"San Diego Chargers",21,27,-15,FALSE,"12/18/1994",1994,"December","1990s",44,80,11
"6409","199412190nor","New Orleans Saints",16,"Dallas Cowboys",24,40,-8,FALSE,"12/19/1994",1994,"December","1990s",72,NA,NA
"6410","199412240den","Denver Broncos",28,"New Orleans Saints",30,58,-2,FALSE,"12/24/1994",1994,"December","1990s",41,40,8
"6411","199412240atl","Atlanta Falcons",10,"Arizona Cardinals",6,16,4,TRUE,"12/24/1994",1994,"December","1990s",72,NA,NA
"6412","199412240cle","Cleveland Browns",35,"Seattle Seahawks",9,44,26,TRUE,"12/24/1994",1994,"December","1990s",40,88,13
"6413","199412240nyg","New York Giants",15,"Dallas Cowboys",10,25,5,TRUE,"12/24/1994",1994,"December","1990s",46,78,31
"6414","199412240rai","Los Angeles Raiders",9,"Kansas City Chiefs",19,28,-10,FALSE,"12/24/1994",1994,"December","1990s",62,68,7
"6415","199412240tam","Tampa Bay Buccaneers",19,"Green Bay Packers",34,53,-15,FALSE,"12/24/1994",1994,"December","1990s",58,72,13
"6416","199412240ram","Los Angeles Rams",21,"Washington Redskins",24,45,-3,FALSE,"12/24/1994",1994,"December","1990s",62,68,7
"6417","199412240oti","Houston Oilers",24,"New York Jets",10,34,14,TRUE,"12/24/1994",1994,"December","1990s",72,NA,NA
"6418","199412240chi","Chicago Bears",3,"New England Patriots",13,16,-10,FALSE,"12/24/1994",1994,"December","1990s",37,90,11
"6419","199412240clt","Indianapolis Colts",10,"Buffalo Bills",9,19,1,TRUE,"12/24/1994",1994,"December","1990s",72,NA,NA
"6420","199412240sdg","San Diego Chargers",37,"Pittsburgh Steelers",34,71,3,TRUE,"12/24/1994",1994,"December","1990s",60,84,8
"6421","199412240cin","Cincinnati Bengals",33,"Philadelphia Eagles",30,63,3,TRUE,"12/24/1994",1994,"December","1990s",38,86,12
"6422","199412250mia","Miami Dolphins",27,"Detroit Lions",20,47,7,TRUE,"12/25/1994",1994,"December","1990s",60,70,7
"6423","199412260min","Minnesota Vikings",21,"San Francisco 49ers",14,35,7,TRUE,"12/26/1994",1994,"December","1990s",72,NA,NA
"6424","199412310gnb","Green Bay Packers",16,"Detroit Lions",12,28,4,TRUE,"12/31/1994",1994,"December","1990s",32,69,7
"6425","199412310mia","Miami Dolphins",27,"Kansas City Chiefs",17,44,10,TRUE,"12/31/1994",1994,"December","1990s",72,74,9
"6426","199501010cle","Cleveland Browns",20,"New England Patriots",13,33,7,TRUE,"1/1/1995",1995,"January","1990s",40,94,10
"6427","199501010min","Minnesota Vikings",18,"Chicago Bears",35,53,-17,FALSE,"1/1/1995",1995,"January","1990s",72,NA,NA
"6428","199501070sfo","San Francisco 49ers",44,"Chicago Bears",15,59,29,TRUE,"1/7/1995",1995,"January","1990s",54,80,26
"6429","199501070pit","Pittsburgh Steelers",29,"Cleveland Browns",9,38,20,TRUE,"1/7/1995",1995,"January","1990s",33,85,13
"6430","199501080dal","Dallas Cowboys",35,"Green Bay Packers",9,44,26,TRUE,"1/8/1995",1995,"January","1990s",47,56,11
"6431","199501080sdg","San Diego Chargers",22,"Miami Dolphins",21,43,1,TRUE,"1/8/1995",1995,"January","1990s",60,86,12
"6432","199501150pit","Pittsburgh Steelers",13,"San Diego Chargers",17,30,-4,FALSE,"1/15/1995",1995,"January","1990s",58,82,14
"6433","199501150sfo","San Francisco 49ers",38,"Dallas Cowboys",28,66,10,TRUE,"1/15/1995",1995,"January","1990s",51,84,13
"6434","199501290sdg","San Diego Chargers",26,"San Francisco 49ers",49,75,-23,FALSE,"1/29/1995",1995,"January","1990s",73,80,6
"6435","199509030atl","Atlanta Falcons",23,"Carolina Panthers",20,43,3,TRUE,"9/3/1995",1995,"September","1990s",72,NA,NA
"6436","199509030mia","Miami Dolphins",52,"New York Jets",14,66,38,TRUE,"9/3/1995",1995,"September","1990s",84,78,7
"6437","199509030sea","Seattle Seahawks",10,"Kansas City Chiefs",34,44,-24,FALSE,"9/3/1995",1995,"September","1990s",72,NA,NA
"6438","199509030jax","Jacksonville Jaguars",3,"Houston Oilers",10,13,-7,FALSE,"9/3/1995",1995,"September","1990s",82,71,8
"6439","199509030den","Denver Broncos",22,"Buffalo Bills",7,29,15,TRUE,"9/3/1995",1995,"September","1990s",76,40,11
"6440","199509030gnb","Green Bay Packers",14,"St. Louis Rams",17,31,-3,FALSE,"9/3/1995",1995,"September","1990s",68,77,6
"6441","199509030nor","New Orleans Saints",22,"San Francisco 49ers",24,46,-2,FALSE,"9/3/1995",1995,"September","1990s",72,NA,NA
"6442","199509030pit","Pittsburgh Steelers",23,"Detroit Lions",20,43,3,TRUE,"9/3/1995",1995,"September","1990s",67,49,10
"6443","199509030clt","Indianapolis Colts",21,"Cincinnati Bengals",24,45,-3,FALSE,"9/3/1995",1995,"September","1990s",72,NA,NA
"6444","199509030rai","Oakland Raiders",17,"San Diego Chargers",7,24,10,TRUE,"9/3/1995",1995,"September","1990s",63,82,11
"6445","199509030nwe","New England Patriots",17,"Cleveland Browns",14,31,3,TRUE,"9/3/1995",1995,"September","1990s",64,56,12
"6446","199509030phi","Philadelphia Eagles",6,"Tampa Bay Buccaneers",21,27,-15,FALSE,"9/3/1995",1995,"September","1990s",74,51,6
"6447","199509030chi","Chicago Bears",31,"Minnesota Vikings",14,45,17,TRUE,"9/3/1995",1995,"September","1990s",72,56,6
"6448","199509030was","Washington Redskins",27,"Arizona Cardinals",7,34,20,TRUE,"9/3/1995",1995,"September","1990s",74,44,8
"6449","199509040nyg","New York Giants",0,"Dallas Cowboys",35,35,-35,FALSE,"9/4/1995",1995,"September","1990s",75,52,12
"6450","199509100min","Minnesota Vikings",20,"Detroit Lions",10,30,10,TRUE,"9/10/1995",1995,"September","1990s",72,NA,NA
"6451","199509100crd","Arizona Cardinals",19,"Philadelphia Eagles",31,50,-12,FALSE,"9/10/1995",1995,"September","1990s",88,40,11
"6452","199509100nyj","New York Jets",24,"Indianapolis Colts",27,51,-3,FALSE,"9/10/1995",1995,"September","1990s",68,56,15
"6453","199509100cle","Cleveland Browns",22,"Tampa Bay Buccaneers",6,28,16,TRUE,"9/10/1995",1995,"September","1990s",58,67,11
"6454","199509100dal","Dallas Cowboys",31,"Denver Broncos",21,52,10,TRUE,"9/10/1995",1995,"September","1990s",75,61,10
"6455","199509100cin","Cincinnati Bengals",24,"Jacksonville Jaguars",17,41,7,TRUE,"9/10/1995",1995,"September","1990s",67,60,10
"6456","199509100kan","Kansas City Chiefs",20,"New York Giants",17,37,3,TRUE,"9/10/1995",1995,"September","1990s",61,66,7
"6457","199509100sfo","San Francisco 49ers",41,"Atlanta Falcons",10,51,31,TRUE,"9/10/1995",1995,"September","1990s",61,78,10
"6458","199509100sdg","San Diego Chargers",14,"Seattle Seahawks",10,24,4,TRUE,"9/10/1995",1995,"September","1990s",70,75,10
"6459","199509100was","Washington Redskins",8,"Oakland Raiders",20,28,-12,FALSE,"9/10/1995",1995,"September","1990s",72,59,12
"6460","199509100ram","St. Louis Rams",17,"New Orleans Saints",13,30,4,TRUE,"9/10/1995",1995,"September","1990s",65,62,7
"6461","199509100oti","Houston Oilers",17,"Pittsburgh Steelers",34,51,-17,FALSE,"9/10/1995",1995,"September","1990s",72,NA,NA
"6462","199509100nwe","New England Patriots",3,"Miami Dolphins",20,23,-17,FALSE,"9/10/1995",1995,"September","1990s",64,60,16
"6463","199509100buf","Buffalo Bills",31,"Carolina Panthers",9,40,22,TRUE,"9/10/1995",1995,"September","1990s",53,61,10
"6464","199509110chi","Chicago Bears",24,"Green Bay Packers",27,51,-3,FALSE,"9/11/1995",1995,"September","1990s",57,61,6
"6465","199509170kan","Kansas City Chiefs",23,"Oakland Raiders",17,40,6,TRUE,"9/17/1995",1995,"September","1990s",65,73,8
"6466","199509170phi","Philadelphia Eagles",21,"San Diego Chargers",27,48,-6,FALSE,"9/17/1995",1995,"September","1990s",65,92,13
"6467","199509170nyj","New York Jets",27,"Jacksonville Jaguars",10,37,17,TRUE,"9/17/1995",1995,"September","1990s",66,81,16
"6468","199509170oti","Houston Oilers",7,"Cleveland Browns",14,21,-7,FALSE,"9/17/1995",1995,"September","1990s",72,NA,NA
"6469","199509170buf","Buffalo Bills",20,"Indianapolis Colts",14,34,6,TRUE,"9/17/1995",1995,"September","1990s",64,72,13
"6470","199509170gnb","Green Bay Packers",14,"New York Giants",6,20,8,TRUE,"9/17/1995",1995,"September","1990s",57,63,9
"6471","199509170tam","Tampa Bay Buccaneers",6,"Chicago Bears",25,31,-19,FALSE,"9/17/1995",1995,"September","1990s",82,77,7
"6472","199509170nor","New Orleans Saints",24,"Atlanta Falcons",27,51,-3,FALSE,"9/17/1995",1995,"September","1990s",72,NA,NA
"6473","199509170sea","Seattle Seahawks",24,"Cincinnati Bengals",21,45,3,TRUE,"9/17/1995",1995,"September","1990s",72,NA,NA
"6474","199509170det","Detroit Lions",17,"Arizona Cardinals",20,37,-3,FALSE,"9/17/1995",1995,"September","1990s",72,NA,NA
"6475","199509170den","Denver Broncos",38,"Washington Redskins",31,69,7,TRUE,"9/17/1995",1995,"September","1990s",70,30,11
"6476","199509170sfo","San Francisco 49ers",28,"New England Patriots",3,31,25,TRUE,"9/17/1995",1995,"September","1990s",62,80,10
"6477","199509170min","Minnesota Vikings",17,"Dallas Cowboys",23,40,-6,FALSE,"9/17/1995",1995,"September","1990s",72,NA,NA
"6478","199509170car","Carolina Panthers",10,"St. Louis Rams",31,41,-21,FALSE,"9/17/1995",1995,"September","1990s",73,80,8
"6479","199509180mia","Miami Dolphins",23,"Pittsburgh Steelers",10,33,13,TRUE,"9/18/1995",1995,"September","1990s",85,72,5
"6480","199509240tam","Tampa Bay Buccaneers",14,"Washington Redskins",6,20,8,TRUE,"9/24/1995",1995,"September","1990s",82,79,8
"6481","199509240cle","Cleveland Browns",35,"Kansas City Chiefs",17,52,18,TRUE,"9/24/1995",1995,"September","1990s",50,52,9
"6482","199509240jax","Jacksonville Jaguars",14,"Green Bay Packers",24,38,-10,FALSE,"9/24/1995",1995,"September","1990s",74,85,8
"6483","199509240sdg","San Diego Chargers",17,"Denver Broncos",6,23,11,TRUE,"9/24/1995",1995,"September","1990s",70,78,7
"6484","199509240nyg","New York Giants",45,"New Orleans Saints",29,74,16,TRUE,"9/24/1995",1995,"September","1990s",58,63,14
"6485","199509240rai","Oakland Raiders",48,"Philadelphia Eagles",17,65,31,TRUE,"9/24/1995",1995,"September","1990s",64,81,9
"6486","199509240cin","Cincinnati Bengals",28,"Houston Oilers",38,66,-10,FALSE,"9/24/1995",1995,"September","1990s",52,59,8
"6487","199509240pit","Pittsburgh Steelers",24,"Minnesota Vikings",44,68,-20,FALSE,"9/24/1995",1995,"September","1990s",52,62,9
"6488","199509240dal","Dallas Cowboys",34,"Arizona Cardinals",20,54,14,TRUE,"9/24/1995",1995,"September","1990s",63,56,8
"6489","199509240ram","St. Louis Rams",34,"Chicago Bears",28,62,6,TRUE,"9/24/1995",1995,"September","1990s",54,50,4
"6490","199509240atl","Atlanta Falcons",13,"New York Jets",3,16,10,TRUE,"9/24/1995",1995,"September","1990s",72,NA,NA
"6491","199509250det","Detroit Lions",27,"San Francisco 49ers",24,51,3,TRUE,"9/25/1995",1995,"September","1990s",72,NA,NA
"6492","199510010car","Carolina Panthers",13,"Tampa Bay Buccaneers",20,33,-7,FALSE,"10/1/1995",1995,"October","1990s",70,69,8
"6493","199510010clt","Indianapolis Colts",21,"St. Louis Rams",18,39,3,TRUE,"10/1/1995",1995,"October","1990s",72,NA,NA
"6494","199510010crd","Arizona Cardinals",3,"Kansas City Chiefs",24,27,-21,FALSE,"10/1/1995",1995,"October","1990s",77,30,4
"6495","199510010atl","Atlanta Falcons",30,"New England Patriots",17,47,13,TRUE,"10/1/1995",1995,"October","1990s",72,NA,NA
"6496","199510010oti","Houston Oilers",16,"Jacksonville Jaguars",17,33,-1,FALSE,"10/1/1995",1995,"October","1990s",72,NA,NA
"6497","199510010was","Washington Redskins",27,"Dallas Cowboys",23,50,4,TRUE,"10/1/1995",1995,"October","1990s",64,78,6
"6498","199510010nyj","New York Jets",10,"Oakland Raiders",47,57,-37,FALSE,"10/1/1995",1995,"October","1990s",63,62,7
"6499","199510010sfo","San Francisco 49ers",20,"New York Giants",6,26,14,TRUE,"10/1/1995",1995,"October","1990s",64,68,12
"6500","199510010sea","Seattle Seahawks",27,"Denver Broncos",10,37,17,TRUE,"10/1/1995",1995,"October","1990s",72,NA,NA
"6501","199510010cin","Cincinnati Bengals",23,"Miami Dolphins",26,49,-3,FALSE,"10/1/1995",1995,"October","1990s",66,72,9
"6502","199510010pit","Pittsburgh Steelers",31,"San Diego Chargers",16,47,15,TRUE,"10/1/1995",1995,"October","1990s",64,70,11
"6503","199510010nor","New Orleans Saints",10,"Philadelphia Eagles",15,25,-5,FALSE,"10/1/1995",1995,"October","1990s",72,NA,NA
"6504","199510020cle","Cleveland Browns",19,"Buffalo Bills",22,41,-3,FALSE,"10/2/1995",1995,"October","1990s",67,61,10
"6505","199510080min","Minnesota Vikings",23,"Houston Oilers",17,40,6,TRUE,"10/8/1995",1995,"October","1990s",72,NA,NA
"6506","199510080buf","Buffalo Bills",29,"New York Jets",10,39,19,TRUE,"10/8/1995",1995,"October","1990s",54,71,15
"6507","199510080chi","Chicago Bears",31,"Carolina Panthers",27,58,4,TRUE,"10/8/1995",1995,"October","1990s",53,70,7
"6508","199510080mia","Miami Dolphins",24,"Indianapolis Colts",27,51,-3,FALSE,"10/8/1995",1995,"October","1990s",81,82,9
"6509","199510080jax","Jacksonville Jaguars",20,"Pittsburgh Steelers",16,36,4,TRUE,"10/8/1995",1995,"October","1990s",80,74,11
"6510","199510080rai","Oakland Raiders",34,"Seattle Seahawks",14,48,20,TRUE,"10/8/1995",1995,"October","1990s",58,86,10
"6511","199510080det","Detroit Lions",38,"Cleveland Browns",20,58,18,TRUE,"10/8/1995",1995,"October","1990s",72,NA,NA
"6512","199510080tam","Tampa Bay Buccaneers",19,"Cincinnati Bengals",16,35,3,TRUE,"10/8/1995",1995,"October","1990s",78,84,10
"6513","199510080dal","Dallas Cowboys",34,"Green Bay Packers",24,58,10,TRUE,"10/8/1995",1995,"October","1990s",65,54,10
"6514","199510080nwe","New England Patriots",3,"Denver Broncos",37,40,-34,FALSE,"10/8/1995",1995,"October","1990s",59,79,12
"6515","199510080phi","Philadelphia Eagles",37,"Washington Redskins",34,71,3,TRUE,"10/8/1995",1995,"October","1990s",64,73,12
"6516","199510080nyg","New York Giants",27,"Arizona Cardinals",21,48,6,TRUE,"10/8/1995",1995,"October","1990s",64,68,12
"6517","199510090kan","Kansas City Chiefs",29,"San Diego Chargers",23,52,6,TRUE,"10/9/1995",1995,"October","1990s",60,64,6
"6518","199510120ram","St. Louis Rams",21,"Atlanta Falcons",19,40,2,TRUE,"10/12/1995",1995,"October","1990s",73,54,9
"6519","199510150gnb","Green Bay Packers",30,"Detroit Lions",21,51,9,TRUE,"10/15/1995",1995,"October","1990s",44,59,14
"6520","199510150clt","Indianapolis Colts",18,"San Francisco 49ers",17,35,1,TRUE,"10/15/1995",1995,"October","1990s",72,NA,NA
"6521","199510150buf","Buffalo Bills",27,"Seattle Seahawks",21,48,6,TRUE,"10/15/1995",1995,"October","1990s",50,61,23
"6522","199510150tam","Tampa Bay Buccaneers",20,"Minnesota Vikings",17,37,3,TRUE,"10/15/1995",1995,"October","1990s",75,81,12
"6523","199510150car","Carolina Panthers",26,"New York Jets",15,41,11,TRUE,"10/15/1995",1995,"October","1990s",60,41,10
"6524","199510150jax","Jacksonville Jaguars",27,"Chicago Bears",30,57,-3,FALSE,"10/15/1995",1995,"October","1990s",72,71,15
"6525","199510150nor","New Orleans Saints",33,"Miami Dolphins",30,63,3,TRUE,"10/15/1995",1995,"October","1990s",72,NA,NA
"6526","199510150sdg","San Diego Chargers",9,"Dallas Cowboys",23,32,-14,FALSE,"10/15/1995",1995,"October","1990s",67,83,9
"6527","199510150crd","Arizona Cardinals",24,"Washington Redskins",20,44,4,TRUE,"10/15/1995",1995,"October","1990s",84,23,6
"6528","199510150kan","Kansas City Chiefs",31,"New England Patriots",26,57,5,TRUE,"10/15/1995",1995,"October","1990s",56,47,7
"6529","199510150nyg","New York Giants",14,"Philadelphia Eagles",17,31,-3,FALSE,"10/15/1995",1995,"October","1990s",61,62,20
"6530","199510160den","Denver Broncos",27,"Oakland Raiders",0,27,27,TRUE,"10/16/1995",1995,"October","1990s",61,20,10
"6531","199510190pit","Pittsburgh Steelers",9,"Cincinnati Bengals",27,36,-18,FALSE,"10/19/1995",1995,"October","1990s",62,65,7
"6532","199510220rai","Oakland Raiders",30,"Indianapolis Colts",17,47,13,TRUE,"10/22/1995",1995,"October","1990s",62,41,11
"6533","199510220was","Washington Redskins",36,"Detroit Lions",30,66,6,TRUE,"10/22/1995",1995,"October","1990s",52,69,8
"6534","199510220chi","Chicago Bears",35,"Houston Oilers",32,67,3,TRUE,"10/22/1995",1995,"October","1990s",44,72,11
"6535","199510220car","Carolina Panthers",20,"New Orleans Saints",3,23,17,TRUE,"10/22/1995",1995,"October","1990s",58,48,7
"6536","199510220nyj","New York Jets",17,"Miami Dolphins",16,33,1,TRUE,"10/22/1995",1995,"October","1990s",55,62,16
"6537","199510220tam","Tampa Bay Buccaneers",21,"Atlanta Falcons",24,45,-3,FALSE,"10/22/1995",1995,"October","1990s",66,66,9
"6538","199510220cle","Cleveland Browns",15,"Jacksonville Jaguars",23,38,-8,FALSE,"10/22/1995",1995,"October","1990s",49,61,18
"6539","199510220gnb","Green Bay Packers",38,"Minnesota Vikings",21,59,17,TRUE,"10/22/1995",1995,"October","1990s",39,77,12
"6540","199510220ram","St. Louis Rams",10,"San Francisco 49ers",44,54,-34,FALSE,"10/22/1995",1995,"October","1990s",54,48,13
"6541","199510220sea","Seattle Seahawks",25,"San Diego Chargers",35,60,-10,FALSE,"10/22/1995",1995,"October","1990s",72,NA,NA
"6542","199510220den","Denver Broncos",7,"Kansas City Chiefs",21,28,-14,FALSE,"10/22/1995",1995,"October","1990s",44,41,15
"6543","199510230nwe","New England Patriots",27,"Buffalo Bills",14,41,13,TRUE,"10/23/1995",1995,"October","1990s",58,52,12
"6544","199510290cin","Cincinnati Bengals",26,"Cleveland Browns",29,55,-3,FALSE,"10/29/1995",1995,"October","1990s",48,72,14
"6545","199510290atl","Atlanta Falcons",13,"Dallas Cowboys",28,41,-15,FALSE,"10/29/1995",1995,"October","1990s",72,NA,NA
"6546","199510290sfo","San Francisco 49ers",7,"New Orleans Saints",11,18,-4,FALSE,"10/29/1995",1995,"October","1990s",56,89,9
"6547","199510290mia","Miami Dolphins",23,"Buffalo Bills",6,29,17,TRUE,"10/29/1995",1995,"October","1990s",80,70,9
"6548","199510290crd","Arizona Cardinals",20,"Seattle Seahawks",14,34,6,TRUE,"10/29/1995",1995,"October","1990s",72,25,5
"6549","199510290phi","Philadelphia Eagles",20,"St. Louis Rams",9,29,11,TRUE,"10/29/1995",1995,"October","1990s",53,72,18
"6550","199510290was","Washington Redskins",15,"New York Giants",24,39,-9,FALSE,"10/29/1995",1995,"October","1990s",52,64,12
"6551","199510290clt","Indianapolis Colts",17,"New York Jets",10,27,7,TRUE,"10/29/1995",1995,"October","1990s",72,NA,NA
"6552","199510290nwe","New England Patriots",17,"Carolina Panthers",20,37,-3,FALSE,"10/29/1995",1995,"October","1990s",54,66,18
"6553","199510290det","Detroit Lions",24,"Green Bay Packers",16,40,8,TRUE,"10/29/1995",1995,"October","1990s",72,NA,NA
"6554","199510290oti","Houston Oilers",19,"Tampa Bay Buccaneers",7,26,12,TRUE,"10/29/1995",1995,"October","1990s",72,NA,NA
"6555","199510290pit","Pittsburgh Steelers",24,"Jacksonville Jaguars",7,31,17,TRUE,"10/29/1995",1995,"October","1990s",46,72,17
"6556","199510300min","Minnesota Vikings",6,"Chicago Bears",14,20,-8,FALSE,"10/30/1995",1995,"October","1990s",72,NA,NA
"6557","199511050kan","Kansas City Chiefs",24,"Washington Redskins",3,27,21,TRUE,"11/5/1995",1995,"November","1990s",41,54,15
"6558","199511050atl","Atlanta Falcons",34,"Detroit Lions",22,56,12,TRUE,"11/5/1995",1995,"November","1990s",72,NA,NA
"6559","199511050nor","New Orleans Saints",19,"St. Louis Rams",10,29,9,TRUE,"11/5/1995",1995,"November","1990s",72,NA,NA
"6560","199511050nyj","New York Jets",7,"New England Patriots",20,27,-13,FALSE,"11/5/1995",1995,"November","1990s",41,48,15
"6561","199511050min","Minnesota Vikings",27,"Green Bay Packers",24,51,3,TRUE,"11/5/1995",1995,"November","1990s",72,NA,NA
"6562","199511050sea","Seattle Seahawks",30,"New York Giants",28,58,2,TRUE,"11/5/1995",1995,"November","1990s",72,NA,NA
"6563","199511050sdg","San Diego Chargers",14,"Miami Dolphins",24,38,-10,FALSE,"11/5/1995",1995,"November","1990s",61,88,7
"6564","199511050clt","Indianapolis Colts",10,"Buffalo Bills",16,26,-6,FALSE,"11/5/1995",1995,"November","1990s",72,NA,NA
"6565","199511050sfo","San Francisco 49ers",7,"Carolina Panthers",13,20,-6,FALSE,"11/5/1995",1995,"November","1990s",55,77,12
"6566","199511050cin","Cincinnati Bengals",17,"Oakland Raiders",20,37,-3,FALSE,"11/5/1995",1995,"November","1990s",25,72,4
"6567","199511050chi","Chicago Bears",34,"Pittsburgh Steelers",37,71,-3,FALSE,"11/5/1995",1995,"November","1990s",28,69,12
"6568","199511050den","Denver Broncos",38,"Arizona Cardinals",6,44,32,TRUE,"11/5/1995",1995,"November","1990s",44,26,16
"6569","199511050cle","Cleveland Browns",10,"Houston Oilers",37,47,-27,FALSE,"11/5/1995",1995,"November","1990s",30,62,12
"6570","199511060dal","Dallas Cowboys",34,"Philadelphia Eagles",12,46,22,TRUE,"11/6/1995",1995,"November","1990s",54,90,14
"6571","199511120sdg","San Diego Chargers",7,"Kansas City Chiefs",22,29,-15,FALSE,"11/12/1995",1995,"November","1990s",63,86,6
"6572","199511120mia","Miami Dolphins",17,"New England Patriots",34,51,-17,FALSE,"11/12/1995",1995,"November","1990s",75,82,7
"6573","199511120buf","Buffalo Bills",23,"Atlanta Falcons",17,40,6,TRUE,"11/12/1995",1995,"November","1990s",32,74,26
"6574","199511120oti","Houston Oilers",25,"Cincinnati Bengals",32,57,-7,FALSE,"11/12/1995",1995,"November","1990s",72,NA,NA
"6575","199511120gnb","Green Bay Packers",35,"Chicago Bears",28,63,7,TRUE,"11/12/1995",1995,"November","1990s",21,60,8
"6576","199511120det","Detroit Lions",27,"Tampa Bay Buccaneers",24,51,3,TRUE,"11/12/1995",1995,"November","1990s",72,NA,NA
"6577","199511120nor","New Orleans Saints",17,"Indianapolis Colts",14,31,3,TRUE,"11/12/1995",1995,"November","1990s",72,NA,NA
"6578","199511120ram","St. Louis Rams",28,"Carolina Panthers",17,45,11,TRUE,"11/12/1995",1995,"November","1990s",72,NA,NA
"6579","199511120nyg","New York Giants",13,"Oakland Raiders",17,30,-4,FALSE,"11/12/1995",1995,"November","1990s",47,64,26
"6580","199511120crd","Arizona Cardinals",24,"Minnesota Vikings",30,54,-6,FALSE,"11/12/1995",1995,"November","1990s",66,49,4
"6581","199511120dal","Dallas Cowboys",20,"San Francisco 49ers",38,58,-18,FALSE,"11/12/1995",1995,"November","1990s",48,39,14
"6582","199511120phi","Philadelphia Eagles",31,"Denver Broncos",13,44,18,TRUE,"11/12/1995",1995,"November","1990s",43,75,24
"6583","199511120jax","Jacksonville Jaguars",30,"Seattle Seahawks",47,77,-17,FALSE,"11/12/1995",1995,"November","1990s",51,56,16
"6584","199511130pit","Pittsburgh Steelers",20,"Cleveland Browns",3,23,17,TRUE,"11/13/1995",1995,"November","1990s",30,84,10
"6585","199511190kan","Kansas City Chiefs",20,"Houston Oilers",13,33,7,TRUE,"11/19/1995",1995,"November","1990s",53,48,15
"6586","199511190phi","Philadelphia Eagles",28,"New York Giants",19,47,9,TRUE,"11/19/1995",1995,"November","1990s",44,84,9
"6587","199511190chi","Chicago Bears",17,"Detroit Lions",24,41,-7,FALSE,"11/19/1995",1995,"November","1990s",37,79,12
"6588","199511190cle","Cleveland Browns",20,"Green Bay Packers",31,51,-11,FALSE,"11/19/1995",1995,"November","1990s",38,86,8
"6589","199511190nyj","New York Jets",26,"Buffalo Bills",28,54,-2,FALSE,"11/19/1995",1995,"November","1990s",46,80,6
"6590","199511190cin","Cincinnati Bengals",31,"Pittsburgh Steelers",49,80,-18,FALSE,"11/19/1995",1995,"November","1990s",40,72,6
"6591","199511190nwe","New England Patriots",10,"Indianapolis Colts",24,34,-14,FALSE,"11/19/1995",1995,"November","1990s",43,86,14
"6592","199511190tam","Tampa Bay Buccaneers",17,"Jacksonville Jaguars",16,33,1,TRUE,"11/19/1995",1995,"November","1990s",66,65,6
"6593","199511190den","Denver Broncos",30,"San Diego Chargers",27,57,3,TRUE,"11/19/1995",1995,"November","1990s",48,33,10
"6594","199511190min","Minnesota Vikings",43,"New Orleans Saints",24,67,19,TRUE,"11/19/1995",1995,"November","1990s",72,NA,NA
"6595","199511190was","Washington Redskins",20,"Seattle Seahawks",27,47,-7,FALSE,"11/19/1995",1995,"November","1990s",44,74,12
"6596","199511190car","Carolina Panthers",27,"Arizona Cardinals",7,34,20,TRUE,"11/19/1995",1995,"November","1990s",55,55,6
"6597","199511190rai","Oakland Raiders",21,"Dallas Cowboys",34,55,-13,FALSE,"11/19/1995",1995,"November","1990s",59,92,4
"6598","199511190atl","Atlanta Falcons",31,"St. Louis Rams",6,37,25,TRUE,"11/19/1995",1995,"November","1990s",72,NA,NA
"6599","199511200mia","Miami Dolphins",20,"San Francisco 49ers",44,64,-24,FALSE,"11/20/1995",1995,"November","1990s",72,70,8
"6600","199511230dal","Dallas Cowboys",24,"Kansas City Chiefs",12,36,12,TRUE,"11/23/1995",1995,"November","1990s",59,54,19
"6601","199511230det","Detroit Lions",44,"Minnesota Vikings",38,82,6,TRUE,"11/23/1995",1995,"November","1990s",72,NA,NA
"6602","199511260cle","Cleveland Browns",17,"Pittsburgh Steelers",20,37,-3,FALSE,"11/26/1995",1995,"November","1990s",38,73,12
"6603","199511260nyg","New York Giants",24,"Chicago Bears",27,51,-3,FALSE,"11/26/1995",1995,"November","1990s",40,53,10
"6604","199511260crd","Arizona Cardinals",40,"Atlanta Falcons",37,77,3,TRUE,"11/26/1995",1995,"November","1990s",67,38,6
"6605","199511260nor","New Orleans Saints",34,"Carolina Panthers",26,60,8,TRUE,"11/26/1995",1995,"November","1990s",72,NA,NA
"6606","199511260oti","Houston Oilers",42,"Denver Broncos",33,75,9,TRUE,"11/26/1995",1995,"November","1990s",72,NA,NA
"6607","199511260sfo","San Francisco 49ers",41,"St. Louis Rams",13,54,28,TRUE,"11/26/1995",1995,"November","1990s",56,78,14
"6608","199511260gnb","Green Bay Packers",35,"Tampa Bay Buccaneers",13,48,22,TRUE,"11/26/1995",1995,"November","1990s",31,84,8
"6609","199511260buf","Buffalo Bills",25,"New England Patriots",35,60,-10,FALSE,"11/26/1995",1995,"November","1990s",36,71,8
"6610","199511260jax","Jacksonville Jaguars",13,"Cincinnati Bengals",17,30,-4,FALSE,"11/26/1995",1995,"November","1990s",54,63,9
"6611","199511260clt","Indianapolis Colts",36,"Miami Dolphins",28,64,8,TRUE,"11/26/1995",1995,"November","1990s",72,NA,NA
"6612","199511260sea","Seattle Seahawks",10,"New York Jets",16,26,-6,FALSE,"11/26/1995",1995,"November","1990s",72,NA,NA
"6613","199511260was","Washington Redskins",7,"Philadelphia Eagles",14,21,-7,FALSE,"11/26/1995",1995,"November","1990s",38,69,9
"6614","199511270sdg","San Diego Chargers",12,"Oakland Raiders",6,18,6,TRUE,"11/27/1995",1995,"November","1990s",61,74,6
"6615","199511300crd","Arizona Cardinals",6,"New York Giants",10,16,-4,FALSE,"11/30/1995",1995,"November","1990s",60,39,4
"6616","199512030sdg","San Diego Chargers",31,"Cleveland Browns",13,44,18,TRUE,"12/3/1995",1995,"December","1990s",60,80,7
"6617","199512030nyj","New York Jets",20,"St. Louis Rams",23,43,-3,FALSE,"12/3/1995",1995,"December","1990s",41,42,13
"6618","199512030sfo","San Francisco 49ers",27,"Buffalo Bills",17,44,10,TRUE,"12/3/1995",1995,"December","1990s",52,76,7
"6619","199512030den","Denver Broncos",31,"Jacksonville Jaguars",23,54,8,TRUE,"12/3/1995",1995,"December","1990s",41,50,11
"6620","199512030min","Minnesota Vikings",31,"Tampa Bay Buccaneers",17,48,14,TRUE,"12/3/1995",1995,"December","1990s",72,NA,NA
"6621","199512030nwe","New England Patriots",17,"New Orleans Saints",31,48,-14,FALSE,"12/3/1995",1995,"December","1990s",32,47,12
"6622","199512030dal","Dallas Cowboys",17,"Washington Redskins",24,41,-7,FALSE,"12/3/1995",1995,"December","1990s",63,70,14
"6623","199512030rai","Oakland Raiders",23,"Kansas City Chiefs",29,52,-6,FALSE,"12/3/1995",1995,"December","1990s",51,77,5
"6624","199512030gnb","Green Bay Packers",24,"Cincinnati Bengals",10,34,14,TRUE,"12/3/1995",1995,"December","1990s",34,81,7
"6625","199512030pit","Pittsburgh Steelers",21,"Houston Oilers",7,28,14,TRUE,"12/3/1995",1995,"December","1990s",44,60,12
"6626","199512030sea","Seattle Seahawks",26,"Philadelphia Eagles",14,40,12,TRUE,"12/3/1995",1995,"December","1990s",72,NA,NA
"6627","199512030car","Carolina Panthers",13,"Indianapolis Colts",10,23,3,TRUE,"12/3/1995",1995,"December","1990s",54,57,6
"6628","199512030mia","Miami Dolphins",21,"Atlanta Falcons",20,41,1,TRUE,"12/3/1995",1995,"December","1990s",71,79,4
"6629","199512040det","Detroit Lions",27,"Chicago Bears",7,34,20,TRUE,"12/4/1995",1995,"December","1990s",72,NA,NA
"6630","199512090sdg","San Diego Chargers",28,"Arizona Cardinals",25,53,3,TRUE,"12/9/1995",1995,"December","1990s",60,85,7
"6631","199512090min","Minnesota Vikings",27,"Cleveland Browns",11,38,16,TRUE,"12/9/1995",1995,"December","1990s",72,NA,NA
"6632","199512100atl","Atlanta Falcons",19,"New Orleans Saints",14,33,5,TRUE,"12/10/1995",1995,"December","1990s",72,NA,NA
"6633","199512100rai","Oakland Raiders",10,"Pittsburgh Steelers",29,39,-19,FALSE,"12/10/1995",1995,"December","1990s",52,91,10
"6634","199512100den","Denver Broncos",27,"Seattle Seahawks",31,58,-4,FALSE,"12/10/1995",1995,"December","1990s",36,42,14
"6635","199512100cin","Cincinnati Bengals",16,"Chicago Bears",10,26,6,TRUE,"12/10/1995",1995,"December","1990s",8,58,15
"6636","199512100car","Carolina Panthers",10,"San Francisco 49ers",31,41,-21,FALSE,"12/10/1995",1995,"December","1990s",33,34,11
"6637","199512100nyg","New York Giants",20,"Washington Redskins",13,33,7,TRUE,"12/10/1995",1995,"December","1990s",26,59,20
"6638","199512100nwe","New England Patriots",31,"New York Jets",28,59,3,TRUE,"12/10/1995",1995,"December","1990s",31,61,21
"6639","199512100tam","Tampa Bay Buccaneers",13,"Green Bay Packers",10,23,3,TRUE,"12/10/1995",1995,"December","1990s",60,58,12
"6640","199512100oti","Houston Oilers",17,"Detroit Lions",24,41,-7,FALSE,"12/10/1995",1995,"December","1990s",72,NA,NA
"6641","199512100jax","Jacksonville Jaguars",31,"Indianapolis Colts",41,72,-10,FALSE,"12/10/1995",1995,"December","1990s",48,56,17
"6642","199512100phi","Philadelphia Eagles",20,"Dallas Cowboys",17,37,3,TRUE,"12/10/1995",1995,"December","1990s",23,55,18
"6643","199512100ram","St. Louis Rams",27,"Buffalo Bills",45,72,-18,FALSE,"12/10/1995",1995,"December","1990s",72,NA,NA
"6644","199512110mia","Miami Dolphins",13,"Kansas City Chiefs",6,19,7,TRUE,"12/11/1995",1995,"December","1990s",62,68,15
"6645","199512160nor","New Orleans Saints",23,"Green Bay Packers",34,57,-11,FALSE,"12/16/1995",1995,"December","1990s",72,NA,NA
"6646","199512160pit","Pittsburgh Steelers",41,"New England Patriots",27,68,14,TRUE,"12/16/1995",1995,"December","1990s",38,76,10
"6647","199512170sea","Seattle Seahawks",44,"Oakland Raiders",10,54,34,TRUE,"12/17/1995",1995,"December","1990s",72,NA,NA
"6648","199512170ram","St. Louis Rams",23,"Washington Redskins",35,58,-12,FALSE,"12/17/1995",1995,"December","1990s",72,NA,NA
"6649","199512170dal","Dallas Cowboys",21,"New York Giants",20,41,1,TRUE,"12/17/1995",1995,"December","1990s",52,98,11
"6650","199512170kan","Kansas City Chiefs",20,"Denver Broncos",17,37,3,TRUE,"12/17/1995",1995,"December","1990s",39,82,14
"6651","199512170phi","Philadelphia Eagles",21,"Arizona Cardinals",20,41,1,TRUE,"12/17/1995",1995,"December","1990s",36,68,12
"6652","199512170buf","Buffalo Bills",23,"Miami Dolphins",20,43,3,TRUE,"12/17/1995",1995,"December","1990s",27,79,8
"6653","199512170oti","Houston Oilers",23,"New York Jets",6,29,17,TRUE,"12/17/1995",1995,"December","1990s",72,NA,NA
"6654","199512170det","Detroit Lions",44,"Jacksonville Jaguars",0,44,44,TRUE,"12/17/1995",1995,"December","1990s",72,NA,NA
"6655","199512170clt","Indianapolis Colts",24,"San Diego Chargers",27,51,-3,FALSE,"12/17/1995",1995,"December","1990s",72,NA,NA
"6656","199512170car","Carolina Panthers",21,"Atlanta Falcons",17,38,4,TRUE,"12/17/1995",1995,"December","1990s",50,54,6
"6657","199512170chi","Chicago Bears",31,"Tampa Bay Buccaneers",10,41,21,TRUE,"12/17/1995",1995,"December","1990s",29,76,8
"6658","199512170cle","Cleveland Browns",26,"Cincinnati Bengals",10,36,16,TRUE,"12/17/1995",1995,"December","1990s",28,77,8
"6659","199512180sfo","San Francisco 49ers",37,"Minnesota Vikings",30,67,7,TRUE,"12/18/1995",1995,"December","1990s",50,76,8
"6660","199512230clt","Indianapolis Colts",10,"New England Patriots",7,17,3,TRUE,"12/23/1995",1995,"December","1990s",72,NA,NA
"6661","199512230tam","Tampa Bay Buccaneers",10,"Detroit Lions",37,47,-27,FALSE,"12/23/1995",1995,"December","1990s",48,65,11
"6662","199512230nyg","New York Giants",17,"San Diego Chargers",27,44,-10,FALSE,"12/23/1995",1995,"December","1990s",34,64,15
"6663","199512240buf","Buffalo Bills",17,"Houston Oilers",28,45,-11,FALSE,"12/24/1995",1995,"December","1990s",25,89,8
"6664","199512240chi","Chicago Bears",20,"Philadelphia Eagles",14,34,6,TRUE,"12/24/1995",1995,"December","1990s",26,76,14
"6665","199512240cin","Cincinnati Bengals",27,"Minnesota Vikings",24,51,3,TRUE,"12/24/1995",1995,"December","1990s",23,79,9
"6666","199512240jax","Jacksonville Jaguars",24,"Cleveland Browns",21,45,3,TRUE,"12/24/1995",1995,"December","1990s",41,48,11
"6667","199512240nyj","New York Jets",0,"New Orleans Saints",12,12,-12,FALSE,"12/24/1995",1995,"December","1990s",34,57,18
"6668","199512240was","Washington Redskins",20,"Carolina Panthers",17,37,3,TRUE,"12/24/1995",1995,"December","1990s",33,57,13
"6669","199512240kan","Kansas City Chiefs",26,"Seattle Seahawks",3,29,23,TRUE,"12/24/1995",1995,"December","1990s",25,79,10
"6670","199512240gnb","Green Bay Packers",24,"Pittsburgh Steelers",19,43,5,TRUE,"12/24/1995",1995,"December","1990s",22,84,10
"6671","199512240rai","Oakland Raiders",28,"Denver Broncos",31,59,-3,FALSE,"12/24/1995",1995,"December","1990s",49,75,10
"6672","199512240atl","Atlanta Falcons",28,"San Francisco 49ers",27,55,1,TRUE,"12/24/1995",1995,"December","1990s",72,NA,NA
"6673","199512240ram","St. Louis Rams",22,"Miami Dolphins",41,63,-19,FALSE,"12/24/1995",1995,"December","1990s",72,NA,NA
"6674","199512250crd","Arizona Cardinals",13,"Dallas Cowboys",37,50,-24,FALSE,"12/25/1995",1995,"December","1990s",56,37,10
"6675","199512300buf","Buffalo Bills",37,"Miami Dolphins",22,59,15,TRUE,"12/30/1995",1995,"December","1990s",26,77,14
"6676","199512300phi","Philadelphia Eagles",58,"Detroit Lions",37,95,21,TRUE,"12/30/1995",1995,"December","1990s",30,64,7
"6677","199512310sdg","San Diego Chargers",20,"Indianapolis Colts",35,55,-15,FALSE,"12/31/1995",1995,"December","1990s",57,90,5
"6678","199512310gnb","Green Bay Packers",37,"Atlanta Falcons",20,57,17,TRUE,"12/31/1995",1995,"December","1990s",30,92,4
"6679","199601060sfo","San Francisco 49ers",17,"Green Bay Packers",27,44,-10,FALSE,"1/6/1996",1996,"January","1990s",52,85,5
"6680","199601060pit","Pittsburgh Steelers",40,"Buffalo Bills",21,61,19,TRUE,"1/6/1996",1996,"January","1990s",15,65,9
"6681","199601070dal","Dallas Cowboys",30,"Philadelphia Eagles",11,41,19,TRUE,"1/7/1996",1996,"January","1990s",24,66,14
"6682","199601070kan","Kansas City Chiefs",7,"Indianapolis Colts",10,17,-3,FALSE,"1/7/1996",1996,"January","1990s",0,58,8
"6683","199601140dal","Dallas Cowboys",38,"Green Bay Packers",27,65,11,TRUE,"1/14/1996",1996,"January","1990s",58,38,15
"6684","199601140pit","Pittsburgh Steelers",20,"Indianapolis Colts",16,36,4,TRUE,"1/14/1996",1996,"January","1990s",36,77,13
"6685","199601280dal","Dallas Cowboys",27,"Pittsburgh Steelers",17,44,10,TRUE,"1/28/1996",1996,"January","1990s",54,40,5
"6686","199609010car","Carolina Panthers",29,"Atlanta Falcons",6,35,23,TRUE,"9/1/1996",1996,"September","1990s",72,65,6
"6687","199609010den","Denver Broncos",31,"New York Jets",6,37,25,TRUE,"9/1/1996",1996,"September","1990s",74,30,14
"6688","199609010nyg","New York Giants",20,"Buffalo Bills",23,43,-3,FALSE,"9/1/1996",1996,"September","1990s",72,72,9
"6689","199609010min","Minnesota Vikings",17,"Detroit Lions",13,30,4,TRUE,"9/1/1996",1996,"September","1990s",72,NA,NA
"6690","199609010mia","Miami Dolphins",24,"New England Patriots",10,34,14,TRUE,"9/1/1996",1996,"September","1990s",85,69,7
"6691","199609010ram","St. Louis Rams",26,"Cincinnati Bengals",16,42,10,TRUE,"9/1/1996",1996,"September","1990s",72,NA,NA
"6692","199609010was","Washington Redskins",14,"Philadelphia Eagles",17,31,-3,FALSE,"9/1/1996",1996,"September","1990s",76,65,9
"6693","199609010jax","Jacksonville Jaguars",24,"Pittsburgh Steelers",9,33,15,TRUE,"9/1/1996",1996,"September","1990s",78,86,8
"6694","199609010sfo","San Francisco 49ers",27,"New Orleans Saints",11,38,16,TRUE,"9/1/1996",1996,"September","1990s",61,79,12
"6695","199609010rav","Baltimore Ravens",19,"Oakland Raiders",14,33,5,TRUE,"9/1/1996",1996,"September","1990s",71,70,5
"6696","199609010tam","Tampa Bay Buccaneers",3,"Green Bay Packers",34,37,-31,FALSE,"9/1/1996",1996,"September","1990s",81,82,6
"6697","199609010oti","Houston Oilers",19,"Kansas City Chiefs",20,39,-1,FALSE,"9/1/1996",1996,"September","1990s",72,NA,NA
"6698","199609010clt","Indianapolis Colts",20,"Arizona Cardinals",13,33,7,TRUE,"9/1/1996",1996,"September","1990s",72,NA,NA
"6699","199609010sdg","San Diego Chargers",29,"Seattle Seahawks",7,36,22,TRUE,"9/1/1996",1996,"September","1990s",74,80,7
"6700","199609020chi","Chicago Bears",22,"Dallas Cowboys",6,28,16,TRUE,"9/2/1996",1996,"September","1990s",72,69,7
"6701","199609080sea","Seattle Seahawks",20,"Denver Broncos",30,50,-10,FALSE,"9/8/1996",1996,"September","1990s",72,NA,NA
"6702","199609080sfo","San Francisco 49ers",34,"St. Louis Rams",0,34,34,TRUE,"9/8/1996",1996,"September","1990s",67,55,13
"6703","199609080was","Washington Redskins",10,"Chicago Bears",3,13,7,TRUE,"9/8/1996",1996,"September","1990s",77,80,9
"6704","199609080crd","Arizona Cardinals",10,"Miami Dolphins",38,48,-28,FALSE,"9/8/1996",1996,"September","1990s",90,39,6
"6705","199609080kan","Kansas City Chiefs",19,"Oakland Raiders",3,22,16,TRUE,"9/8/1996",1996,"September","1990s",72,86,8
"6706","199609080jax","Jacksonville Jaguars",27,"Houston Oilers",34,61,-7,FALSE,"9/8/1996",1996,"September","1990s",82,74,8
"6707","199609080pit","Pittsburgh Steelers",31,"Baltimore Ravens",17,48,14,TRUE,"9/8/1996",1996,"September","1990s",71,78,8
"6708","199609080nyj","New York Jets",7,"Indianapolis Colts",21,28,-14,FALSE,"9/8/1996",1996,"September","1990s",74,91,12
"6709","199609080atl","Atlanta Falcons",17,"Minnesota Vikings",23,40,-6,FALSE,"9/8/1996",1996,"September","1990s",72,NA,NA
"6710","199609080dal","Dallas Cowboys",27,"New York Giants",0,27,27,TRUE,"9/8/1996",1996,"September","1990s",81,67,9
"6711","199609080det","Detroit Lions",21,"Tampa Bay Buccaneers",6,27,15,TRUE,"9/8/1996",1996,"September","1990s",72,NA,NA
"6712","199609080nor","New Orleans Saints",20,"Carolina Panthers",22,42,-2,FALSE,"9/8/1996",1996,"September","1990s",72,NA,NA
"6713","199609080sdg","San Diego Chargers",27,"Cincinnati Bengals",14,41,13,TRUE,"9/8/1996",1996,"September","1990s",74,76,9
"6714","199609080buf","Buffalo Bills",17,"New England Patriots",10,27,7,TRUE,"9/8/1996",1996,"September","1990s",67,91,17
"6715","199609090gnb","Green Bay Packers",39,"Philadelphia Eagles",13,52,26,TRUE,"9/9/1996",1996,"September","1990s",65,88,8
"6716","199609150nwe","New England Patriots",31,"Arizona Cardinals",0,31,31,TRUE,"9/15/1996",1996,"September","1990s",64,68,11
"6717","199609150rai","Oakland Raiders",17,"Jacksonville Jaguars",3,20,14,TRUE,"9/15/1996",1996,"September","1990s",64,87,12
"6718","199609150dal","Dallas Cowboys",24,"Indianapolis Colts",25,49,-1,FALSE,"9/15/1996",1996,"September","1990s",78,76,15
"6719","199609150nyg","New York Giants",10,"Washington Redskins",31,41,-21,FALSE,"9/15/1996",1996,"September","1990s",68,53,10
"6720","199609150phi","Philadelphia Eagles",24,"Detroit Lions",17,41,7,TRUE,"9/15/1996",1996,"September","1990s",65,63,9
"6721","199609150cin","Cincinnati Bengals",30,"New Orleans Saints",15,45,15,TRUE,"9/15/1996",1996,"September","1990s",57,65,6
"6722","199609150mia","Miami Dolphins",36,"New York Jets",27,63,9,TRUE,"9/15/1996",1996,"September","1990s",83,68,8
"6723","199609150gnb","Green Bay Packers",42,"San Diego Chargers",10,52,32,TRUE,"9/15/1996",1996,"September","1990s",55,80,9
"6724","199609150oti","Houston Oilers",29,"Baltimore Ravens",13,42,16,TRUE,"9/15/1996",1996,"September","1990s",72,NA,NA
"6725","199609150sea","Seattle Seahawks",17,"Kansas City Chiefs",35,52,-18,FALSE,"9/15/1996",1996,"September","1990s",72,NA,NA
"6726","199609150den","Denver Broncos",27,"Tampa Bay Buccaneers",23,50,4,TRUE,"9/15/1996",1996,"September","1990s",59,72,9
"6727","199609150chi","Chicago Bears",14,"Minnesota Vikings",20,34,-6,FALSE,"9/15/1996",1996,"September","1990s",60,74,7
"6728","199609160pit","Pittsburgh Steelers",24,"Buffalo Bills",6,30,18,TRUE,"9/16/1996",1996,"September","1990s",57,91,6
"6729","199609220car","Carolina Panthers",23,"San Francisco 49ers",7,30,16,TRUE,"9/22/1996",1996,"September","1990s",69,67,8
"6730","199609220atl","Atlanta Falcons",18,"Philadelphia Eagles",33,51,-15,FALSE,"9/22/1996",1996,"September","1990s",72,NA,NA
"6731","199609220ram","St. Louis Rams",10,"Washington Redskins",17,27,-7,FALSE,"9/22/1996",1996,"September","1990s",72,NA,NA
"6732","199609220nwe","New England Patriots",28,"Jacksonville Jaguars",25,53,3,TRUE,"9/22/1996",1996,"September","1990s",63,81,10
"6733","199609220min","Minnesota Vikings",30,"Green Bay Packers",21,51,9,TRUE,"9/22/1996",1996,"September","1990s",72,NA,NA
"6734","199609220tam","Tampa Bay Buccaneers",13,"Seattle Seahawks",17,30,-4,FALSE,"9/22/1996",1996,"September","1990s",78,89,11
"6735","199609220nor","New Orleans Saints",14,"Arizona Cardinals",28,42,-14,FALSE,"9/22/1996",1996,"September","1990s",72,NA,NA
"6736","199609220rai","Oakland Raiders",34,"San Diego Chargers",40,74,-6,FALSE,"9/22/1996",1996,"September","1990s",62,74,11
"6737","199609220nyj","New York Jets",6,"New York Giants",13,19,-7,FALSE,"9/22/1996",1996,"September","1990s",66,85,11
"6738","199609220det","Detroit Lions",35,"Chicago Bears",16,51,19,TRUE,"9/22/1996",1996,"September","1990s",72,NA,NA
"6739","199609220buf","Buffalo Bills",10,"Dallas Cowboys",7,17,3,TRUE,"9/22/1996",1996,"September","1990s",60,82,12
"6740","199609220kan","Kansas City Chiefs",17,"Denver Broncos",14,31,3,TRUE,"9/22/1996",1996,"September","1990s",67,67,8
"6741","199609230clt","Indianapolis Colts",10,"Miami Dolphins",6,16,4,TRUE,"9/23/1996",1996,"September","1990s",72,NA,NA
"6742","199609290cin","Cincinnati Bengals",10,"Denver Broncos",14,24,-4,FALSE,"9/29/1996",1996,"September","1990s",55,73,6
"6743","199609290sfo","San Francisco 49ers",39,"Atlanta Falcons",17,56,22,TRUE,"9/29/1996",1996,"September","1990s",56,88,16
"6744","199609290jax","Jacksonville Jaguars",24,"Carolina Panthers",14,38,10,TRUE,"9/29/1996",1996,"September","1990s",81,75,8
"6745","199609290pit","Pittsburgh Steelers",30,"Houston Oilers",16,46,14,TRUE,"9/29/1996",1996,"September","1990s",53,81,8
"6746","199609290rav","Baltimore Ravens",17,"New Orleans Saints",10,27,7,TRUE,"9/29/1996",1996,"September","1990s",60,81,6
"6747","199609290tam","Tampa Bay Buccaneers",0,"Detroit Lions",27,27,-27,FALSE,"9/29/1996",1996,"September","1990s",81,79,9
"6748","199609290nyg","New York Giants",15,"Minnesota Vikings",10,25,5,TRUE,"9/29/1996",1996,"September","1990s",64,77,14
"6749","199609290chi","Chicago Bears",19,"Oakland Raiders",17,36,2,TRUE,"9/29/1996",1996,"September","1990s",56,74,8
"6750","199609290crd","Arizona Cardinals",31,"St. Louis Rams",28,59,3,TRUE,"9/29/1996",1996,"September","1990s",83,19,4
"6751","199609290sea","Seattle Seahawks",10,"Green Bay Packers",31,41,-21,FALSE,"9/29/1996",1996,"September","1990s",72,NA,NA
"6752","199609290was","Washington Redskins",31,"New York Jets",16,47,15,TRUE,"9/29/1996",1996,"September","1990s",62,76,10
"6753","199609290sdg","San Diego Chargers",22,"Kansas City Chiefs",19,41,3,TRUE,"9/29/1996",1996,"September","1990s",66,86,8
"6754","199609300phi","Philadelphia Eagles",19,"Dallas Cowboys",23,42,-4,FALSE,"9/30/1996",1996,"September","1990s",62,67,8
"6755","199610060ram","St. Louis Rams",11,"San Francisco 49ers",28,39,-17,FALSE,"10/6/1996",1996,"October","1990s",72,NA,NA
"6756","199610060min","Minnesota Vikings",14,"Carolina Panthers",12,26,2,TRUE,"10/6/1996",1996,"October","1990s",72,NA,NA
"6757","199610060det","Detroit Lions",28,"Atlanta Falcons",24,52,4,TRUE,"10/6/1996",1996,"October","1990s",72,NA,NA
"6758","199610060mia","Miami Dolphins",15,"Seattle Seahawks",22,37,-7,FALSE,"10/6/1996",1996,"October","1990s",78,82,8
"6759","199610060rav","Baltimore Ravens",38,"New England Patriots",46,84,-8,FALSE,"10/6/1996",1996,"October","1990s",50,76,5
"6760","199610060cin","Cincinnati Bengals",27,"Houston Oilers",30,57,-3,FALSE,"10/6/1996",1996,"October","1990s",59,67,5
"6761","199610060buf","Buffalo Bills",16,"Indianapolis Colts",13,29,3,TRUE,"10/6/1996",1996,"October","1990s",52,60,8
"6762","199610060chi","Chicago Bears",6,"Green Bay Packers",37,43,-31,FALSE,"10/6/1996",1996,"October","1990s",61,77,11
"6763","199610060nor","New Orleans Saints",17,"Jacksonville Jaguars",13,30,4,TRUE,"10/6/1996",1996,"October","1990s",72,NA,NA
"6764","199610060den","Denver Broncos",28,"San Diego Chargers",17,45,11,TRUE,"10/6/1996",1996,"October","1990s",60,44,9
"6765","199610060nyj","New York Jets",13,"Oakland Raiders",34,47,-21,FALSE,"10/6/1996",1996,"October","1990s",53,65,10
"6766","199610070kan","Kansas City Chiefs",7,"Pittsburgh Steelers",17,24,-10,FALSE,"10/7/1996",1996,"October","1990s",59,91,10
"6767","199610130clt","Indianapolis Colts",26,"Baltimore Ravens",21,47,5,TRUE,"10/13/1996",1996,"October","1990s",72,NA,NA
"6768","199610130atl","Atlanta Falcons",13,"Houston Oilers",23,36,-10,FALSE,"10/13/1996",1996,"October","1990s",72,NA,NA
"6769","199610130buf","Buffalo Bills",7,"Miami Dolphins",21,28,-14,FALSE,"10/13/1996",1996,"October","1990s",59,64,16
"6770","199610130nwe","New England Patriots",22,"Washington Redskins",27,49,-5,FALSE,"10/13/1996",1996,"October","1990s",53,61,8
"6771","199610130car","Carolina Panthers",45,"St. Louis Rams",13,58,32,TRUE,"10/13/1996",1996,"October","1990s",56,63,3
"6772","199610130dal","Dallas Cowboys",17,"Arizona Cardinals",3,20,14,TRUE,"10/13/1996",1996,"October","1990s",71,56,13
"6773","199610130pit","Pittsburgh Steelers",20,"Cincinnati Bengals",10,30,10,TRUE,"10/13/1996",1996,"October","1990s",58,60,9
"6774","199610130nyg","New York Giants",10,"Philadelphia Eagles",19,29,-9,FALSE,"10/13/1996",1996,"October","1990s",57,68,9
"6775","199610130nor","New Orleans Saints",27,"Chicago Bears",24,51,3,TRUE,"10/13/1996",1996,"October","1990s",72,NA,NA
"6776","199610130tam","Tampa Bay Buccaneers",24,"Minnesota Vikings",13,37,11,TRUE,"10/13/1996",1996,"October","1990s",73,71,12
"6777","199610130rai","Oakland Raiders",37,"Detroit Lions",21,58,16,TRUE,"10/13/1996",1996,"October","1990s",62,83,9
"6778","199610130jax","Jacksonville Jaguars",21,"New York Jets",17,38,4,TRUE,"10/13/1996",1996,"October","1990s",72,68,15
"6779","199610140gnb","Green Bay Packers",23,"San Francisco 49ers",20,43,3,TRUE,"10/14/1996",1996,"October","1990s",47,77,12
"6780","199610170kan","Kansas City Chiefs",34,"Seattle Seahawks",16,50,18,TRUE,"10/17/1996",1996,"October","1990s",62,68,19
"6781","199610200oti","Houston Oilers",23,"Pittsburgh Steelers",13,36,10,TRUE,"10/20/1996",1996,"October","1990s",72,NA,NA
"6782","199610200dal","Dallas Cowboys",32,"Atlanta Falcons",28,60,4,TRUE,"10/20/1996",1996,"October","1990s",70,63,17
"6783","199610200phi","Philadelphia Eagles",35,"Miami Dolphins",28,63,7,TRUE,"10/20/1996",1996,"October","1990s",49,82,9
"6784","199610200was","Washington Redskins",31,"New York Giants",21,52,10,TRUE,"10/20/1996",1996,"October","1990s",50,83,11
"6785","199610200nyj","New York Jets",22,"Buffalo Bills",25,47,-3,FALSE,"10/20/1996",1996,"October","1990s",54,81,10
"6786","199610200den","Denver Broncos",45,"Baltimore Ravens",34,79,11,TRUE,"10/20/1996",1996,"October","1990s",41,57,14
"6787","199610200car","Carolina Panthers",19,"New Orleans Saints",7,26,12,TRUE,"10/20/1996",1996,"October","1990s",52,40,6
"6788","199610200sfo","San Francisco 49ers",28,"Cincinnati Bengals",21,49,7,TRUE,"10/20/1996",1996,"October","1990s",54,63,16
"6789","199610200crd","Arizona Cardinals",13,"Tampa Bay Buccaneers",9,22,4,TRUE,"10/20/1996",1996,"October","1990s",73,31,13
"6790","199610200clt","Indianapolis Colts",9,"New England Patriots",27,36,-18,FALSE,"10/20/1996",1996,"October","1990s",72,NA,NA
"6791","199610200ram","St. Louis Rams",17,"Jacksonville Jaguars",14,31,3,TRUE,"10/20/1996",1996,"October","1990s",72,NA,NA
"6792","199610210sdg","San Diego Chargers",14,"Oakland Raiders",23,37,-9,FALSE,"10/21/1996",1996,"October","1990s",66,54,7
"6793","199610270gnb","Green Bay Packers",13,"Tampa Bay Buccaneers",7,20,6,TRUE,"10/27/1996",1996,"October","1990s",57,79,18
"6794","199610270den","Denver Broncos",34,"Kansas City Chiefs",7,41,27,TRUE,"10/27/1996",1996,"October","1990s",33,76,11
"6795","199610270nwe","New England Patriots",28,"Buffalo Bills",25,53,3,TRUE,"10/27/1996",1996,"October","1990s",54,63,8
"6796","199610270det","Detroit Lions",7,"New York Giants",35,42,-28,FALSE,"10/27/1996",1996,"October","1990s",72,NA,NA
"6797","199610270mia","Miami Dolphins",10,"Dallas Cowboys",29,39,-19,FALSE,"10/27/1996",1996,"October","1990s",81,68,14
"6798","199610270crd","Arizona Cardinals",21,"New York Jets",31,52,-10,FALSE,"10/27/1996",1996,"October","1990s",52,60,9
"6799","199610270was","Washington Redskins",31,"Indianapolis Colts",16,47,15,TRUE,"10/27/1996",1996,"October","1990s",63,82,8
"6800","199610270cin","Cincinnati Bengals",28,"Jacksonville Jaguars",21,49,7,TRUE,"10/27/1996",1996,"October","1990s",64,94,6
"6801","199610270phi","Philadelphia Eagles",20,"Carolina Panthers",9,29,11,TRUE,"10/27/1996",1996,"October","1990s",59,83,6
"6802","199610270rav","Baltimore Ravens",37,"St. Louis Rams",31,68,6,TRUE,"10/27/1996",1996,"October","1990s",62,78,3
"6803","199610270oti","Houston Oilers",9,"San Francisco 49ers",10,19,-1,FALSE,"10/27/1996",1996,"October","1990s",72,NA,NA
"6804","199610270atl","Atlanta Falcons",17,"Pittsburgh Steelers",20,37,-3,FALSE,"10/27/1996",1996,"October","1990s",72,NA,NA
"6805","199610270sea","Seattle Seahawks",32,"San Diego Chargers",13,45,19,TRUE,"10/27/1996",1996,"October","1990s",72,NA,NA
"6806","199610280min","Minnesota Vikings",13,"Chicago Bears",15,28,-2,FALSE,"10/28/1996",1996,"October","1990s",72,NA,NA
"6807","199611030min","Minnesota Vikings",6,"Kansas City Chiefs",21,27,-15,FALSE,"11/3/1996",1996,"November","1990s",72,NA,NA
"6808","199611030pit","Pittsburgh Steelers",42,"St. Louis Rams",6,48,36,TRUE,"11/3/1996",1996,"November","1990s",34,63,10
"6809","199611030gnb","Green Bay Packers",28,"Detroit Lions",18,46,10,TRUE,"11/3/1996",1996,"November","1990s",33,59,11
"6810","199611030chi","Chicago Bears",13,"Tampa Bay Buccaneers",10,23,3,TRUE,"11/3/1996",1996,"November","1990s",32,75,10
"6811","199611030rav","Baltimore Ravens",21,"Cincinnati Bengals",24,45,-3,FALSE,"11/3/1996",1996,"November","1990s",38,55,10
"6812","199611030atl","Atlanta Falcons",20,"Carolina Panthers",17,37,3,TRUE,"11/3/1996",1996,"November","1990s",72,NA,NA
"6813","199611030nor","New Orleans Saints",17,"San Francisco 49ers",24,41,-7,FALSE,"11/3/1996",1996,"November","1990s",72,NA,NA
"6814","199611030nwe","New England Patriots",42,"Miami Dolphins",23,65,19,TRUE,"11/3/1996",1996,"November","1990s",39,43,19
"6815","199611030buf","Buffalo Bills",38,"Washington Redskins",13,51,25,TRUE,"11/3/1996",1996,"November","1990s",34,65,15
"6816","199611030clt","Indianapolis Colts",19,"San Diego Chargers",26,45,-7,FALSE,"11/3/1996",1996,"November","1990s",72,NA,NA
"6817","199611030nyg","New York Giants",16,"Arizona Cardinals",8,24,8,TRUE,"11/3/1996",1996,"November","1990s",42,46,16
"6818","199611030dal","Dallas Cowboys",21,"Philadelphia Eagles",31,52,-10,FALSE,"11/3/1996",1996,"November","1990s",50,58,8
"6819","199611030sea","Seattle Seahawks",23,"Houston Oilers",16,39,7,TRUE,"11/3/1996",1996,"November","1990s",72,NA,NA
"6820","199611040rai","Oakland Raiders",21,"Denver Broncos",22,43,-1,FALSE,"11/4/1996",1996,"November","1990s",54,77,9
"6821","199611100cin","Cincinnati Bengals",34,"Pittsburgh Steelers",24,58,10,TRUE,"11/10/1996",1996,"November","1990s",32,73,11
"6822","199611100car","Carolina Panthers",27,"New York Giants",17,44,10,TRUE,"11/10/1996",1996,"November","1990s",38,61,4
"6823","199611100was","Washington Redskins",34,"Arizona Cardinals",37,71,-3,FALSE,"11/10/1996",1996,"November","1990s",42,63,10
"6824","199611100tam","Tampa Bay Buccaneers",20,"Oakland Raiders",17,37,3,TRUE,"11/10/1996",1996,"November","1990s",56,50,9
"6825","199611100den","Denver Broncos",17,"Chicago Bears",12,29,5,TRUE,"11/10/1996",1996,"November","1990s",47,32,10
"6826","199611100kan","Kansas City Chiefs",27,"Green Bay Packers",20,47,7,TRUE,"11/10/1996",1996,"November","1990s",30,72,8
"6827","199611100phi","Philadelphia Eagles",17,"Buffalo Bills",24,41,-7,FALSE,"11/10/1996",1996,"November","1990s",42,72,12
"6828","199611100jax","Jacksonville Jaguars",30,"Baltimore Ravens",27,57,3,TRUE,"11/10/1996",1996,"November","1990s",53,47,8
"6829","199611100ram","St. Louis Rams",59,"Atlanta Falcons",16,75,43,TRUE,"11/10/1996",1996,"November","1990s",72,NA,NA
"6830","199611100sea","Seattle Seahawks",42,"Minnesota Vikings",23,65,19,TRUE,"11/10/1996",1996,"November","1990s",72,NA,NA
"6831","199611100sfo","San Francisco 49ers",17,"Dallas Cowboys",20,37,-3,FALSE,"11/10/1996",1996,"November","1990s",58,74,2
"6832","199611100nyj","New York Jets",27,"New England Patriots",31,58,-4,FALSE,"11/10/1996",1996,"November","1990s",46,61,11
"6833","199611100mia","Miami Dolphins",37,"Indianapolis Colts",13,50,24,TRUE,"11/10/1996",1996,"November","1990s",65,54,16
"6834","199611100nor","New Orleans Saints",14,"Houston Oilers",31,45,-17,FALSE,"11/10/1996",1996,"November","1990s",72,NA,NA
"6835","199611110sdg","San Diego Chargers",27,"Detroit Lions",21,48,6,TRUE,"11/11/1996",1996,"November","1990s",67,48,4
"6836","199611170nwe","New England Patriots",8,"Denver Broncos",34,42,-26,FALSE,"11/17/1996",1996,"November","1990s",42,24,8
"6837","199611170phi","Philadelphia Eagles",21,"Washington Redskins",26,47,-5,FALSE,"11/17/1996",1996,"November","1990s",38,46,3
"6838","199611170det","Detroit Lions",17,"Seattle Seahawks",16,33,1,TRUE,"11/17/1996",1996,"November","1990s",72,NA,NA
"6839","199611170buf","Buffalo Bills",31,"Cincinnati Bengals",17,48,14,TRUE,"11/17/1996",1996,"November","1990s",41,46,6
"6840","199611170ram","St. Louis Rams",10,"Carolina Panthers",20,30,-10,FALSE,"11/17/1996",1996,"November","1990s",72,NA,NA
"6841","199611170sfo","San Francisco 49ers",38,"Baltimore Ravens",20,58,18,TRUE,"11/17/1996",1996,"November","1990s",59,97,21
"6842","199611170crd","Arizona Cardinals",31,"New York Giants",23,54,8,TRUE,"11/17/1996",1996,"November","1990s",57,37,5
"6843","199611170pit","Pittsburgh Steelers",28,"Jacksonville Jaguars",3,31,25,TRUE,"11/17/1996",1996,"November","1990s",38,54,5
"6844","199611170clt","Indianapolis Colts",34,"New York Jets",29,63,5,TRUE,"11/17/1996",1996,"November","1990s",72,NA,NA
"6845","199611170sdg","San Diego Chargers",17,"Tampa Bay Buccaneers",25,42,-8,FALSE,"11/17/1996",1996,"November","1990s",58,78,6
"6846","199611170rai","Oakland Raiders",13,"Minnesota Vikings",16,29,-3,FALSE,"11/17/1996",1996,"November","1990s",55,96,19
"6847","199611170kan","Kansas City Chiefs",14,"Chicago Bears",10,24,4,TRUE,"11/17/1996",1996,"November","1990s",36,83,16
"6848","199611170oti","Houston Oilers",20,"Miami Dolphins",23,43,-3,FALSE,"11/17/1996",1996,"November","1990s",72,NA,NA
"6849","199611170atl","Atlanta Falcons",17,"New Orleans Saints",15,32,2,TRUE,"11/17/1996",1996,"November","1990s",72,NA,NA
"6850","199611180dal","Dallas Cowboys",21,"Green Bay Packers",6,27,15,TRUE,"11/18/1996",1996,"November","1990s",50,67,5
"6851","199611240was","Washington Redskins",16,"San Francisco 49ers",19,35,-3,FALSE,"11/24/1996",1996,"November","1990s",43,65,7
"6852","199611240buf","Buffalo Bills",35,"New York Jets",10,45,25,TRUE,"11/24/1996",1996,"November","1990s",29,75,11
"6853","199611240cin","Cincinnati Bengals",41,"Atlanta Falcons",31,72,10,TRUE,"11/24/1996",1996,"November","1990s",47,70,6
"6854","199611240nyg","New York Giants",20,"Dallas Cowboys",6,26,14,TRUE,"11/24/1996",1996,"November","1990s",44,48,11
"6855","199611240kan","Kansas City Chiefs",14,"San Diego Chargers",28,42,-14,FALSE,"11/24/1996",1996,"November","1990s",27,91,16
"6856","199611240rav","Baltimore Ravens",25,"Jacksonville Jaguars",28,53,-3,FALSE,"11/24/1996",1996,"November","1990s",39,70,4
"6857","199611240nwe","New England Patriots",27,"Indianapolis Colts",13,40,14,TRUE,"11/24/1996",1996,"November","1990s",38,44,11
"6858","199611240min","Minnesota Vikings",17,"Denver Broncos",21,38,-4,FALSE,"11/24/1996",1996,"November","1990s",72,NA,NA
"6859","199611240chi","Chicago Bears",31,"Detroit Lions",14,45,17,TRUE,"11/24/1996",1996,"November","1990s",37,95,9
"6860","199611240ram","St. Louis Rams",9,"Green Bay Packers",24,33,-15,FALSE,"11/24/1996",1996,"November","1990s",72,NA,NA
"6861","199611240sea","Seattle Seahawks",21,"Oakland Raiders",27,48,-6,FALSE,"11/24/1996",1996,"November","1990s",72,NA,NA
"6862","199611240crd","Arizona Cardinals",36,"Philadelphia Eagles",30,66,6,TRUE,"11/24/1996",1996,"November","1990s",61,49,6
"6863","199611240oti","Houston Oilers",6,"Carolina Panthers",31,37,-25,FALSE,"11/24/1996",1996,"November","1990s",72,NA,NA
"6864","199611240tam","Tampa Bay Buccaneers",13,"New Orleans Saints",7,20,6,TRUE,"11/24/1996",1996,"November","1990s",68,66,8
"6865","199611250mia","Miami Dolphins",17,"Pittsburgh Steelers",24,41,-7,FALSE,"11/25/1996",1996,"November","1990s",76,64,15
"6866","199611280dal","Dallas Cowboys",21,"Washington Redskins",10,31,11,TRUE,"11/28/1996",1996,"November","1990s",39,72,5
"6867","199611280det","Detroit Lions",24,"Kansas City Chiefs",28,52,-4,FALSE,"11/28/1996",1996,"November","1990s",72,NA,NA
"6868","199612010den","Denver Broncos",34,"Seattle Seahawks",7,41,27,TRUE,"12/1/1996",1996,"December","1990s",31,47,13
"6869","199612010min","Minnesota Vikings",41,"Arizona Cardinals",17,58,24,TRUE,"12/1/1996",1996,"December","1990s",72,NA,NA
"6870","199612010phi","Philadelphia Eagles",24,"New York Giants",0,24,24,TRUE,"12/1/1996",1996,"December","1990s",51,92,16
"6871","199612010rav","Baltimore Ravens",31,"Pittsburgh Steelers",17,48,14,TRUE,"12/1/1996",1996,"December","1990s",49,96,7
"6872","199612010nor","New Orleans Saints",10,"St. Louis Rams",26,36,-16,FALSE,"12/1/1996",1996,"December","1990s",72,NA,NA
"6873","199612010nyj","New York Jets",10,"Houston Oilers",35,45,-25,FALSE,"12/1/1996",1996,"December","1990s",51,77,17
"6874","199612010car","Carolina Panthers",24,"Tampa Bay Buccaneers",0,24,24,TRUE,"12/1/1996",1996,"December","1990s",58,95,13
"6875","199612010sdg","San Diego Chargers",7,"New England Patriots",45,52,-38,FALSE,"12/1/1996",1996,"December","1990s",55,66,5
"6876","199612010jax","Jacksonville Jaguars",30,"Cincinnati Bengals",27,57,3,TRUE,"12/1/1996",1996,"December","1990s",69,80,14
"6877","199612010rai","Oakland Raiders",17,"Miami Dolphins",7,24,10,TRUE,"12/1/1996",1996,"December","1990s",54,86,10
"6878","199612010clt","Indianapolis Colts",13,"Buffalo Bills",10,23,3,TRUE,"12/1/1996",1996,"December","1990s",72,NA,NA
"6879","199612010gnb","Green Bay Packers",28,"Chicago Bears",17,45,11,TRUE,"12/1/1996",1996,"December","1990s",31,85,14
"6880","199612020atl","Atlanta Falcons",10,"San Francisco 49ers",34,44,-24,FALSE,"12/2/1996",1996,"December","1990s",72,NA,NA
"6881","199612050clt","Indianapolis Colts",37,"Philadelphia Eagles",10,47,27,TRUE,"12/5/1996",1996,"December","1990s",72,NA,NA
"6882","199612080pit","Pittsburgh Steelers",16,"San Diego Chargers",3,19,13,TRUE,"12/8/1996",1996,"December","1990s",34,73,12
"6883","199612080nwe","New England Patriots",34,"New York Jets",10,44,24,TRUE,"12/8/1996",1996,"December","1990s",40,76,20
"6884","199612080tam","Tampa Bay Buccaneers",24,"Washington Redskins",10,34,14,TRUE,"12/8/1996",1996,"December","1990s",64,70,12
"6885","199612080det","Detroit Lions",22,"Minnesota Vikings",24,46,-2,FALSE,"12/8/1996",1996,"December","1990s",72,NA,NA
"6886","199612080sfo","San Francisco 49ers",24,"Carolina Panthers",30,54,-6,FALSE,"12/8/1996",1996,"December","1990s",59,81,15
"6887","199612080oti","Houston Oilers",17,"Jacksonville Jaguars",23,40,-6,FALSE,"12/8/1996",1996,"December","1990s",72,NA,NA
"6888","199612080gnb","Green Bay Packers",41,"Denver Broncos",6,47,35,TRUE,"12/8/1996",1996,"December","1990s",29,78,16
"6889","199612080nor","New Orleans Saints",15,"Atlanta Falcons",31,46,-16,FALSE,"12/8/1996",1996,"December","1990s",72,NA,NA
"6890","199612080chi","Chicago Bears",35,"St. Louis Rams",9,44,26,TRUE,"12/8/1996",1996,"December","1990s",29,79,15
"6891","199612080cin","Cincinnati Bengals",21,"Baltimore Ravens",14,35,7,TRUE,"12/8/1996",1996,"December","1990s",34,68,15
"6892","199612080mia","Miami Dolphins",7,"New York Giants",17,24,-10,FALSE,"12/8/1996",1996,"December","1990s",72,74,13
"6893","199612080crd","Arizona Cardinals",6,"Dallas Cowboys",10,16,-4,FALSE,"12/8/1996",1996,"December","1990s",63,44,3
"6894","199612080sea","Seattle Seahawks",26,"Buffalo Bills",18,44,8,TRUE,"12/8/1996",1996,"December","1990s",72,NA,NA
"6895","199612090rai","Oakland Raiders",26,"Kansas City Chiefs",7,33,19,TRUE,"12/9/1996",1996,"December","1990s",57,86,17
"6896","199612140nyj","New York Jets",20,"Philadelphia Eagles",21,41,-1,FALSE,"12/14/1996",1996,"December","1990s",41,90,17
"6897","199612140chi","Chicago Bears",27,"San Diego Chargers",14,41,13,TRUE,"12/14/1996",1996,"December","1990s",37,85,8
"6898","199612150pit","Pittsburgh Steelers",15,"San Francisco 49ers",25,40,-10,FALSE,"12/15/1996",1996,"December","1990s",32,85,6
"6899","199612150kan","Kansas City Chiefs",19,"Indianapolis Colts",24,43,-5,FALSE,"12/15/1996",1996,"December","1990s",33,77,15
"6900","199612150crd","Arizona Cardinals",27,"Washington Redskins",26,53,1,TRUE,"12/15/1996",1996,"December","1990s",61,15,12
"6901","199612150nyg","New York Giants",3,"New Orleans Saints",17,20,-14,FALSE,"12/15/1996",1996,"December","1990s",42,82,14
"6902","199612150dal","Dallas Cowboys",12,"New England Patriots",6,18,6,TRUE,"12/15/1996",1996,"December","1990s",50,75,22
"6903","199612150oti","Houston Oilers",13,"Cincinnati Bengals",21,34,-8,FALSE,"12/15/1996",1996,"December","1990s",72,NA,NA
"6904","199612150min","Minnesota Vikings",21,"Tampa Bay Buccaneers",10,31,11,TRUE,"12/15/1996",1996,"December","1990s",72,NA,NA
"6905","199612150atl","Atlanta Falcons",27,"St. Louis Rams",34,61,-7,FALSE,"12/15/1996",1996,"December","1990s",72,NA,NA
"6906","199612150den","Denver Broncos",24,"Oakland Raiders",19,43,5,TRUE,"12/15/1996",1996,"December","1990s",24,40,16
"6907","199612150car","Carolina Panthers",27,"Baltimore Ravens",16,43,11,TRUE,"12/15/1996",1996,"December","1990s",46,44,5
"6908","199612150jax","Jacksonville Jaguars",20,"Seattle Seahawks",13,33,7,TRUE,"12/15/1996",1996,"December","1990s",56,76,10
"6909","199612150det","Detroit Lions",3,"Green Bay Packers",31,34,-28,FALSE,"12/15/1996",1996,"December","1990s",72,NA,NA
"6910","199612160mia","Miami Dolphins",16,"Buffalo Bills",14,30,2,TRUE,"12/16/1996",1996,"December","1990s",68,64,8
"6911","199612210ram","St. Louis Rams",14,"New Orleans Saints",13,27,1,TRUE,"12/21/1996",1996,"December","1990s",72,NA,NA
"6912","199612210nyg","New York Giants",22,"New England Patriots",23,45,-1,FALSE,"12/21/1996",1996,"December","1990s",26,51,13
"6913","199612220rai","Oakland Raiders",21,"Seattle Seahawks",28,49,-7,FALSE,"12/22/1996",1996,"December","1990s",50,90,19
"6914","199612220car","Carolina Panthers",18,"Pittsburgh Steelers",14,32,4,TRUE,"12/22/1996",1996,"December","1990s",33,52,4
"6915","199612220buf","Buffalo Bills",20,"Kansas City Chiefs",9,29,11,TRUE,"12/22/1996",1996,"December","1990s",32,74,14
"6916","199612220jax","Jacksonville Jaguars",19,"Atlanta Falcons",17,36,2,TRUE,"12/22/1996",1996,"December","1990s",49,76,11
"6917","199612220tam","Tampa Bay Buccaneers",34,"Chicago Bears",19,53,15,TRUE,"12/22/1996",1996,"December","1990s",58,67,7
"6918","199612220cin","Cincinnati Bengals",31,"Indianapolis Colts",24,55,7,TRUE,"12/22/1996",1996,"December","1990s",37,61,12
"6919","199612220gnb","Green Bay Packers",38,"Minnesota Vikings",10,48,28,TRUE,"12/22/1996",1996,"December","1990s",30,82,12
"6920","199612220nyj","New York Jets",28,"Miami Dolphins",31,59,-3,FALSE,"12/22/1996",1996,"December","1990s",32,54,10
"6921","199612220sdg","San Diego Chargers",16,"Denver Broncos",10,26,6,TRUE,"12/22/1996",1996,"December","1990s",59,80,13
"6922","199612220was","Washington Redskins",37,"Dallas Cowboys",10,47,27,TRUE,"12/22/1996",1996,"December","1990s",34,60,9
"6923","199612220phi","Philadelphia Eagles",29,"Arizona Cardinals",19,48,10,TRUE,"12/22/1996",1996,"December","1990s",30,68,8
"6924","199612220rav","Baltimore Ravens",21,"Houston Oilers",24,45,-3,FALSE,"12/22/1996",1996,"December","1990s",27,73,3
"6925","199612230sfo","San Francisco 49ers",24,"Detroit Lions",14,38,10,TRUE,"12/23/1996",1996,"December","1990s",51,84,9
"6926","199612280buf","Buffalo Bills",27,"Jacksonville Jaguars",30,57,-3,FALSE,"12/28/1996",1996,"December","1990s",39,90,12
"6927","199612280dal","Dallas Cowboys",40,"Minnesota Vikings",15,55,25,TRUE,"12/28/1996",1996,"December","1990s",54,86,13
"6928","199612290sfo","San Francisco 49ers",14,"Philadelphia Eagles",0,14,14,TRUE,"12/29/1996",1996,"December","1990s",58,79,26
"6929","199612290pit","Pittsburgh Steelers",42,"Indianapolis Colts",14,56,28,TRUE,"12/29/1996",1996,"December","1990s",56,82,12
"6930","199701040gnb","Green Bay Packers",35,"San Francisco 49ers",14,49,21,TRUE,"1/4/1997",1997,"January","1990s",34,95,17
"6931","199701040den","Denver Broncos",27,"Jacksonville Jaguars",30,57,-3,FALSE,"1/4/1997",1997,"January","1990s",36,46,13
"6932","199701050car","Carolina Panthers",26,"Dallas Cowboys",17,43,9,TRUE,"1/5/1997",1997,"January","1990s",64,79,13
"6933","199701050nwe","New England Patriots",28,"Pittsburgh Steelers",3,31,25,TRUE,"1/5/1997",1997,"January","1990s",42,96,8
"6934","199701120gnb","Green Bay Packers",30,"Carolina Panthers",13,43,17,TRUE,"1/12/1997",1997,"January","1990s",3,67,16
"6935","199701120nwe","New England Patriots",20,"Jacksonville Jaguars",6,26,14,TRUE,"1/12/1997",1997,"January","1990s",23,54,19
"6936","199701260gnb","Green Bay Packers",35,"New England Patriots",21,56,14,TRUE,"1/26/1997",1997,"January","1990s",72,NA,NA
"6937","199708310det","Detroit Lions",28,"Atlanta Falcons",17,45,11,TRUE,"8/31/1997",1997,"August","1990s",72,NA,NA
"6938","199708310car","Carolina Panthers",10,"Washington Redskins",24,34,-14,FALSE,"8/31/1997",1997,"August","1990s",78,74,3
"6939","199708310cin","Cincinnati Bengals",24,"Arizona Cardinals",21,45,3,TRUE,"8/31/1997",1997,"August","1990s",71,72,4
"6940","199708310mia","Miami Dolphins",16,"Indianapolis Colts",10,26,6,TRUE,"8/31/1997",1997,"August","1990s",81,80,7
"6941","199708310pit","Pittsburgh Steelers",7,"Dallas Cowboys",37,44,-30,FALSE,"8/31/1997",1997,"August","1990s",66,76,4
"6942","199708310den","Denver Broncos",19,"Kansas City Chiefs",3,22,16,TRUE,"8/31/1997",1997,"August","1990s",70,53,14
"6943","199708310buf","Buffalo Bills",13,"Minnesota Vikings",34,47,-21,FALSE,"8/31/1997",1997,"August","1990s",65,80,6
"6944","199708310oti","Tennessee Oilers",24,"Oakland Raiders",21,45,3,TRUE,"8/31/1997",1997,"August","1990s",80,78,8
"6945","199708310rav","Baltimore Ravens",27,"Jacksonville Jaguars",28,55,-1,FALSE,"8/31/1997",1997,"August","1990s",71,79,4
"6946","199708310nyg","New York Giants",31,"Philadelphia Eagles",17,48,14,TRUE,"8/31/1997",1997,"August","1990s",75,70,10
"6947","199708310nwe","New England Patriots",41,"San Diego Chargers",7,48,34,TRUE,"8/31/1997",1997,"August","1990s",67,85,8
"6948","199708310tam","Tampa Bay Buccaneers",13,"San Francisco 49ers",6,19,7,TRUE,"8/31/1997",1997,"August","1990s",82,71,5
"6949","199708310ram","St. Louis Rams",38,"New Orleans Saints",24,62,14,TRUE,"8/31/1997",1997,"August","1990s",72,NA,NA
"6950","199708310sea","Seattle Seahawks",3,"New York Jets",41,44,-38,FALSE,"8/31/1997",1997,"August","1990s",72,NA,NA
"6951","199709010gnb","Green Bay Packers",38,"Chicago Bears",24,62,14,TRUE,"9/1/1997",1997,"September","1990s",69,82,8
"6952","199709070pit","Pittsburgh Steelers",14,"Washington Redskins",13,27,1,TRUE,"9/7/1997",1997,"September","1990s",67,70,8
"6953","199709070chi","Chicago Bears",24,"Minnesota Vikings",27,51,-3,FALSE,"9/7/1997",1997,"September","1990s",68,81,9
"6954","199709070ram","St. Louis Rams",12,"San Francisco 49ers",15,27,-3,FALSE,"9/7/1997",1997,"September","1990s",72,NA,NA
"6955","199709070clt","Indianapolis Colts",6,"New England Patriots",31,37,-25,FALSE,"9/7/1997",1997,"September","1990s",72,NA,NA
"6956","199709070crd","Arizona Cardinals",25,"Dallas Cowboys",22,47,3,TRUE,"9/7/1997",1997,"September","1990s",89,48,5
"6957","199709070mia","Miami Dolphins",16,"Tennessee Oilers",13,29,3,TRUE,"9/7/1997",1997,"September","1990s",80,71,11
"6958","199709070nor","New Orleans Saints",6,"San Diego Chargers",20,26,-14,FALSE,"9/7/1997",1997,"September","1990s",72,NA,NA
"6959","199709070sea","Seattle Seahawks",14,"Denver Broncos",35,49,-21,FALSE,"9/7/1997",1997,"September","1990s",72,NA,NA
"6960","199709070rav","Baltimore Ravens",23,"Cincinnati Bengals",10,33,13,TRUE,"9/7/1997",1997,"September","1990s",71,68,6
"6961","199709070phi","Philadelphia Eagles",10,"Green Bay Packers",9,19,1,TRUE,"9/7/1997",1997,"September","1990s",70,69,8
"6962","199709070jax","Jacksonville Jaguars",40,"New York Giants",13,53,27,TRUE,"9/7/1997",1997,"September","1990s",79,66,10
"6963","199709070det","Detroit Lions",17,"Tampa Bay Buccaneers",24,41,-7,FALSE,"9/7/1997",1997,"September","1990s",72,NA,NA
"6964","199709070atl","Atlanta Falcons",6,"Carolina Panthers",9,15,-3,FALSE,"9/7/1997",1997,"September","1990s",72,NA,NA
"6965","199709070nyj","New York Jets",22,"Buffalo Bills",28,50,-6,FALSE,"9/7/1997",1997,"September","1990s",73,61,9
"6966","199709080rai","Oakland Raiders",27,"Kansas City Chiefs",28,55,-1,FALSE,"9/8/1997",1997,"September","1990s",67,68,11
"6967","199709140gnb","Green Bay Packers",23,"Miami Dolphins",18,41,5,TRUE,"9/14/1997",1997,"September","1990s",66,86,6
"6968","199709140sfo","San Francisco 49ers",33,"New Orleans Saints",7,40,26,TRUE,"9/14/1997",1997,"September","1990s",68,76,13
"6969","199709140kan","Kansas City Chiefs",22,"Buffalo Bills",16,38,6,TRUE,"9/14/1997",1997,"September","1990s",72,80,6
"6970","199709140was","Washington Redskins",19,"Arizona Cardinals",13,32,6,TRUE,"9/14/1997",1997,"September","1990s",71,65,7
"6971","199709140min","Minnesota Vikings",14,"Tampa Bay Buccaneers",28,42,-14,FALSE,"9/14/1997",1997,"September","1990s",72,NA,NA
"6972","199709140den","Denver Broncos",35,"St. Louis Rams",14,49,21,TRUE,"9/14/1997",1997,"September","1990s",71,42,11
"6973","199709140atl","Atlanta Falcons",31,"Oakland Raiders",36,67,-5,FALSE,"9/14/1997",1997,"September","1990s",72,NA,NA
"6974","199709140chi","Chicago Bears",7,"Detroit Lions",32,39,-25,FALSE,"9/14/1997",1997,"September","1990s",69,75,6
"6975","199709140clt","Indianapolis Colts",3,"Seattle Seahawks",31,34,-28,FALSE,"9/14/1997",1997,"September","1990s",72,NA,NA
"6976","199709140sdg","San Diego Chargers",7,"Carolina Panthers",26,33,-19,FALSE,"9/14/1997",1997,"September","1990s",74,71,7
"6977","199709140nyg","New York Giants",23,"Baltimore Ravens",24,47,-1,FALSE,"9/14/1997",1997,"September","1990s",72,68,9
"6978","199709140nwe","New England Patriots",27,"New York Jets",24,51,3,TRUE,"9/14/1997",1997,"September","1990s",63,93,7
"6979","199709150dal","Dallas Cowboys",21,"Philadelphia Eagles",20,41,1,TRUE,"9/15/1997",1997,"September","1990s",86,57,10
"6980","199709210oti","Tennessee Oilers",10,"Baltimore Ravens",36,46,-26,FALSE,"9/21/1997",1997,"September","1990s",71,74,13
"6981","199709210den","Denver Broncos",38,"Cincinnati Bengals",20,58,18,TRUE,"9/21/1997",1997,"September","1990s",51,82,9
"6982","199709210sfo","San Francisco 49ers",34,"Atlanta Falcons",7,41,27,TRUE,"9/21/1997",1997,"September","1990s",66,70,15
"6983","199709210nyj","New York Jets",23,"Oakland Raiders",22,45,1,TRUE,"9/21/1997",1997,"September","1990s",60,56,19
"6984","199709210ram","St. Louis Rams",13,"New York Giants",3,16,10,TRUE,"9/21/1997",1997,"September","1990s",72,NA,NA
"6985","199709210buf","Buffalo Bills",37,"Indianapolis Colts",35,72,2,TRUE,"9/21/1997",1997,"September","1990s",51,66,9
"6986","199709210nwe","New England Patriots",31,"Chicago Bears",3,34,28,TRUE,"9/21/1997",1997,"September","1990s",56,61,17
"6987","199709210car","Carolina Panthers",14,"Kansas City Chiefs",35,49,-21,FALSE,"9/21/1997",1997,"September","1990s",75,52,10
"6988","199709210tam","Tampa Bay Buccaneers",31,"Miami Dolphins",21,52,10,TRUE,"9/21/1997",1997,"September","1990s",84,64,5
"6989","199709210nor","New Orleans Saints",35,"Detroit Lions",17,52,18,TRUE,"9/21/1997",1997,"September","1990s",72,NA,NA
"6990","199709210gnb","Green Bay Packers",38,"Minnesota Vikings",32,70,6,TRUE,"9/21/1997",1997,"September","1990s",50,72,8
"6991","199709210sea","Seattle Seahawks",26,"San Diego Chargers",22,48,4,TRUE,"9/21/1997",1997,"September","1990s",72,NA,NA
"6992","199709220jax","Jacksonville Jaguars",30,"Pittsburgh Steelers",21,51,9,TRUE,"9/22/1997",1997,"September","1990s",82,74,8
"6993","199709280cin","Cincinnati Bengals",14,"New York Jets",31,45,-17,FALSE,"9/28/1997",1997,"September","1990s",66,67,12
"6994","199709280pit","Pittsburgh Steelers",37,"Tennessee Oilers",24,61,13,TRUE,"9/28/1997",1997,"September","1990s",60,81,8
"6995","199709280tam","Tampa Bay Buccaneers",19,"Arizona Cardinals",18,37,1,TRUE,"9/28/1997",1997,"September","1990s",81,77,11
"6996","199709280was","Washington Redskins",24,"Jacksonville Jaguars",12,36,12,TRUE,"9/28/1997",1997,"September","1990s",64,85,14
"6997","199709280sdg","San Diego Chargers",21,"Baltimore Ravens",17,38,4,TRUE,"9/28/1997",1997,"September","1990s",73,83,6
"6998","199709280rai","Oakland Raiders",35,"St. Louis Rams",17,52,18,TRUE,"9/28/1997",1997,"September","1990s",72,48,8
"6999","199709280atl","Atlanta Falcons",21,"Denver Broncos",29,50,-8,FALSE,"9/28/1997",1997,"September","1990s",72,NA,NA
"7000","199709280dal","Dallas Cowboys",27,"Chicago Bears",3,30,24,TRUE,"9/28/1997",1997,"September","1990s",78,49,10
"7001","199709280min","Minnesota Vikings",28,"Philadelphia Eagles",19,47,9,TRUE,"9/28/1997",1997,"September","1990s",72,NA,NA
"7002","199709280det","Detroit Lions",26,"Green Bay Packers",15,41,11,TRUE,"9/28/1997",1997,"September","1990s",72,NA,NA
"7003","199709280kan","Kansas City Chiefs",20,"Seattle Seahawks",17,37,3,TRUE,"9/28/1997",1997,"September","1990s",67,56,11
"7004","199709280nyg","New York Giants",14,"New Orleans Saints",9,23,5,TRUE,"9/28/1997",1997,"September","1990s",63,78,13
"7005","199709290car","Carolina Panthers",21,"San Francisco 49ers",34,55,-13,FALSE,"9/29/1997",1997,"September","1990s",69,66,11
"7006","199710050clt","Indianapolis Colts",12,"New York Jets",16,28,-4,FALSE,"10/5/1997",1997,"October","1990s",72,NA,NA
"7007","199710050nyg","New York Giants",20,"Dallas Cowboys",17,37,3,TRUE,"10/5/1997",1997,"October","1990s",69,80,8
"7008","199710050sea","Seattle Seahawks",16,"Tennessee Oilers",13,29,3,TRUE,"10/5/1997",1997,"October","1990s",72,NA,NA
"7009","199710050crd","Arizona Cardinals",19,"Minnesota Vikings",20,39,-1,FALSE,"10/5/1997",1997,"October","1990s",86,35,6
"7010","199710050buf","Buffalo Bills",22,"Detroit Lions",13,35,9,TRUE,"10/5/1997",1997,"October","1990s",65,84,12
"7011","199710050phi","Philadelphia Eagles",24,"Washington Redskins",10,34,14,TRUE,"10/5/1997",1997,"October","1990s",68,74,7
"7012","199710050rav","Baltimore Ravens",34,"Pittsburgh Steelers",42,76,-8,FALSE,"10/5/1997",1997,"October","1990s",68,73,4
"7013","199710050jax","Jacksonville Jaguars",21,"Cincinnati Bengals",13,34,8,TRUE,"10/5/1997",1997,"October","1990s",79,69,10
"7014","199710050rai","Oakland Raiders",10,"San Diego Chargers",25,35,-15,FALSE,"10/5/1997",1997,"October","1990s",67,56,10
"7015","199710050chi","Chicago Bears",17,"New Orleans Saints",20,37,-3,FALSE,"10/5/1997",1997,"October","1990s",68,70,13
"7016","199710050mia","Miami Dolphins",17,"Kansas City Chiefs",14,31,3,TRUE,"10/5/1997",1997,"October","1990s",82,66,12
"7017","199710050gnb","Green Bay Packers",21,"Tampa Bay Buccaneers",16,37,5,TRUE,"10/5/1997",1997,"October","1990s",62,70,13
"7018","199710060den","Denver Broncos",34,"New England Patriots",13,47,21,TRUE,"10/6/1997",1997,"October","1990s",59,30,10
"7019","199710120oti","Tennessee Oilers",30,"Cincinnati Bengals",7,37,23,TRUE,"10/12/1997",1997,"October","1990s",74,64,12
"7020","199710120crd","Arizona Cardinals",13,"New York Giants",27,40,-14,FALSE,"10/12/1997",1997,"October","1990s",64,28,10
"7021","199710120nyj","New York Jets",20,"Miami Dolphins",31,51,-11,FALSE,"10/12/1997",1997,"October","1990s",60,47,8
"7022","199710120sfo","San Francisco 49ers",30,"St. Louis Rams",10,40,20,TRUE,"10/12/1997",1997,"October","1990s",59,63,13
"7023","199710120jax","Jacksonville Jaguars",38,"Philadelphia Eagles",21,59,17,TRUE,"10/12/1997",1997,"October","1990s",77,75,11
"7024","199710120nwe","New England Patriots",33,"Buffalo Bills",6,39,27,TRUE,"10/12/1997",1997,"October","1990s",53,58,9
"7025","199710120min","Minnesota Vikings",21,"Carolina Panthers",14,35,7,TRUE,"10/12/1997",1997,"October","1990s",72,NA,NA
"7026","199710120pit","Pittsburgh Steelers",24,"Indianapolis Colts",22,46,2,TRUE,"10/12/1997",1997,"October","1990s",57,66,4
"7027","199710120nor","New Orleans Saints",17,"Atlanta Falcons",23,40,-6,FALSE,"10/12/1997",1997,"October","1990s",72,NA,NA
"7028","199710120tam","Tampa Bay Buccaneers",9,"Detroit Lions",27,36,-18,FALSE,"10/12/1997",1997,"October","1990s",77,71,10
"7029","199710120chi","Chicago Bears",23,"Green Bay Packers",24,47,-1,FALSE,"10/12/1997",1997,"October","1990s",68,53,15
"7030","199710130was","Washington Redskins",21,"Dallas Cowboys",16,37,5,TRUE,"10/13/1997",1997,"October","1990s",65,72,8
"7031","199710160kan","Kansas City Chiefs",31,"San Diego Chargers",3,34,28,TRUE,"10/16/1997",1997,"October","1990s",57,69,10
"7032","199710190oti","Tennessee Oilers",28,"Washington Redskins",14,42,14,TRUE,"10/19/1997",1997,"October","1990s",55,61,4
"7033","199710190ram","St. Louis Rams",9,"Seattle Seahawks",17,26,-8,FALSE,"10/19/1997",1997,"October","1990s",72,NA,NA
"7034","199710190atl","Atlanta Falcons",28,"San Francisco 49ers",35,63,-7,FALSE,"10/19/1997",1997,"October","1990s",72,NA,NA
"7035","199710190cin","Cincinnati Bengals",10,"Pittsburgh Steelers",26,36,-16,FALSE,"10/19/1997",1997,"October","1990s",51,66,7
"7036","199710190nyj","New York Jets",24,"New England Patriots",19,43,5,TRUE,"10/19/1997",1997,"October","1990s",54,75,13
"7037","199710190dal","Dallas Cowboys",26,"Jacksonville Jaguars",22,48,4,TRUE,"10/19/1997",1997,"October","1990s",66,59,10
"7038","199710190rai","Oakland Raiders",28,"Denver Broncos",25,53,3,TRUE,"10/19/1997",1997,"October","1990s",60,72,12
"7039","199710190phi","Philadelphia Eagles",13,"Arizona Cardinals",10,23,3,TRUE,"10/19/1997",1997,"October","1990s",55,68,13
"7040","199710190rav","Baltimore Ravens",13,"Miami Dolphins",24,37,-11,FALSE,"10/19/1997",1997,"October","1990s",56,76,8
"7041","199710190nor","New Orleans Saints",0,"Carolina Panthers",13,13,-13,FALSE,"10/19/1997",1997,"October","1990s",72,NA,NA
"7042","199710190det","Detroit Lions",20,"New York Giants",26,46,-6,FALSE,"10/19/1997",1997,"October","1990s",72,NA,NA
"7043","199710200clt","Indianapolis Colts",6,"Buffalo Bills",9,15,-3,FALSE,"10/20/1997",1997,"October","1990s",72,NA,NA
"7044","199710260ram","St. Louis Rams",20,"Kansas City Chiefs",28,48,-8,FALSE,"10/26/1997",1997,"October","1990s",72,NA,NA
"7045","199710260pit","Pittsburgh Steelers",23,"Jacksonville Jaguars",17,40,6,TRUE,"10/26/1997",1997,"October","1990s",46,83,11
"7046","199710260was","Washington Redskins",17,"Baltimore Ravens",20,37,-3,FALSE,"10/26/1997",1997,"October","1990s",50,86,11
"7047","199710260sea","Seattle Seahawks",45,"Oakland Raiders",34,79,11,TRUE,"10/26/1997",1997,"October","1990s",72,NA,NA
"7048","199710260crd","Arizona Cardinals",14,"Tennessee Oilers",41,55,-27,FALSE,"10/26/1997",1997,"October","1990s",62,22,7
"7049","199710260tam","Tampa Bay Buccaneers",6,"Minnesota Vikings",10,16,-4,FALSE,"10/26/1997",1997,"October","1990s",78,89,9
"7050","199710260buf","Buffalo Bills",20,"Denver Broncos",23,43,-3,FALSE,"10/26/1997",1997,"October","1990s",35,80,11
"7051","199710260sdg","San Diego Chargers",35,"Indianapolis Colts",19,54,16,TRUE,"10/26/1997",1997,"October","1990s",66,31,7
"7052","199710260car","Carolina Panthers",21,"Atlanta Falcons",12,33,9,TRUE,"10/26/1997",1997,"October","1990s",63,94,8
"7053","199710260phi","Philadelphia Eagles",13,"Dallas Cowboys",12,25,1,TRUE,"10/26/1997",1997,"October","1990s",48,74,10
"7054","199710260nyg","New York Giants",29,"Cincinnati Bengals",27,56,2,TRUE,"10/26/1997",1997,"October","1990s",46,76,12
"7055","199710260nor","New Orleans Saints",0,"San Francisco 49ers",23,23,-23,FALSE,"10/26/1997",1997,"October","1990s",72,NA,NA
"7056","199710270nwe","New England Patriots",10,"Green Bay Packers",28,38,-18,FALSE,"10/27/1997",1997,"October","1990s",48,87,20
"7057","199710270mia","Miami Dolphins",33,"Chicago Bears",36,69,-3,FALSE,"10/27/1997",1997,"October","1990s",82,78,11
"7058","199711020oti","Tennessee Oilers",24,"Jacksonville Jaguars",30,54,-6,FALSE,"11/2/1997",1997,"November","1990s",55,56,16
"7059","199711020chi","Chicago Bears",8,"Washington Redskins",31,39,-23,FALSE,"11/2/1997",1997,"November","1990s",42,71,14
"7060","199711020clt","Indianapolis Colts",28,"Tampa Bay Buccaneers",31,59,-3,FALSE,"11/2/1997",1997,"November","1990s",72,NA,NA
"7061","199711020cin","Cincinnati Bengals",38,"San Diego Chargers",31,69,7,TRUE,"11/2/1997",1997,"November","1990s",46,79,13
"7062","199711020gnb","Green Bay Packers",20,"Detroit Lions",10,30,10,TRUE,"11/2/1997",1997,"November","1990s",39,78,12
"7063","199711020sfo","San Francisco 49ers",17,"Dallas Cowboys",10,27,7,TRUE,"11/2/1997",1997,"November","1990s",65,73,5
"7064","199711020car","Carolina Panthers",38,"Oakland Raiders",14,52,24,TRUE,"11/2/1997",1997,"November","1990s",60,67,12
"7065","199711020crd","Arizona Cardinals",31,"Philadelphia Eagles",21,52,10,TRUE,"11/2/1997",1997,"November","1990s",73,31,3
"7066","199711020den","Denver Broncos",30,"Seattle Seahawks",27,57,3,TRUE,"11/2/1997",1997,"November","1990s",38,48,16
"7067","199711020nyj","New York Jets",19,"Baltimore Ravens",16,35,3,TRUE,"11/2/1997",1997,"November","1990s",60,93,14
"7068","199711020min","Minnesota Vikings",23,"New England Patriots",18,41,5,TRUE,"11/2/1997",1997,"November","1990s",72,NA,NA
"7069","199711020atl","Atlanta Falcons",34,"St. Louis Rams",31,65,3,TRUE,"11/2/1997",1997,"November","1990s",72,NA,NA
"7070","199711020buf","Buffalo Bills",9,"Miami Dolphins",6,15,3,TRUE,"11/2/1997",1997,"November","1990s",51,91,14
"7071","199711030kan","Kansas City Chiefs",13,"Pittsburgh Steelers",10,23,3,TRUE,"11/3/1997",1997,"November","1990s",36,73,16
"7072","199711090mia","Miami Dolphins",24,"New York Jets",17,41,7,TRUE,"11/9/1997",1997,"November","1990s",64,66,6
"7073","199711090pit","Pittsburgh Steelers",37,"Baltimore Ravens",0,37,37,TRUE,"11/9/1997",1997,"November","1990s",46,76,13
"7074","199711090gnb","Green Bay Packers",17,"St. Louis Rams",7,24,10,TRUE,"11/9/1997",1997,"November","1990s",38,85,7
"7075","199711090atl","Atlanta Falcons",10,"Tampa Bay Buccaneers",31,41,-21,FALSE,"11/9/1997",1997,"November","1990s",72,NA,NA
"7076","199711090rai","Oakland Raiders",10,"New Orleans Saints",13,23,-3,FALSE,"11/9/1997",1997,"November","1990s",58,63,7
"7077","199711090sdg","San Diego Chargers",31,"Seattle Seahawks",37,68,-6,FALSE,"11/9/1997",1997,"November","1990s",63,71,7
"7078","199711090oti","Tennessee Oilers",10,"New York Giants",6,16,4,TRUE,"11/9/1997",1997,"November","1990s",46,79,7
"7079","199711090jax","Jacksonville Jaguars",24,"Kansas City Chiefs",10,34,14,TRUE,"11/9/1997",1997,"November","1990s",54,68,8
"7080","199711090buf","Buffalo Bills",10,"New England Patriots",31,41,-21,FALSE,"11/9/1997",1997,"November","1990s",43,78,9
"7081","199711090clt","Indianapolis Colts",13,"Cincinnati Bengals",28,41,-15,FALSE,"11/9/1997",1997,"November","1990s",72,NA,NA
"7082","199711090dal","Dallas Cowboys",24,"Arizona Cardinals",6,30,18,TRUE,"11/9/1997",1997,"November","1990s",54,79,10
"7083","199711090den","Denver Broncos",34,"Carolina Panthers",0,34,34,TRUE,"11/9/1997",1997,"November","1990s",30,90,12
"7084","199711090was","Washington Redskins",30,"Detroit Lions",7,37,23,TRUE,"11/9/1997",1997,"November","1990s",50,85,15
"7085","199711090min","Minnesota Vikings",29,"Chicago Bears",22,51,7,TRUE,"11/9/1997",1997,"November","1990s",72,NA,NA
"7086","199711100phi","Philadelphia Eagles",12,"San Francisco 49ers",24,36,-12,FALSE,"11/10/1997",1997,"November","1990s",47,67,12
"7087","199711160sfo","San Francisco 49ers",27,"Carolina Panthers",19,46,8,TRUE,"11/16/1997",1997,"November","1990s",56,86,12
"7088","199711160dal","Dallas Cowboys",17,"Washington Redskins",14,31,3,TRUE,"11/16/1997",1997,"November","1990s",37,56,8
"7089","199711160det","Detroit Lions",38,"Minnesota Vikings",15,53,23,TRUE,"11/16/1997",1997,"November","1990s",72,NA,NA
"7090","199711160chi","Chicago Bears",15,"New York Jets",23,38,-8,FALSE,"11/16/1997",1997,"November","1990s",25,78,11
"7091","199711160rav","Baltimore Ravens",10,"Philadelphia Eagles",10,20,0,FALSE,"11/16/1997",1997,"November","1990s",38,68,14
"7092","199711160nyg","New York Giants",19,"Arizona Cardinals",10,29,9,TRUE,"11/16/1997",1997,"November","1990s",38,69,17
"7093","199711160sdg","San Diego Chargers",13,"Oakland Raiders",38,51,-25,FALSE,"11/16/1997",1997,"November","1990s",61,72,6
"7094","199711160nor","New Orleans Saints",20,"Seattle Seahawks",17,37,3,TRUE,"11/16/1997",1997,"November","1990s",72,NA,NA
"7095","199711160clt","Indianapolis Colts",41,"Green Bay Packers",38,79,3,TRUE,"11/16/1997",1997,"November","1990s",72,NA,NA
"7096","199711160tam","Tampa Bay Buccaneers",27,"New England Patriots",7,34,20,TRUE,"11/16/1997",1997,"November","1990s",60,73,9
"7097","199711160pit","Pittsburgh Steelers",20,"Cincinnati Bengals",3,23,17,TRUE,"11/16/1997",1997,"November","1990s",29,78,15
"7098","199711160jax","Jacksonville Jaguars",17,"Tennessee Oilers",9,26,8,TRUE,"11/16/1997",1997,"November","1990s",56,58,10
"7099","199711160ram","St. Louis Rams",21,"Atlanta Falcons",27,48,-6,FALSE,"11/16/1997",1997,"November","1990s",72,NA,NA
"7100","199711160kan","Kansas City Chiefs",24,"Denver Broncos",22,46,2,TRUE,"11/16/1997",1997,"November","1990s",24,71,8
"7101","199711170mia","Miami Dolphins",30,"Buffalo Bills",13,43,17,TRUE,"11/17/1997",1997,"November","1990s",70,73,11
"7102","199711230cin","Cincinnati Bengals",31,"Jacksonville Jaguars",26,57,5,TRUE,"11/23/1997",1997,"November","1990s",39,74,11
"7103","199711230nyj","New York Jets",23,"Minnesota Vikings",21,44,2,TRUE,"11/23/1997",1997,"November","1990s",39,98,10
"7104","199711230ram","St. Louis Rams",10,"Carolina Panthers",16,26,-6,FALSE,"11/23/1997",1997,"November","1990s",72,NA,NA
"7105","199711230atl","Atlanta Falcons",20,"New Orleans Saints",3,23,17,TRUE,"11/23/1997",1997,"November","1990s",72,NA,NA
"7106","199711230gnb","Green Bay Packers",45,"Dallas Cowboys",17,62,28,TRUE,"11/23/1997",1997,"November","1990s",23,62,17
"7107","199711230phi","Philadelphia Eagles",23,"Pittsburgh Steelers",20,43,3,TRUE,"11/23/1997",1997,"November","1990s",45,90,6
"7108","199711230rav","Baltimore Ravens",13,"Arizona Cardinals",16,29,-3,FALSE,"11/23/1997",1997,"November","1990s",48,93,3
"7109","199711230sea","Seattle Seahawks",14,"Kansas City Chiefs",19,33,-5,FALSE,"11/23/1997",1997,"November","1990s",72,NA,NA
"7110","199711230det","Detroit Lions",32,"Indianapolis Colts",10,42,22,TRUE,"11/23/1997",1997,"November","1990s",72,NA,NA
"7111","199711230sfo","San Francisco 49ers",17,"San Diego Chargers",10,27,7,TRUE,"11/23/1997",1997,"November","1990s",61,86,15
"7112","199711230oti","Tennessee Oilers",31,"Buffalo Bills",14,45,17,TRUE,"11/23/1997",1997,"November","1990s",40,90,6
"7113","199711230chi","Chicago Bears",13,"Tampa Bay Buccaneers",7,20,6,TRUE,"11/23/1997",1997,"November","1990s",27,73,13
"7114","199711230was","Washington Redskins",7,"New York Giants",7,14,0,FALSE,"11/23/1997",1997,"November","1990s",49,90,5
"7115","199711230nwe","New England Patriots",27,"Miami Dolphins",24,51,3,TRUE,"11/23/1997",1997,"November","1990s",32,92,12
"7116","199711240den","Denver Broncos",31,"Oakland Raiders",3,34,28,TRUE,"11/24/1997",1997,"November","1990s",42,42,11
"7117","199711270det","Detroit Lions",55,"Chicago Bears",20,75,35,TRUE,"11/27/1997",1997,"November","1990s",72,NA,NA
"7118","199711270dal","Dallas Cowboys",14,"Tennessee Oilers",27,41,-13,FALSE,"11/27/1997",1997,"November","1990s",66,68,16
"7119","199711300nwe","New England Patriots",20,"Indianapolis Colts",17,37,3,TRUE,"11/30/1997",1997,"November","1990s",38,58,7
"7120","199711300sdg","San Diego Chargers",28,"Denver Broncos",38,66,-10,FALSE,"11/30/1997",1997,"November","1990s",61,67,8
"7121","199711300sea","Seattle Seahawks",17,"Atlanta Falcons",24,41,-7,FALSE,"11/30/1997",1997,"November","1990s",72,NA,NA
"7122","199711300kan","Kansas City Chiefs",44,"San Francisco 49ers",9,53,35,TRUE,"11/30/1997",1997,"November","1990s",46,84,14
"7123","199711300jax","Jacksonville Jaguars",29,"Baltimore Ravens",27,56,2,TRUE,"11/30/1997",1997,"November","1990s",71,89,14
"7124","199711300nyg","New York Giants",8,"Tampa Bay Buccaneers",20,28,-12,FALSE,"11/30/1997",1997,"November","1990s",45,75,7
"7125","199711300crd","Arizona Cardinals",20,"Pittsburgh Steelers",26,46,-6,FALSE,"11/30/1997",1997,"November","1990s",56,52,5
"7126","199711300car","Carolina Panthers",13,"New Orleans Saints",16,29,-3,FALSE,"11/30/1997",1997,"November","1990s",57,93,6
"7127","199711300phi","Philadelphia Eagles",44,"Cincinnati Bengals",42,86,2,TRUE,"11/30/1997",1997,"November","1990s",46,80,5
"7128","199711300was","Washington Redskins",20,"St. Louis Rams",23,43,-3,FALSE,"11/30/1997",1997,"November","1990s",50,82,6
"7129","199711300buf","Buffalo Bills",20,"New York Jets",10,30,10,TRUE,"11/30/1997",1997,"November","1990s",39,92,6
"7130","199711300rai","Oakland Raiders",16,"Miami Dolphins",34,50,-18,FALSE,"11/30/1997",1997,"November","1990s",56,76,12
"7131","199712010min","Minnesota Vikings",11,"Green Bay Packers",27,38,-16,FALSE,"12/1/1997",1997,"December","1990s",72,NA,NA
"7132","199712040cin","Cincinnati Bengals",41,"Tennessee Oilers",14,55,27,TRUE,"12/4/1997",1997,"December","1990s",42,84,13
"7133","199712070rav","Baltimore Ravens",31,"Seattle Seahawks",24,55,7,TRUE,"12/7/1997",1997,"December","1990s",36,53,16
"7134","199712070pit","Pittsburgh Steelers",35,"Denver Broncos",24,59,11,TRUE,"12/7/1997",1997,"December","1990s",28,86,13
"7135","199712070jax","Jacksonville Jaguars",20,"New England Patriots",26,46,-6,FALSE,"12/7/1997",1997,"December","1990s",43,56,9
"7136","199712070phi","Philadelphia Eagles",21,"New York Giants",31,52,-10,FALSE,"12/7/1997",1997,"December","1990s",35,56,17
"7137","199712070tam","Tampa Bay Buccaneers",6,"Green Bay Packers",17,23,-11,FALSE,"12/7/1997",1997,"December","1990s",49,56,8
"7138","199712070sdg","San Diego Chargers",3,"Atlanta Falcons",14,17,-11,FALSE,"12/7/1997",1997,"December","1990s",62,82,11
"7139","199712070crd","Arizona Cardinals",28,"Washington Redskins",38,66,-10,FALSE,"12/7/1997",1997,"December","1990s",57,82,6
"7140","199712070nor","New Orleans Saints",27,"St. Louis Rams",34,61,-7,FALSE,"12/7/1997",1997,"December","1990s",72,NA,NA
"7141","199712070chi","Chicago Bears",20,"Buffalo Bills",3,23,17,TRUE,"12/7/1997",1997,"December","1990s",31,80,11
"7142","199712070nyj","New York Jets",14,"Indianapolis Colts",22,36,-8,FALSE,"12/7/1997",1997,"December","1990s",35,63,19
"7143","199712070kan","Kansas City Chiefs",30,"Oakland Raiders",0,30,30,TRUE,"12/7/1997",1997,"December","1990s",25,87,7
"7144","199712070mia","Miami Dolphins",33,"Detroit Lions",30,63,3,TRUE,"12/7/1997",1997,"December","1990s",56,62,7
"7145","199712070sfo","San Francisco 49ers",28,"Minnesota Vikings",17,45,11,TRUE,"12/7/1997",1997,"December","1990s",57,91,14
"7146","199712080dal","Dallas Cowboys",13,"Carolina Panthers",23,36,-10,FALSE,"12/8/1997",1997,"December","1990s",49,88,11
"7147","199712130nyg","New York Giants",30,"Washington Redskins",10,40,20,TRUE,"12/13/1997",1997,"December","1990s",36,69,13
"7148","199712130nwe","New England Patriots",21,"Pittsburgh Steelers",24,45,-3,FALSE,"12/13/1997",1997,"December","1990s",36,86,14
"7149","199712140car","Carolina Panthers",10,"Green Bay Packers",31,41,-21,FALSE,"12/14/1997",1997,"December","1990s",41,52,8
"7150","199712140ram","St. Louis Rams",10,"Chicago Bears",13,23,-3,FALSE,"12/14/1997",1997,"December","1990s",72,NA,NA
"7151","199712140rai","Oakland Raiders",21,"Seattle Seahawks",22,43,-1,FALSE,"12/14/1997",1997,"December","1990s",53,79,12
"7152","199712140buf","Buffalo Bills",14,"Jacksonville Jaguars",20,34,-6,FALSE,"12/14/1997",1997,"December","1990s",30,74,15
"7153","199712140rav","Baltimore Ravens",21,"Tennessee Oilers",19,40,2,TRUE,"12/14/1997",1997,"December","1990s",35,61,11
"7154","199712140nyj","New York Jets",31,"Tampa Bay Buccaneers",0,31,31,TRUE,"12/14/1997",1997,"December","1990s",38,56,20
"7155","199712140sdg","San Diego Chargers",7,"Kansas City Chiefs",29,36,-22,FALSE,"12/14/1997",1997,"December","1990s",58,52,6
"7156","199712140cin","Cincinnati Bengals",31,"Dallas Cowboys",24,55,7,TRUE,"12/14/1997",1997,"December","1990s",33,73,6
"7157","199712140min","Minnesota Vikings",13,"Detroit Lions",14,27,-1,FALSE,"12/14/1997",1997,"December","1990s",72,NA,NA
"7158","199712140nor","New Orleans Saints",27,"Arizona Cardinals",10,37,17,TRUE,"12/14/1997",1997,"December","1990s",72,NA,NA
"7159","199712140atl","Atlanta Falcons",20,"Philadelphia Eagles",17,37,3,TRUE,"12/14/1997",1997,"December","1990s",72,NA,NA
"7160","199712140clt","Indianapolis Colts",41,"Miami Dolphins",0,41,41,TRUE,"12/14/1997",1997,"December","1990s",72,NA,NA
"7161","199712150sfo","San Francisco 49ers",34,"Denver Broncos",17,51,17,TRUE,"12/15/1997",1997,"December","1990s",49,90,7
"7162","199712200car","Carolina Panthers",18,"St. Louis Rams",30,48,-12,FALSE,"12/20/1997",1997,"December","1990s",49,50,6
"7163","199712200gnb","Green Bay Packers",31,"Buffalo Bills",21,52,10,TRUE,"12/20/1997",1997,"December","1990s",32,73,7
"7164","199712210kan","Kansas City Chiefs",25,"New Orleans Saints",13,38,12,TRUE,"12/21/1997",1997,"December","1990s",31,84,16
"7165","199712210rai","Oakland Raiders",9,"Jacksonville Jaguars",20,29,-11,FALSE,"12/21/1997",1997,"December","1990s",52,54,12
"7166","199712210crd","Arizona Cardinals",29,"Atlanta Falcons",26,55,3,TRUE,"12/21/1997",1997,"December","1990s",55,71,8
"7167","199712210det","Detroit Lions",13,"New York Jets",10,23,3,TRUE,"12/21/1997",1997,"December","1990s",72,NA,NA
"7168","199712210den","Denver Broncos",38,"San Diego Chargers",3,41,35,TRUE,"12/21/1997",1997,"December","1990s",23,80,6
"7169","199712210sea","Seattle Seahawks",38,"San Francisco 49ers",9,47,29,TRUE,"12/21/1997",1997,"December","1990s",72,NA,NA
"7170","199712210dal","Dallas Cowboys",7,"New York Giants",20,27,-13,FALSE,"12/21/1997",1997,"December","1990s",48,87,17
"7171","199712210tam","Tampa Bay Buccaneers",31,"Chicago Bears",15,46,16,TRUE,"12/21/1997",1997,"December","1990s",65,86,6
"7172","199712210cin","Cincinnati Bengals",16,"Baltimore Ravens",14,30,2,TRUE,"12/21/1997",1997,"December","1990s",37,74,13
"7173","199712210oti","Tennessee Oilers",16,"Pittsburgh Steelers",6,22,10,TRUE,"12/21/1997",1997,"December","1990s",47,83,15
"7174","199712210min","Minnesota Vikings",39,"Indianapolis Colts",28,67,11,TRUE,"12/21/1997",1997,"December","1990s",72,NA,NA
"7175","199712210was","Washington Redskins",35,"Philadelphia Eagles",32,67,3,TRUE,"12/21/1997",1997,"December","1990s",42,58,10
"7176","199712220mia","Miami Dolphins",12,"New England Patriots",14,26,-2,FALSE,"12/22/1997",1997,"December","1990s",76,84,12
"7177","199712270den","Denver Broncos",42,"Jacksonville Jaguars",17,59,25,TRUE,"12/27/1997",1997,"December","1990s",27,50,21
"7178","199712270nyg","New York Giants",22,"Minnesota Vikings",23,45,-1,FALSE,"12/27/1997",1997,"December","1990s",39,69,10
"7179","199712280nwe","New England Patriots",17,"Miami Dolphins",3,20,14,TRUE,"12/28/1997",1997,"December","1990s",33,63,14
"7180","199712280tam","Tampa Bay Buccaneers",20,"Detroit Lions",10,30,10,TRUE,"12/28/1997",1997,"December","1990s",49,69,11
"7181","199801030sfo","San Francisco 49ers",38,"Minnesota Vikings",22,60,16,TRUE,"1/3/1998",1998,"January","1990s",54,90,13
"7182","199801030pit","Pittsburgh Steelers",7,"New England Patriots",6,13,1,TRUE,"1/3/1998",1998,"January","1990s",50,36,14
"7183","199801040gnb","Green Bay Packers",21,"Tampa Bay Buccaneers",7,28,14,TRUE,"1/4/1998",1998,"January","1990s",27,79,17
"7184","199801040kan","Kansas City Chiefs",10,"Denver Broncos",14,24,-4,FALSE,"1/4/1998",1998,"January","1990s",30,91,11
"7185","199801110sfo","San Francisco 49ers",10,"Green Bay Packers",23,33,-13,FALSE,"1/11/1998",1998,"January","1990s",54,95,10
"7186","199801110pit","Pittsburgh Steelers",21,"Denver Broncos",24,45,-3,FALSE,"1/11/1998",1998,"January","1990s",33,52,8
"7187","199801250den","Denver Broncos",31,"Green Bay Packers",24,55,7,TRUE,"1/25/1998",1998,"January","1990s",59,79,6
"7188","199809060sdg","San Diego Chargers",16,"Buffalo Bills",14,30,2,TRUE,"9/6/1998",1998,"September","1990s",73,83,9
"7189","199809060min","Minnesota Vikings",31,"Tampa Bay Buccaneers",7,38,24,TRUE,"9/6/1998",1998,"September","1990s",72,NA,NA
"7190","199809060gnb","Green Bay Packers",38,"Detroit Lions",19,57,19,TRUE,"9/6/1998",1998,"September","1990s",74,73,8
"7191","199809060chi","Chicago Bears",23,"Jacksonville Jaguars",24,47,-1,FALSE,"9/6/1998",1998,"September","1990s",80,73,7
"7192","199809060clt","Indianapolis Colts",15,"Miami Dolphins",24,39,-9,FALSE,"9/6/1998",1998,"September","1990s",72,NA,NA
"7193","199809060ram","St. Louis Rams",17,"New Orleans Saints",24,41,-7,FALSE,"9/6/1998",1998,"September","1990s",72,NA,NA
"7194","199809060rav","Baltimore Ravens",13,"Pittsburgh Steelers",20,33,-7,FALSE,"9/6/1998",1998,"September","1990s",73,51,5
"7195","199809060phi","Philadelphia Eagles",0,"Seattle Seahawks",38,38,-38,FALSE,"9/6/1998",1998,"September","1990s",75,60,11
"7196","199809060dal","Dallas Cowboys",38,"Arizona Cardinals",10,48,28,TRUE,"9/6/1998",1998,"September","1990s",88,44,11
"7197","199809060kan","Kansas City Chiefs",28,"Oakland Raiders",8,36,20,TRUE,"9/6/1998",1998,"September","1990s",84,66,12
"7198","199809060nyg","New York Giants",31,"Washington Redskins",24,55,7,TRUE,"9/6/1998",1998,"September","1990s",80,42,12
"7199","199809060sfo","San Francisco 49ers",36,"New York Jets",30,66,6,TRUE,"9/6/1998",1998,"September","1990s",70,70,14
"7200","199809060cin","Cincinnati Bengals",14,"Tennessee Oilers",23,37,-9,FALSE,"9/6/1998",1998,"September","1990s",81,62,8
"7201","199809060car","Carolina Panthers",14,"Atlanta Falcons",19,33,-5,FALSE,"9/6/1998",1998,"September","1990s",79,76,5
"7202","199809070den","Denver Broncos",27,"New England Patriots",21,48,6,TRUE,"9/7/1998",1998,"September","1990s",70,46,9
"7203","199809130nor","New Orleans Saints",19,"Carolina Panthers",14,33,5,TRUE,"9/13/1998",1998,"September","1990s",72,NA,NA
"7204","199809130nyj","New York Jets",10,"Baltimore Ravens",24,34,-14,FALSE,"9/13/1998",1998,"September","1990s",75,60,9
"7205","199809130sea","Seattle Seahawks",33,"Arizona Cardinals",14,47,19,TRUE,"9/13/1998",1998,"September","1990s",72,NA,NA
"7206","199809130oti","Tennessee Oilers",7,"San Diego Chargers",13,20,-6,FALSE,"9/13/1998",1998,"September","1990s",76,47,4
"7207","199809130rai","Oakland Raiders",20,"New York Giants",17,37,3,TRUE,"9/13/1998",1998,"September","1990s",72,59,11
"7208","199809130jax","Jacksonville Jaguars",21,"Kansas City Chiefs",16,37,5,TRUE,"9/13/1998",1998,"September","1990s",79,73,6
"7209","199809130mia","Miami Dolphins",13,"Buffalo Bills",7,20,6,TRUE,"9/13/1998",1998,"September","1990s",82,62,12
"7210","199809130den","Denver Broncos",42,"Dallas Cowboys",23,65,19,TRUE,"9/13/1998",1998,"September","1990s",64,65,14
"7211","199809130nwe","New England Patriots",29,"Indianapolis Colts",6,35,23,TRUE,"9/13/1998",1998,"September","1990s",66,76,10
"7212","199809130gnb","Green Bay Packers",23,"Tampa Bay Buccaneers",15,38,8,TRUE,"9/13/1998",1998,"September","1990s",70,79,5
"7213","199809130ram","St. Louis Rams",31,"Minnesota Vikings",38,69,-7,FALSE,"9/13/1998",1998,"September","1990s",72,NA,NA
"7214","199809130pit","Pittsburgh Steelers",17,"Chicago Bears",12,29,5,TRUE,"9/13/1998",1998,"September","1990s",73,59,4
"7215","199809130atl","Atlanta Falcons",17,"Philadelphia Eagles",12,29,5,TRUE,"9/13/1998",1998,"September","1990s",72,NA,NA
"7216","199809130det","Detroit Lions",28,"Cincinnati Bengals",34,62,-6,FALSE,"9/13/1998",1998,"September","1990s",72,NA,NA
"7217","199809140was","Washington Redskins",10,"San Francisco 49ers",45,55,-35,FALSE,"9/14/1998",1998,"September","1990s",78,69,10
"7218","199809200crd","Arizona Cardinals",17,"Philadelphia Eagles",3,20,14,TRUE,"9/20/1998",1998,"September","1990s",90,27,7
"7219","199809200cin","Cincinnati Bengals",6,"Green Bay Packers",13,19,-7,FALSE,"9/20/1998",1998,"September","1990s",74,82,7
"7220","199809200tam","Tampa Bay Buccaneers",27,"Chicago Bears",15,42,12,TRUE,"9/20/1998",1998,"September","1990s",78,94,7
"7221","199809200nyj","New York Jets",44,"Indianapolis Colts",6,50,38,TRUE,"9/20/1998",1998,"September","1990s",73,76,8
"7222","199809200jax","Jacksonville Jaguars",24,"Baltimore Ravens",10,34,14,TRUE,"9/20/1998",1998,"September","1990s",81,90,9
"7223","199809200kan","Kansas City Chiefs",23,"San Diego Chargers",7,30,16,TRUE,"9/20/1998",1998,"September","1990s",71,86,10
"7224","199809200min","Minnesota Vikings",29,"Detroit Lions",6,35,23,TRUE,"9/20/1998",1998,"September","1990s",72,NA,NA
"7225","199809200nwe","New England Patriots",27,"Tennessee Oilers",16,43,11,TRUE,"9/20/1998",1998,"September","1990s",68,87,10
"7226","199809200buf","Buffalo Bills",33,"St. Louis Rams",34,67,-1,FALSE,"9/20/1998",1998,"September","1990s",72,82,10
"7227","199809200mia","Miami Dolphins",21,"Pittsburgh Steelers",0,21,21,TRUE,"9/20/1998",1998,"September","1990s",84,80,8
"7228","199809200rai","Oakland Raiders",17,"Denver Broncos",34,51,-17,FALSE,"9/20/1998",1998,"September","1990s",64,68,10
"7229","199809200sea","Seattle Seahawks",24,"Washington Redskins",14,38,10,TRUE,"9/20/1998",1998,"September","1990s",72,NA,NA
"7230","199809210nyg","New York Giants",7,"Dallas Cowboys",31,38,-24,FALSE,"9/21/1998",1998,"September","1990s",75,76,10
"7231","199809270car","Carolina Panthers",30,"Green Bay Packers",37,67,-7,FALSE,"9/27/1998",1998,"September","1990s",73,75,5
"7232","199809270sfo","San Francisco 49ers",31,"Atlanta Falcons",20,51,11,TRUE,"9/27/1998",1998,"September","1990s",59,82,4
"7233","199809270rav","Baltimore Ravens",31,"Cincinnati Bengals",24,55,7,TRUE,"9/27/1998",1998,"September","1990s",79,60,11
"7234","199809270chi","Chicago Bears",28,"Minnesota Vikings",31,59,-3,FALSE,"9/27/1998",1998,"September","1990s",78,63,12
"7235","199809270phi","Philadelphia Eagles",21,"Kansas City Chiefs",24,45,-3,FALSE,"9/27/1998",1998,"September","1990s",78,70,11
"7236","199809270pit","Pittsburgh Steelers",13,"Seattle Seahawks",10,23,3,TRUE,"9/27/1998",1998,"September","1990s",76,65,11
"7237","199809270clt","Indianapolis Colts",13,"New Orleans Saints",19,32,-6,FALSE,"9/27/1998",1998,"September","1990s",72,NA,NA
"7238","199809270dal","Dallas Cowboys",12,"Oakland Raiders",13,25,-1,FALSE,"9/27/1998",1998,"September","1990s",84,72,9
"7239","199809270was","Washington Redskins",16,"Denver Broncos",38,54,-22,FALSE,"9/27/1998",1998,"September","1990s",80,60,12
"7240","199809270sdg","San Diego Chargers",16,"New York Giants",34,50,-18,FALSE,"9/27/1998",1998,"September","1990s",66,69,7
"7241","199809270ram","St. Louis Rams",17,"Arizona Cardinals",20,37,-3,FALSE,"9/27/1998",1998,"September","1990s",72,NA,NA
"7242","199809270oti","Tennessee Oilers",22,"Jacksonville Jaguars",27,49,-5,FALSE,"9/27/1998",1998,"September","1990s",81,66,6
"7243","199809280det","Detroit Lions",27,"Tampa Bay Buccaneers",6,33,21,TRUE,"9/28/1998",1998,"September","1990s",72,NA,NA
"7244","199810040buf","Buffalo Bills",26,"San Francisco 49ers",21,47,5,TRUE,"10/4/1998",1998,"October","1990s",50,68,9
"7245","199810040nyj","New York Jets",20,"Miami Dolphins",9,29,11,TRUE,"10/4/1998",1998,"October","1990s",55,70,8
"7246","199810040nor","New Orleans Saints",27,"New England Patriots",30,57,-3,FALSE,"10/4/1998",1998,"October","1990s",72,NA,NA
"7247","199810040atl","Atlanta Falcons",51,"Carolina Panthers",23,74,28,TRUE,"10/4/1998",1998,"October","1990s",72,NA,NA
"7248","199810040den","Denver Broncos",41,"Philadelphia Eagles",16,57,25,TRUE,"10/4/1998",1998,"October","1990s",47,85,14
"7249","199810040tam","Tampa Bay Buccaneers",20,"New York Giants",3,23,17,TRUE,"10/4/1998",1998,"October","1990s",80,81,6
"7250","199810040crd","Arizona Cardinals",20,"Oakland Raiders",23,43,-3,FALSE,"10/4/1998",1998,"October","1990s",80,31,10
"7251","199810040chi","Chicago Bears",31,"Detroit Lions",27,58,4,TRUE,"10/4/1998",1998,"October","1990s",58,74,17
"7252","199810040clt","Indianapolis Colts",17,"San Diego Chargers",12,29,5,TRUE,"10/4/1998",1998,"October","1990s",72,NA,NA
"7253","199810040was","Washington Redskins",10,"Dallas Cowboys",31,41,-21,FALSE,"10/4/1998",1998,"October","1990s",56,88,13
"7254","199810040kan","Kansas City Chiefs",17,"Seattle Seahawks",6,23,11,TRUE,"10/4/1998",1998,"October","1990s",57,93,19
"7255","199810050gnb","Green Bay Packers",24,"Minnesota Vikings",37,61,-13,FALSE,"10/5/1998",1998,"October","1990s",54,84,14
"7256","199810110nyg","New York Giants",20,"Atlanta Falcons",34,54,-14,FALSE,"10/11/1998",1998,"October","1990s",64,73,15
"7257","199810110cin","Cincinnati Bengals",25,"Pittsburgh Steelers",20,45,5,TRUE,"10/11/1998",1998,"October","1990s",56,74,6
"7258","199810110rav","Baltimore Ravens",8,"Tennessee Oilers",12,20,-4,FALSE,"10/11/1998",1998,"October","1990s",60,70,9
"7259","199810110dal","Dallas Cowboys",27,"Carolina Panthers",20,47,7,TRUE,"10/11/1998",1998,"October","1990s",68,69,9
"7260","199810110ram","St. Louis Rams",30,"New York Jets",10,40,20,TRUE,"10/11/1998",1998,"October","1990s",72,NA,NA
"7261","199810110clt","Indianapolis Colts",24,"Buffalo Bills",31,55,-7,FALSE,"10/11/1998",1998,"October","1990s",72,NA,NA
"7262","199810110nor","New Orleans Saints",0,"San Francisco 49ers",31,31,-31,FALSE,"10/11/1998",1998,"October","1990s",72,NA,NA
"7263","199810110nwe","New England Patriots",40,"Kansas City Chiefs",10,50,30,TRUE,"10/11/1998",1998,"October","1990s",58,95,18
"7264","199810110sea","Seattle Seahawks",16,"Denver Broncos",21,37,-5,FALSE,"10/11/1998",1998,"October","1990s",72,NA,NA
"7265","199810110crd","Arizona Cardinals",20,"Chicago Bears",7,27,13,TRUE,"10/11/1998",1998,"October","1990s",77,20,5
"7266","199810110rai","Oakland Raiders",7,"San Diego Chargers",6,13,1,TRUE,"10/11/1998",1998,"October","1990s",61,60,7
"7267","199810110phi","Philadelphia Eagles",17,"Washington Redskins",12,29,5,TRUE,"10/11/1998",1998,"October","1990s",63,65,14
"7268","199810120jax","Jacksonville Jaguars",28,"Miami Dolphins",21,49,7,TRUE,"10/12/1998",1998,"October","1990s",80,81,11
"7269","199810150det","Detroit Lions",27,"Green Bay Packers",20,47,7,TRUE,"10/15/1998",1998,"October","1990s",72,NA,NA
"7270","199810180min","Minnesota Vikings",41,"Washington Redskins",7,48,34,TRUE,"10/18/1998",1998,"October","1990s",72,NA,NA
"7271","199810180oti","Tennessee Oilers",44,"Cincinnati Bengals",14,58,30,TRUE,"10/18/1998",1998,"October","1990s",69,61,12
"7272","199810180atl","Atlanta Falcons",31,"New Orleans Saints",23,54,8,TRUE,"10/18/1998",1998,"October","1990s",72,NA,NA
"7273","199810180pit","Pittsburgh Steelers",16,"Baltimore Ravens",6,22,10,TRUE,"10/18/1998",1998,"October","1990s",65,62,11
"7274","199810180tam","Tampa Bay Buccaneers",16,"Carolina Panthers",13,29,3,TRUE,"10/18/1998",1998,"October","1990s",77,76,8
"7275","199810180mia","Miami Dolphins",14,"St. Louis Rams",0,14,14,TRUE,"10/18/1998",1998,"October","1990s",81,68,17
"7276","199810180buf","Buffalo Bills",17,"Jacksonville Jaguars",16,33,1,TRUE,"10/18/1998",1998,"October","1990s",68,56,18
"7277","199810180sdg","San Diego Chargers",13,"Philadelphia Eagles",10,23,3,TRUE,"10/18/1998",1998,"October","1990s",66,38,8
"7278","199810180chi","Chicago Bears",13,"Dallas Cowboys",12,25,1,TRUE,"10/18/1998",1998,"October","1990s",58,85,16
"7279","199810180nyg","New York Giants",34,"Arizona Cardinals",7,41,27,TRUE,"10/18/1998",1998,"October","1990s",64,72,11
"7280","199810180sfo","San Francisco 49ers",34,"Indianapolis Colts",31,65,3,TRUE,"10/18/1998",1998,"October","1990s",58,67,12
"7281","199810190nwe","New England Patriots",14,"New York Jets",24,38,-10,FALSE,"10/19/1998",1998,"October","1990s",64,63,18
"7282","199810250car","Carolina Panthers",14,"Buffalo Bills",30,44,-16,FALSE,"10/25/1998",1998,"October","1990s",55,63,2
"7283","199810250rai","Oakland Raiders",27,"Cincinnati Bengals",10,37,17,TRUE,"10/25/1998",1998,"October","1990s",61,64,10
"7284","199810250nor","New Orleans Saints",9,"Tampa Bay Buccaneers",3,12,6,TRUE,"10/25/1998",1998,"October","1990s",72,NA,NA
"7285","199810250nyj","New York Jets",28,"Atlanta Falcons",3,31,25,TRUE,"10/25/1998",1998,"October","1990s",64,46,11
"7286","199810250mia","Miami Dolphins",12,"New England Patriots",9,21,3,TRUE,"10/25/1998",1998,"October","1990s",78,64,14
"7287","199810250gnb","Green Bay Packers",28,"Baltimore Ravens",10,38,18,TRUE,"10/25/1998",1998,"October","1990s",52,77,7
"7288","199810250den","Denver Broncos",37,"Jacksonville Jaguars",24,61,13,TRUE,"10/25/1998",1998,"October","1990s",50,46,10
"7289","199810250det","Detroit Lions",13,"Minnesota Vikings",34,47,-21,FALSE,"10/25/1998",1998,"October","1990s",72,NA,NA
"7290","199810250ram","St. Louis Rams",10,"San Francisco 49ers",28,38,-18,FALSE,"10/25/1998",1998,"October","1990s",72,NA,NA
"7291","199810250sdg","San Diego Chargers",20,"Seattle Seahawks",27,47,-7,FALSE,"10/25/1998",1998,"October","1990s",65,80,8
"7292","199810250oti","Tennessee Oilers",20,"Chicago Bears",23,43,-3,FALSE,"10/25/1998",1998,"October","1990s",57,55,3
"7293","199810260kan","Kansas City Chiefs",13,"Pittsburgh Steelers",20,33,-7,FALSE,"10/26/1998",1998,"October","1990s",63,78,12
"7294","199811010was","Washington Redskins",21,"New York Giants",14,35,7,TRUE,"11/1/1998",1998,"November","1990s",55,48,9
"7295","199811010tam","Tampa Bay Buccaneers",27,"Minnesota Vikings",24,51,3,TRUE,"11/1/1998",1998,"November","1990s",73,89,4
"7296","199811010atl","Atlanta Falcons",37,"St. Louis Rams",15,52,22,TRUE,"11/1/1998",1998,"November","1990s",72,NA,NA
"7297","199811010rav","Baltimore Ravens",19,"Jacksonville Jaguars",45,64,-26,FALSE,"11/1/1998",1998,"November","1990s",48,52,6
"7298","199811010buf","Buffalo Bills",30,"Miami Dolphins",24,54,6,TRUE,"11/1/1998",1998,"November","1990s",44,71,7
"7299","199811010gnb","Green Bay Packers",36,"San Francisco 49ers",22,58,14,TRUE,"11/1/1998",1998,"November","1990s",49,73,12
"7300","199811010det","Detroit Lions",15,"Arizona Cardinals",17,32,-2,FALSE,"11/1/1998",1998,"November","1990s",72,NA,NA
"7301","199811010cin","Cincinnati Bengals",26,"Denver Broncos",33,59,-7,FALSE,"11/1/1998",1998,"November","1990s",55,75,7
"7302","199811010pit","Pittsburgh Steelers",31,"Tennessee Oilers",41,72,-10,FALSE,"11/1/1998",1998,"November","1990s",47,56,6
"7303","199811010car","Carolina Panthers",31,"New Orleans Saints",17,48,14,TRUE,"11/1/1998",1998,"November","1990s",61,63,6
"7304","199811010sea","Seattle Seahawks",18,"Oakland Raiders",31,49,-13,FALSE,"11/1/1998",1998,"November","1990s",72,NA,NA
"7305","199811010clt","Indianapolis Colts",16,"New England Patriots",21,37,-5,FALSE,"11/1/1998",1998,"November","1990s",72,NA,NA
"7306","199811010kan","Kansas City Chiefs",17,"New York Jets",20,37,-3,FALSE,"11/1/1998",1998,"November","1990s",49,97,19
"7307","199811020phi","Philadelphia Eagles",0,"Dallas Cowboys",34,34,-34,FALSE,"11/2/1998",1998,"November","1990s",50,56,11
"7308","199811080sea","Seattle Seahawks",24,"Kansas City Chiefs",12,36,12,TRUE,"11/8/1998",1998,"November","1990s",72,NA,NA
"7309","199811080mia","Miami Dolphins",27,"Indianapolis Colts",14,41,13,TRUE,"11/8/1998",1998,"November","1990s",74,68,11
"7310","199811080jax","Jacksonville Jaguars",24,"Cincinnati Bengals",11,35,13,TRUE,"11/8/1998",1998,"November","1990s",66,71,7
"7311","199811080phi","Philadelphia Eagles",10,"Detroit Lions",9,19,1,TRUE,"11/8/1998",1998,"November","1990s",48,60,10
"7312","199811080sfo","San Francisco 49ers",25,"Carolina Panthers",23,48,2,TRUE,"11/8/1998",1998,"November","1990s",53,81,9
"7313","199811080den","Denver Broncos",27,"San Diego Chargers",10,37,17,TRUE,"11/8/1998",1998,"November","1990s",31,86,8
"7314","199811080dal","Dallas Cowboys",16,"New York Giants",6,22,10,TRUE,"11/8/1998",1998,"November","1990s",50,96,6
"7315","199811080nyj","New York Jets",34,"Buffalo Bills",12,46,22,TRUE,"11/8/1998",1998,"November","1990s",46,61,13
"7316","199811080rav","Baltimore Ravens",13,"Oakland Raiders",10,23,3,TRUE,"11/8/1998",1998,"November","1990s",45,62,6
"7317","199811080tam","Tampa Bay Buccaneers",22,"Tennessee Oilers",31,53,-9,FALSE,"11/8/1998",1998,"November","1990s",68,71,7
"7318","199811080min","Minnesota Vikings",31,"New Orleans Saints",24,55,7,TRUE,"11/8/1998",1998,"November","1990s",72,NA,NA
"7319","199811080nwe","New England Patriots",10,"Atlanta Falcons",41,51,-31,FALSE,"11/8/1998",1998,"November","1990s",44,69,9
"7320","199811080chi","Chicago Bears",12,"St. Louis Rams",20,32,-8,FALSE,"11/8/1998",1998,"November","1990s",36,81,4
"7321","199811080crd","Arizona Cardinals",29,"Washington Redskins",27,56,2,TRUE,"11/8/1998",1998,"November","1990s",65,42,7
"7322","199811090pit","Pittsburgh Steelers",27,"Green Bay Packers",20,47,7,TRUE,"11/9/1998",1998,"November","1990s",44,62,4
"7323","199811150det","Detroit Lions",26,"Chicago Bears",3,29,23,TRUE,"11/15/1998",1998,"November","1990s",72,NA,NA
"7324","199811150nyg","New York Giants",3,"Green Bay Packers",37,40,-34,FALSE,"11/15/1998",1998,"November","1990s",54,63,15
"7325","199811150oti","Tennessee Oilers",23,"Pittsburgh Steelers",14,37,9,TRUE,"11/15/1998",1998,"November","1990s",58,77,6
"7326","199811150sdg","San Diego Chargers",14,"Baltimore Ravens",13,27,1,TRUE,"11/15/1998",1998,"November","1990s",58,74,6
"7327","199811150min","Minnesota Vikings",24,"Cincinnati Bengals",3,27,21,TRUE,"11/15/1998",1998,"November","1990s",72,NA,NA
"7328","199811150nor","New Orleans Saints",24,"St. Louis Rams",3,27,21,TRUE,"11/15/1998",1998,"November","1990s",72,NA,NA
"7329","199811150was","Washington Redskins",28,"Philadelphia Eagles",3,31,25,TRUE,"11/15/1998",1998,"November","1990s",56,67,12
"7330","199811150atl","Atlanta Falcons",31,"San Francisco 49ers",19,50,12,TRUE,"11/15/1998",1998,"November","1990s",72,NA,NA
"7331","199811150rai","Oakland Raiders",20,"Seattle Seahawks",17,37,3,TRUE,"11/15/1998",1998,"November","1990s",58,65,10
"7332","199811150clt","Indianapolis Colts",24,"New York Jets",23,47,1,TRUE,"11/15/1998",1998,"November","1990s",72,NA,NA
"7333","199811150jax","Jacksonville Jaguars",29,"Tampa Bay Buccaneers",24,53,5,TRUE,"11/15/1998",1998,"November","1990s",72,81,6
"7334","199811150car","Carolina Panthers",9,"Miami Dolphins",13,22,-4,FALSE,"11/15/1998",1998,"November","1990s",55,90,4
"7335","199811150crd","Arizona Cardinals",28,"Dallas Cowboys",35,63,-7,FALSE,"11/15/1998",1998,"November","1990s",64,43,4
"7336","199811150buf","Buffalo Bills",13,"New England Patriots",10,23,3,TRUE,"11/15/1998",1998,"November","1990s",46,63,18
"7337","199811160kan","Kansas City Chiefs",7,"Denver Broncos",30,37,-23,FALSE,"11/16/1998",1998,"November","1990s",53,71,14
"7338","199811220atl","Atlanta Falcons",20,"Chicago Bears",13,33,7,TRUE,"11/22/1998",1998,"November","1990s",72,NA,NA
"7339","199811220pit","Pittsburgh Steelers",30,"Jacksonville Jaguars",15,45,15,TRUE,"11/22/1998",1998,"November","1990s",36,60,7
"7340","199811220sdg","San Diego Chargers",38,"Kansas City Chiefs",37,75,1,TRUE,"11/22/1998",1998,"November","1990s",59,60,6
"7341","199811220min","Minnesota Vikings",28,"Green Bay Packers",14,42,14,TRUE,"11/22/1998",1998,"November","1990s",72,NA,NA
"7342","199811220sfo","San Francisco 49ers",31,"New Orleans Saints",20,51,11,TRUE,"11/22/1998",1998,"November","1990s",56,90,10
"7343","199811220buf","Buffalo Bills",34,"Indianapolis Colts",11,45,23,TRUE,"11/22/1998",1998,"November","1990s",38,61,14
"7344","199811220den","Denver Broncos",40,"Oakland Raiders",14,54,26,TRUE,"11/22/1998",1998,"November","1990s",56,30,15
"7345","199811220dal","Dallas Cowboys",30,"Seattle Seahawks",22,52,8,TRUE,"11/22/1998",1998,"November","1990s",54,68,12
"7346","199811220oti","Tennessee Oilers",3,"New York Jets",24,27,-21,FALSE,"11/22/1998",1998,"November","1990s",44,62,7
"7347","199811220nyg","New York Giants",20,"Philadelphia Eagles",0,20,20,TRUE,"11/22/1998",1998,"November","1990s",43,55,14
"7348","199811220was","Washington Redskins",42,"Arizona Cardinals",45,87,-3,FALSE,"11/22/1998",1998,"November","1990s",41,57,9
"7349","199811220tam","Tampa Bay Buccaneers",25,"Detroit Lions",28,53,-3,FALSE,"11/22/1998",1998,"November","1990s",74,80,8
"7350","199811220ram","St. Louis Rams",20,"Carolina Panthers",24,44,-4,FALSE,"11/22/1998",1998,"November","1990s",72,NA,NA
"7351","199811220cin","Cincinnati Bengals",13,"Baltimore Ravens",20,33,-7,FALSE,"11/22/1998",1998,"November","1990s",38,64,8
"7352","199811230nwe","New England Patriots",26,"Miami Dolphins",23,49,3,TRUE,"11/23/1998",1998,"November","1990s",46,66,17
"7353","199811260dal","Dallas Cowboys",36,"Minnesota Vikings",46,82,-10,FALSE,"11/26/1998",1998,"November","1990s",58,61,7
"7354","199811260det","Detroit Lions",19,"Pittsburgh Steelers",16,35,3,TRUE,"11/26/1998",1998,"November","1990s",72,NA,NA
"7355","199811290gnb","Green Bay Packers",24,"Philadelphia Eagles",16,40,8,TRUE,"11/29/1998",1998,"November","1990s",52,91,9
"7356","199811290cin","Cincinnati Bengals",17,"Jacksonville Jaguars",34,51,-17,FALSE,"11/29/1998",1998,"November","1990s",57,72,9
"7357","199811290sea","Seattle Seahawks",20,"Tennessee Oilers",18,38,2,TRUE,"11/29/1998",1998,"November","1990s",72,NA,NA
"7358","199811290mia","Miami Dolphins",30,"New Orleans Saints",10,40,20,TRUE,"11/29/1998",1998,"November","1990s",74,69,9
"7359","199811290nwe","New England Patriots",25,"Buffalo Bills",21,46,4,TRUE,"11/29/1998",1998,"November","1990s",43,76,8
"7360","199811290nyj","New York Jets",48,"Carolina Panthers",21,69,27,TRUE,"11/29/1998",1998,"November","1990s",53,71,8
"7361","199811290rav","Baltimore Ravens",38,"Indianapolis Colts",31,69,7,TRUE,"11/29/1998",1998,"November","1990s",53,50,5
"7362","199811290chi","Chicago Bears",17,"Tampa Bay Buccaneers",31,48,-14,FALSE,"11/29/1998",1998,"November","1990s",62,86,14
"7363","199811290sdg","San Diego Chargers",16,"Denver Broncos",31,47,-15,FALSE,"11/29/1998",1998,"November","1990s",58,70,14
"7364","199811290ram","St. Louis Rams",10,"Atlanta Falcons",21,31,-11,FALSE,"11/29/1998",1998,"November","1990s",72,NA,NA
"7365","199811290kan","Kansas City Chiefs",34,"Arizona Cardinals",24,58,10,TRUE,"11/29/1998",1998,"November","1990s",66,82,23
"7366","199811290rai","Oakland Raiders",19,"Washington Redskins",29,48,-10,FALSE,"11/29/1998",1998,"November","1990s",54,66,20
"7367","199811300sfo","San Francisco 49ers",31,"New York Giants",7,38,24,TRUE,"11/30/1998",1998,"November","1990s",57,89,24
"7368","199812030phi","Philadelphia Eagles",17,"St. Louis Rams",14,31,3,TRUE,"12/3/1998",1998,"December","1990s",54,56,12
"7369","199812060rai","Oakland Raiders",17,"Miami Dolphins",27,44,-10,FALSE,"12/6/1998",1998,"December","1990s",50,51,18
"7370","199812060oti","Tennessee Oilers",16,"Baltimore Ravens",14,30,2,TRUE,"12/6/1998",1998,"December","1990s",65,83,11
"7371","199812060pit","Pittsburgh Steelers",9,"New England Patriots",23,32,-14,FALSE,"12/6/1998",1998,"December","1990s",63,81,11
"7372","199812060was","Washington Redskins",24,"San Diego Chargers",20,44,4,TRUE,"12/6/1998",1998,"December","1990s",62,76,9
"7373","199812060jax","Jacksonville Jaguars",37,"Detroit Lions",22,59,15,TRUE,"12/6/1998",1998,"December","1990s",73,76,7
"7374","199812060min","Minnesota Vikings",48,"Chicago Bears",22,70,26,TRUE,"12/6/1998",1998,"December","1990s",72,NA,NA
"7375","199812060car","Carolina Panthers",28,"San Francisco 49ers",31,59,-3,FALSE,"12/6/1998",1998,"December","1990s",65,80,6
"7376","199812060crd","Arizona Cardinals",19,"New York Giants",23,42,-4,FALSE,"12/6/1998",1998,"December","1990s",45,62,10
"7377","199812060cin","Cincinnati Bengals",20,"Buffalo Bills",33,53,-13,FALSE,"12/6/1998",1998,"December","1990s",66,82,14
"7378","199812060den","Denver Broncos",35,"Kansas City Chiefs",31,66,4,TRUE,"12/6/1998",1998,"December","1990s",25,83,8
"7379","199812060nyj","New York Jets",32,"Seattle Seahawks",31,63,1,TRUE,"12/6/1998",1998,"December","1990s",54,82,7
"7380","199812060atl","Atlanta Falcons",28,"Indianapolis Colts",21,49,7,TRUE,"12/6/1998",1998,"December","1990s",72,NA,NA
"7381","199812060nor","New Orleans Saints",22,"Dallas Cowboys",3,25,19,TRUE,"12/6/1998",1998,"December","1990s",72,NA,NA
"7382","199812070tam","Tampa Bay Buccaneers",24,"Green Bay Packers",22,46,2,TRUE,"12/7/1998",1998,"December","1990s",73,77,7
"7383","199812130ram","St. Louis Rams",32,"New England Patriots",18,50,14,TRUE,"12/13/1998",1998,"December","1990s",72,NA,NA
"7384","199812130nyg","New York Giants",20,"Denver Broncos",16,36,4,TRUE,"12/13/1998",1998,"December","1990s",44,56,8
"7385","199812130gnb","Green Bay Packers",26,"Chicago Bears",20,46,6,TRUE,"12/13/1998",1998,"December","1990s",31,77,6
"7386","199812130clt","Indianapolis Colts",39,"Cincinnati Bengals",26,65,13,TRUE,"12/13/1998",1998,"December","1990s",72,NA,NA
"7387","199812130rav","Baltimore Ravens",28,"Minnesota Vikings",38,66,-10,FALSE,"12/13/1998",1998,"December","1990s",42,80,5
"7388","199812130kan","Kansas City Chiefs",20,"Dallas Cowboys",17,37,3,TRUE,"12/13/1998",1998,"December","1990s",41,62,5
"7389","199812130car","Carolina Panthers",25,"Washington Redskins",28,53,-3,FALSE,"12/13/1998",1998,"December","1990s",43,96,8
"7390","199812130tam","Tampa Bay Buccaneers",16,"Pittsburgh Steelers",3,19,13,TRUE,"12/13/1998",1998,"December","1990s",74,94,10
"7391","199812130sea","Seattle Seahawks",38,"San Diego Chargers",17,55,21,TRUE,"12/13/1998",1998,"December","1990s",72,NA,NA
"7392","199812130phi","Philadelphia Eagles",17,"Arizona Cardinals",20,37,-3,FALSE,"12/13/1998",1998,"December","1990s",43,60,7
"7393","199812130buf","Buffalo Bills",44,"Oakland Raiders",21,65,23,TRUE,"12/13/1998",1998,"December","1990s",38,66,11
"7394","199812130mia","Miami Dolphins",16,"New York Jets",21,37,-5,FALSE,"12/13/1998",1998,"December","1990s",78,74,12
"7395","199812130jax","Jacksonville Jaguars",13,"Tennessee Oilers",16,29,-3,FALSE,"12/13/1998",1998,"December","1990s",73,90,11
"7396","199812130nor","New Orleans Saints",17,"Atlanta Falcons",27,44,-10,FALSE,"12/13/1998",1998,"December","1990s",72,NA,NA
"7397","199812140sfo","San Francisco 49ers",35,"Detroit Lions",13,48,22,TRUE,"12/14/1998",1998,"December","1990s",51,81,14
"7398","199812190buf","Buffalo Bills",10,"New York Jets",17,27,-7,FALSE,"12/19/1998",1998,"December","1990s",39,71,20
"7399","199812190was","Washington Redskins",20,"Tampa Bay Buccaneers",16,36,4,TRUE,"12/19/1998",1998,"December","1990s",44,47,16
"7400","199812200dal","Dallas Cowboys",13,"Philadelphia Eagles",9,22,4,TRUE,"12/20/1998",1998,"December","1990s",44,98,8
"7401","199812200car","Carolina Panthers",20,"St. Louis Rams",13,33,7,TRUE,"12/20/1998",1998,"December","1990s",48,97,3
"7402","199812200gnb","Green Bay Packers",30,"Tennessee Oilers",22,52,8,TRUE,"12/20/1998",1998,"December","1990s",25,75,11
"7403","199812200pit","Pittsburgh Steelers",24,"Cincinnati Bengals",25,49,-1,FALSE,"12/20/1998",1998,"December","1990s",41,82,4
"7404","199812200sea","Seattle Seahawks",27,"Indianapolis Colts",23,50,4,TRUE,"12/20/1998",1998,"December","1990s",72,NA,NA
"7405","199812200sdg","San Diego Chargers",10,"Oakland Raiders",17,27,-7,FALSE,"12/20/1998",1998,"December","1990s",55,73,12
"7406","199812200nwe","New England Patriots",24,"San Francisco 49ers",21,45,3,TRUE,"12/20/1998",1998,"December","1990s",46,69,12
"7407","199812200chi","Chicago Bears",24,"Baltimore Ravens",3,27,21,TRUE,"12/20/1998",1998,"December","1990s",32,73,7
"7408","199812200det","Detroit Lions",17,"Atlanta Falcons",24,41,-7,FALSE,"12/20/1998",1998,"December","1990s",72,NA,NA
"7409","199812200crd","Arizona Cardinals",19,"New Orleans Saints",17,36,2,TRUE,"12/20/1998",1998,"December","1990s",57,63,6
"7410","199812200nyg","New York Giants",28,"Kansas City Chiefs",7,35,21,TRUE,"12/20/1998",1998,"December","1990s",49,59,9
"7411","199812200min","Minnesota Vikings",50,"Jacksonville Jaguars",10,60,40,TRUE,"12/20/1998",1998,"December","1990s",72,NA,NA
"7412","199812210mia","Miami Dolphins",31,"Denver Broncos",21,52,10,TRUE,"12/21/1998",1998,"December","1990s",76,81,11
"7413","199812260rai","Oakland Raiders",24,"Kansas City Chiefs",31,55,-7,FALSE,"12/26/1998",1998,"December","1990s",48,51,11
"7414","199812260oti","Tennessee Oilers",16,"Minnesota Vikings",26,42,-10,FALSE,"12/26/1998",1998,"December","1990s",31,82,7
"7415","199812270nor","New Orleans Saints",33,"Buffalo Bills",45,78,-12,FALSE,"12/27/1998",1998,"December","1990s",72,NA,NA
"7416","199812270rav","Baltimore Ravens",19,"Detroit Lions",10,29,9,TRUE,"12/27/1998",1998,"December","1990s",26,72,5
"7417","199812270sfo","San Francisco 49ers",38,"St. Louis Rams",19,57,19,TRUE,"12/27/1998",1998,"December","1990s",46,97,5
"7418","199812270clt","Indianapolis Colts",19,"Carolina Panthers",27,46,-8,FALSE,"12/27/1998",1998,"December","1990s",72,NA,NA
"7419","199812270den","Denver Broncos",28,"Seattle Seahawks",21,49,7,TRUE,"12/27/1998",1998,"December","1990s",36,47,13
"7420","199812270dal","Dallas Cowboys",23,"Washington Redskins",7,30,16,TRUE,"12/27/1998",1998,"December","1990s",45,72,12
"7421","199812270phi","Philadelphia Eagles",10,"New York Giants",20,30,-10,FALSE,"12/27/1998",1998,"December","1990s",29,68,7
"7422","199812270crd","Arizona Cardinals",16,"San Diego Chargers",13,29,3,TRUE,"12/27/1998",1998,"December","1990s",53,39,4
"7423","199812270nyj","New York Jets",31,"New England Patriots",10,41,21,TRUE,"12/27/1998",1998,"December","1990s",34,45,9
"7424","199812270atl","Atlanta Falcons",38,"Miami Dolphins",16,54,22,TRUE,"12/27/1998",1998,"December","1990s",72,NA,NA
"7425","199812270cin","Cincinnati Bengals",0,"Tampa Bay Buccaneers",35,35,-35,FALSE,"12/27/1998",1998,"December","1990s",32,75,10
"7426","199812270chi","Chicago Bears",13,"Green Bay Packers",16,29,-3,FALSE,"12/27/1998",1998,"December","1990s",33,60,14
"7427","199812280jax","Jacksonville Jaguars",21,"Pittsburgh Steelers",3,24,18,TRUE,"12/28/1998",1998,"December","1990s",57,85,8
"7428","199901020dal","Dallas Cowboys",7,"Arizona Cardinals",20,27,-13,FALSE,"1/2/1999",1999,"January","1990s",43,71,24
"7429","199901020mia","Miami Dolphins",24,"Buffalo Bills",17,41,7,TRUE,"1/2/1999",1999,"January","1990s",75,80,14
"7430","199901030jax","Jacksonville Jaguars",25,"New England Patriots",10,35,15,TRUE,"1/3/1999",1999,"January","1990s",64,89,12
"7431","199901030sfo","San Francisco 49ers",30,"Green Bay Packers",27,57,3,TRUE,"1/3/1999",1999,"January","1990s",54,56,12
"7432","199901090atl","Atlanta Falcons",20,"San Francisco 49ers",18,38,2,TRUE,"1/9/1999",1999,"January","1990s",72,NA,NA
"7433","199901090den","Denver Broncos",38,"Miami Dolphins",3,41,35,TRUE,"1/9/1999",1999,"January","1990s",29,62,14
"7434","199901100min","Minnesota Vikings",41,"Arizona Cardinals",21,62,20,TRUE,"1/10/1999",1999,"January","1990s",72,NA,NA
"7435","199901100nyj","New York Jets",34,"Jacksonville Jaguars",24,58,10,TRUE,"1/10/1999",1999,"January","1990s",28,53,16
"7436","199901170min","Minnesota Vikings",27,"Atlanta Falcons",30,57,-3,FALSE,"1/17/1999",1999,"January","1990s",72,NA,NA
"7437","199901170den","Denver Broncos",23,"New York Jets",10,33,13,TRUE,"1/17/1999",1999,"January","1990s",37,36,20
"7438","199901310atl","Atlanta Falcons",19,"Denver Broncos",34,53,-15,FALSE,"1/31/1999",1999,"January","1990s",74,67,11
"7439","199909120atl","Atlanta Falcons",14,"Minnesota Vikings",17,31,-3,FALSE,"9/12/1999",1999,"September","1990s",72,NA,NA
"7440","199909120jax","Jacksonville Jaguars",41,"San Francisco 49ers",3,44,38,TRUE,"9/12/1999",1999,"September","1990s",80,81,12
"7441","199909120oti","Tennessee Titans",36,"Cincinnati Bengals",35,71,1,TRUE,"9/12/1999",1999,"September","1990s",79,46,7
"7442","199909120phi","Philadelphia Eagles",24,"Arizona Cardinals",25,49,-1,FALSE,"9/12/1999",1999,"September","1990s",70,64,6
"7443","199909120clt","Indianapolis Colts",31,"Buffalo Bills",14,45,17,TRUE,"9/12/1999",1999,"September","1990s",72,NA,NA
"7444","199909120chi","Chicago Bears",20,"Kansas City Chiefs",17,37,3,TRUE,"9/12/1999",1999,"September","1990s",68,69,10
"7445","199909120nyj","New York Jets",28,"New England Patriots",30,58,-2,FALSE,"9/12/1999",1999,"September","1990s",73,50,8
"7446","199909120nor","New Orleans Saints",19,"Carolina Panthers",10,29,9,TRUE,"9/12/1999",1999,"September","1990s",72,NA,NA
"7447","199909120tam","Tampa Bay Buccaneers",13,"New York Giants",17,30,-4,FALSE,"9/12/1999",1999,"September","1990s",81,82,7
"7448","199909120cle","Cleveland Browns",0,"Pittsburgh Steelers",43,43,-43,FALSE,"9/12/1999",1999,"September","1990s",70,54,10
"7449","199909120ram","St. Louis Rams",27,"Baltimore Ravens",10,37,17,TRUE,"9/12/1999",1999,"September","1990s",72,NA,NA
"7450","199909120sea","Seattle Seahawks",20,"Detroit Lions",28,48,-8,FALSE,"9/12/1999",1999,"September","1990s",72,NA,NA
"7451","199909120gnb","Green Bay Packers",28,"Oakland Raiders",24,52,4,TRUE,"9/12/1999",1999,"September","1990s",61,84,9
"7452","199909120was","Washington Redskins",35,"Dallas Cowboys",41,76,-6,FALSE,"9/12/1999",1999,"September","1990s",71,59,5
"7453","199909130den","Denver Broncos",21,"Miami Dolphins",38,59,-17,FALSE,"9/13/1999",1999,"September","1990s",50,65,7
"7454","199909190cin","Cincinnati Bengals",7,"San Diego Chargers",34,41,-27,FALSE,"9/19/1999",1999,"September","1990s",67,44,5
"7455","199909190kan","Kansas City Chiefs",26,"Denver Broncos",10,36,16,TRUE,"9/19/1999",1999,"September","1990s",66,87,10
"7456","199909190car","Carolina Panthers",20,"Jacksonville Jaguars",22,42,-2,FALSE,"9/19/1999",1999,"September","1990s",66,67,5
"7457","199909190mia","Miami Dolphins",19,"Arizona Cardinals",16,35,3,TRUE,"9/19/1999",1999,"September","1990s",79,86,9
"7458","199909190sfo","San Francisco 49ers",28,"New Orleans Saints",21,49,7,TRUE,"9/19/1999",1999,"September","1990s",61,74,9
"7459","199909190oti","Tennessee Titans",26,"Cleveland Browns",9,35,17,TRUE,"9/19/1999",1999,"September","1990s",72,54,6
"7460","199909190chi","Chicago Bears",13,"Seattle Seahawks",14,27,-1,FALSE,"9/19/1999",1999,"September","1990s",64,62,9
"7461","199909190nwe","New England Patriots",31,"Indianapolis Colts",28,59,3,TRUE,"9/19/1999",1999,"September","1990s",60,65,9
"7462","199909190min","Minnesota Vikings",17,"Oakland Raiders",22,39,-5,FALSE,"9/19/1999",1999,"September","1990s",72,NA,NA
"7463","199909190rav","Baltimore Ravens",20,"Pittsburgh Steelers",23,43,-3,FALSE,"9/19/1999",1999,"September","1990s",62,74,4
"7464","199909190det","Detroit Lions",23,"Green Bay Packers",15,38,8,TRUE,"9/19/1999",1999,"September","1990s",72,NA,NA
"7465","199909190nyg","New York Giants",21,"Washington Redskins",50,71,-29,FALSE,"9/19/1999",1999,"September","1990s",68,60,9
"7466","199909190phi","Philadelphia Eagles",5,"Tampa Bay Buccaneers",19,24,-14,FALSE,"9/19/1999",1999,"September","1990s",64,76,4
"7467","199909190buf","Buffalo Bills",17,"New York Jets",3,20,14,TRUE,"9/19/1999",1999,"September","1990s",62,63,5
"7468","199909200dal","Dallas Cowboys",24,"Atlanta Falcons",7,31,17,TRUE,"9/20/1999",1999,"September","1990s",83,46,11
"7469","199909260nwe","New England Patriots",16,"New York Giants",14,30,2,TRUE,"9/26/1999",1999,"September","1990s",58,73,10
"7470","199909260gnb","Green Bay Packers",23,"Minnesota Vikings",20,43,3,TRUE,"9/26/1999",1999,"September","1990s",68,58,16
"7471","199909260ram","St. Louis Rams",35,"Atlanta Falcons",7,42,28,TRUE,"9/26/1999",1999,"September","1990s",72,NA,NA
"7472","199909260kan","Kansas City Chiefs",31,"Detroit Lions",21,52,10,TRUE,"9/26/1999",1999,"September","1990s",68,75,11
"7473","199909260jax","Jacksonville Jaguars",19,"Tennessee Titans",20,39,-1,FALSE,"9/26/1999",1999,"September","1990s",76,90,8
"7474","199909260buf","Buffalo Bills",26,"Philadelphia Eagles",0,26,26,TRUE,"9/26/1999",1999,"September","1990s",60,66,7
"7475","199909260tam","Tampa Bay Buccaneers",13,"Denver Broncos",10,23,3,TRUE,"9/26/1999",1999,"September","1990s",78,90,7
"7476","199909260nyj","New York Jets",20,"Washington Redskins",27,47,-7,FALSE,"9/26/1999",1999,"September","1990s",63,62,9
"7477","199909260car","Carolina Panthers",27,"Cincinnati Bengals",3,30,24,TRUE,"9/26/1999",1999,"September","1990s",70,80,6
"7478","199909260pit","Pittsburgh Steelers",10,"Seattle Seahawks",29,39,-19,FALSE,"9/26/1999",1999,"September","1990s",64,56,6
"7479","199909260rai","Oakland Raiders",24,"Chicago Bears",17,41,7,TRUE,"9/26/1999",1999,"September","1990s",69,54,9
"7480","199909260rav","Baltimore Ravens",17,"Cleveland Browns",10,27,7,TRUE,"9/26/1999",1999,"September","1990s",67,78,8
"7481","199909260sdg","San Diego Chargers",19,"Indianapolis Colts",27,46,-8,FALSE,"9/26/1999",1999,"September","1990s",63,91,6
"7482","199909270crd","Arizona Cardinals",10,"San Francisco 49ers",24,34,-14,FALSE,"9/27/1999",1999,"September","1990s",87,33,7
"7483","199910030atl","Atlanta Falcons",13,"Baltimore Ravens",19,32,-6,FALSE,"10/3/1999",1999,"October","1990s",72,NA,NA
"7484","199910030chi","Chicago Bears",14,"New Orleans Saints",10,24,4,TRUE,"10/3/1999",1999,"October","1990s",44,81,8
"7485","199910030cin","Cincinnati Bengals",10,"St. Louis Rams",38,48,-28,FALSE,"10/3/1999",1999,"October","1990s",62,57,12
"7486","199910030sdg","San Diego Chargers",21,"Kansas City Chiefs",14,35,7,TRUE,"10/3/1999",1999,"October","1990s",65,80,10
"7487","199910030cle","Cleveland Browns",7,"New England Patriots",19,26,-12,FALSE,"10/3/1999",1999,"October","1990s",56,68,14
"7488","199910030pit","Pittsburgh Steelers",3,"Jacksonville Jaguars",17,20,-14,FALSE,"10/3/1999",1999,"October","1990s",60,66,9
"7489","199910030min","Minnesota Vikings",21,"Tampa Bay Buccaneers",14,35,7,TRUE,"10/3/1999",1999,"October","1990s",72,NA,NA
"7490","199910030nyg","New York Giants",16,"Philadelphia Eagles",15,31,1,TRUE,"10/3/1999",1999,"October","1990s",67,71,12
"7491","199910030sfo","San Francisco 49ers",24,"Tennessee Titans",22,46,2,TRUE,"10/3/1999",1999,"October","1990s",60,78,9
"7492","199910030was","Washington Redskins",38,"Carolina Panthers",36,74,2,TRUE,"10/3/1999",1999,"October","1990s",66,74,8
"7493","199910030dal","Dallas Cowboys",35,"Arizona Cardinals",7,42,28,TRUE,"10/3/1999",1999,"October","1990s",78,54,10
"7494","199910030sea","Seattle Seahawks",22,"Oakland Raiders",21,43,1,TRUE,"10/3/1999",1999,"October","1990s",72,NA,NA
"7495","199910030den","Denver Broncos",13,"New York Jets",21,34,-8,FALSE,"10/3/1999",1999,"October","1990s",41,75,11
"7496","199910040mia","Miami Dolphins",18,"Buffalo Bills",23,41,-5,FALSE,"10/4/1999",1999,"October","1990s",82,83,13
"7497","199910100ram","St. Louis Rams",42,"San Francisco 49ers",20,62,22,TRUE,"10/10/1999",1999,"October","1990s",72,NA,NA
"7498","199910100clt","Indianapolis Colts",31,"Miami Dolphins",34,65,-3,FALSE,"10/10/1999",1999,"October","1990s",72,NA,NA
"7499","199910100det","Detroit Lions",10,"San Diego Chargers",20,30,-10,FALSE,"10/10/1999",1999,"October","1990s",72,NA,NA
"7500","199910100phi","Philadelphia Eagles",13,"Dallas Cowboys",10,23,3,TRUE,"10/10/1999",1999,"October","1990s",64,98,11
"7501","199910100gnb","Green Bay Packers",26,"Tampa Bay Buccaneers",23,49,3,TRUE,"10/10/1999",1999,"October","1990s",58,74,10
"7502","199910100rai","Oakland Raiders",13,"Denver Broncos",16,29,-3,FALSE,"10/10/1999",1999,"October","1990s",71,57,10
"7503","199910100crd","Arizona Cardinals",14,"New York Giants",3,17,11,TRUE,"10/10/1999",1999,"October","1990s",84,24,6
"7504","199910100min","Minnesota Vikings",22,"Chicago Bears",24,46,-2,FALSE,"10/10/1999",1999,"October","1990s",72,NA,NA
"7505","199910100nor","New Orleans Saints",17,"Atlanta Falcons",20,37,-3,FALSE,"10/10/1999",1999,"October","1990s",72,NA,NA
"7506","199910100oti","Tennessee Titans",14,"Baltimore Ravens",11,25,3,TRUE,"10/10/1999",1999,"October","1990s",71,83,8
"7507","199910100cle","Cleveland Browns",17,"Cincinnati Bengals",18,35,-1,FALSE,"10/10/1999",1999,"October","1990s",62,94,6
"7508","199910100buf","Buffalo Bills",24,"Pittsburgh Steelers",21,45,3,TRUE,"10/10/1999",1999,"October","1990s",60,92,8
"7509","199910100kan","Kansas City Chiefs",16,"New England Patriots",14,30,2,TRUE,"10/10/1999",1999,"October","1990s",65,76,8
"7510","199910110nyj","New York Jets",6,"Jacksonville Jaguars",16,22,-10,FALSE,"10/11/1999",1999,"October","1990s",68,67,12
"7511","199910170sfo","San Francisco 49ers",29,"Carolina Panthers",31,60,-2,FALSE,"10/17/1999",1999,"October","1990s",70,26,11
"7512","199910170nwe","New England Patriots",30,"Miami Dolphins",31,61,-1,FALSE,"10/17/1999",1999,"October","1990s",63,81,10
"7513","199910170sdg","San Diego Chargers",13,"Seattle Seahawks",10,23,3,TRUE,"10/17/1999",1999,"October","1990s",66,75,9
"7514","199910170nyj","New York Jets",13,"Indianapolis Colts",16,29,-3,FALSE,"10/17/1999",1999,"October","1990s",64,85,6
"7515","199910170nor","New Orleans Saints",21,"Tennessee Titans",24,45,-3,FALSE,"10/17/1999",1999,"October","1990s",72,NA,NA
"7516","199910170det","Detroit Lions",25,"Minnesota Vikings",23,48,2,TRUE,"10/17/1999",1999,"October","1990s",72,NA,NA
"7517","199910170chi","Chicago Bears",16,"Philadelphia Eagles",20,36,-4,FALSE,"10/17/1999",1999,"October","1990s",48,67,12
"7518","199910170atl","Atlanta Falcons",13,"St. Louis Rams",41,54,-28,FALSE,"10/17/1999",1999,"October","1990s",72,NA,NA
"7519","199910170cin","Cincinnati Bengals",3,"Pittsburgh Steelers",17,20,-14,FALSE,"10/17/1999",1999,"October","1990s",58,86,10
"7520","199910170jax","Jacksonville Jaguars",24,"Cleveland Browns",7,31,17,TRUE,"10/17/1999",1999,"October","1990s",74,83,24
"7521","199910170buf","Buffalo Bills",14,"Oakland Raiders",20,34,-6,FALSE,"10/17/1999",1999,"October","1990s",58,75,12
"7522","199910170den","Denver Broncos",31,"Green Bay Packers",10,41,21,TRUE,"10/17/1999",1999,"October","1990s",32,62,10
"7523","199910170crd","Arizona Cardinals",10,"Washington Redskins",24,34,-14,FALSE,"10/17/1999",1999,"October","1990s",74,12,12
"7524","199910180nyg","New York Giants",13,"Dallas Cowboys",10,23,3,TRUE,"10/18/1999",1999,"October","1990s",59,71,19
"7525","199910210rav","Baltimore Ravens",8,"Kansas City Chiefs",35,43,-27,FALSE,"10/21/1999",1999,"October","1990s",51,74,5
"7526","199910240dal","Dallas Cowboys",38,"Washington Redskins",20,58,18,TRUE,"10/24/1999",1999,"October","1990s",59,36,6
"7527","199910240mia","Miami Dolphins",16,"Philadelphia Eagles",13,29,3,TRUE,"10/24/1999",1999,"October","1990s",71,56,9
"7528","199910240sdg","San Diego Chargers",3,"Green Bay Packers",31,34,-28,FALSE,"10/24/1999",1999,"October","1990s",65,70,8
"7529","199910240car","Carolina Panthers",9,"Detroit Lions",24,33,-15,FALSE,"10/24/1999",1999,"October","1990s",46,60,8
"7530","199910240nyg","New York Giants",31,"New Orleans Saints",3,34,28,TRUE,"10/24/1999",1999,"October","1990s",50,58,17
"7531","199910240min","Minnesota Vikings",40,"San Francisco 49ers",16,56,24,TRUE,"10/24/1999",1999,"October","1990s",72,NA,NA
"7532","199910240tam","Tampa Bay Buccaneers",6,"Chicago Bears",3,9,3,TRUE,"10/24/1999",1999,"October","1990s",62,51,10
"7533","199910240clt","Indianapolis Colts",31,"Cincinnati Bengals",10,41,21,TRUE,"10/24/1999",1999,"October","1990s",72,NA,NA
"7534","199910240nwe","New England Patriots",24,"Denver Broncos",23,47,1,TRUE,"10/24/1999",1999,"October","1990s",49,65,14
"7535","199910240ram","St. Louis Rams",34,"Cleveland Browns",3,37,31,TRUE,"10/24/1999",1999,"October","1990s",72,NA,NA
"7536","199910240rai","Oakland Raiders",24,"New York Jets",23,47,1,TRUE,"10/24/1999",1999,"October","1990s",59,73,10
"7537","199910240sea","Seattle Seahawks",26,"Buffalo Bills",16,42,10,TRUE,"10/24/1999",1999,"October","1990s",72,NA,NA
"7538","199910250pit","Pittsburgh Steelers",13,"Atlanta Falcons",9,22,4,TRUE,"10/25/1999",1999,"October","1990s",41,67,9
"7539","199910310det","Detroit Lions",20,"Tampa Bay Buccaneers",3,23,17,TRUE,"10/31/1999",1999,"October","1990s",72,NA,NA
"7540","199910310oti","Tennessee Titans",24,"St. Louis Rams",21,45,3,TRUE,"10/31/1999",1999,"October","1990s",65,65,6
"7541","199910310crd","Arizona Cardinals",3,"New England Patriots",27,30,-24,FALSE,"10/31/1999",1999,"October","1990s",74,14,7
"7542","199910310rai","Oakland Raiders",9,"Miami Dolphins",16,25,-7,FALSE,"10/31/1999",1999,"October","1990s",64,62,8
"7543","199910310kan","Kansas City Chiefs",34,"San Diego Chargers",0,34,34,TRUE,"10/31/1999",1999,"October","1990s",58,74,9
"7544","199910310clt","Indianapolis Colts",34,"Dallas Cowboys",24,58,10,TRUE,"10/31/1999",1999,"October","1990s",72,NA,NA
"7545","199910310cin","Cincinnati Bengals",10,"Jacksonville Jaguars",41,51,-31,FALSE,"10/31/1999",1999,"October","1990s",62,73,6
"7546","199910310phi","Philadelphia Eagles",17,"New York Giants",23,40,-6,FALSE,"10/31/1999",1999,"October","1990s",59,90,6
"7547","199910310rav","Baltimore Ravens",10,"Buffalo Bills",13,23,-3,FALSE,"10/31/1999",1999,"October","1990s",59,80,4
"7548","199910310atl","Atlanta Falcons",27,"Carolina Panthers",20,47,7,TRUE,"10/31/1999",1999,"October","1990s",72,NA,NA
"7549","199910310nor","New Orleans Saints",16,"Cleveland Browns",21,37,-5,FALSE,"10/31/1999",1999,"October","1990s",72,NA,NA
"7550","199910310was","Washington Redskins",48,"Chicago Bears",22,70,26,TRUE,"10/31/1999",1999,"October","1990s",61,85,6
"7551","199910310den","Denver Broncos",20,"Minnesota Vikings",23,43,-3,FALSE,"10/31/1999",1999,"October","1990s",51,28,10
"7552","199911010gnb","Green Bay Packers",7,"Seattle Seahawks",27,34,-20,FALSE,"11/1/1999",1999,"November","1990s",52,62,16
"7553","199911070mia","Miami Dolphins",17,"Tennessee Titans",0,17,17,TRUE,"11/7/1999",1999,"November","1990s",76,78,14
"7554","199911070nor","New Orleans Saints",16,"Tampa Bay Buccaneers",31,47,-15,FALSE,"11/7/1999",1999,"November","1990s",72,NA,NA
"7555","199911070clt","Indianapolis Colts",25,"Kansas City Chiefs",17,42,8,TRUE,"11/7/1999",1999,"November","1990s",72,NA,NA
"7556","199911070sfo","San Francisco 49ers",6,"Pittsburgh Steelers",27,33,-21,FALSE,"11/7/1999",1999,"November","1990s",62,69,19
"7557","199911070det","Detroit Lions",31,"St. Louis Rams",27,58,4,TRUE,"11/7/1999",1999,"November","1990s",72,NA,NA
"7558","199911070nyj","New York Jets",12,"Arizona Cardinals",7,19,5,TRUE,"11/7/1999",1999,"November","1990s",50,41,18
"7559","199911070car","Carolina Panthers",33,"Philadelphia Eagles",7,40,26,TRUE,"11/7/1999",1999,"November","1990s",59,68,5
"7560","199911070atl","Atlanta Falcons",7,"Jacksonville Jaguars",30,37,-23,FALSE,"11/7/1999",1999,"November","1990s",72,NA,NA
"7561","199911070sdg","San Diego Chargers",17,"Denver Broncos",33,50,-16,FALSE,"11/7/1999",1999,"November","1990s",63,73,6
"7562","199911070sea","Seattle Seahawks",37,"Cincinnati Bengals",20,57,17,TRUE,"11/7/1999",1999,"November","1990s",72,NA,NA
"7563","199911070was","Washington Redskins",17,"Buffalo Bills",34,51,-17,FALSE,"11/7/1999",1999,"November","1990s",55,43,14
"7564","199911070gnb","Green Bay Packers",13,"Chicago Bears",14,27,-1,FALSE,"11/7/1999",1999,"November","1990s",37,48,6
"7565","199911070cle","Cleveland Browns",9,"Baltimore Ravens",41,50,-32,FALSE,"11/7/1999",1999,"November","1990s",43,56,11
"7566","199911080min","Minnesota Vikings",27,"Dallas Cowboys",17,44,10,TRUE,"11/8/1999",1999,"November","1990s",72,NA,NA
"7567","199911140nyg","New York Giants",19,"Indianapolis Colts",27,46,-8,FALSE,"11/14/1999",1999,"November","1990s",53,71,12
"7568","199911140tam","Tampa Bay Buccaneers",17,"Kansas City Chiefs",10,27,7,TRUE,"11/14/1999",1999,"November","1990s",69,85,7
"7569","199911140jax","Jacksonville Jaguars",6,"Baltimore Ravens",3,9,3,TRUE,"11/14/1999",1999,"November","1990s",64,64,6
"7570","199911140ram","St. Louis Rams",35,"Carolina Panthers",10,45,25,TRUE,"11/14/1999",1999,"November","1990s",72,NA,NA
"7571","199911140rai","Oakland Raiders",28,"San Diego Chargers",9,37,19,TRUE,"11/14/1999",1999,"November","1990s",58,77,6
"7572","199911140crd","Arizona Cardinals",23,"Detroit Lions",19,42,4,TRUE,"11/14/1999",1999,"November","1990s",75,26,3
"7573","199911140dal","Dallas Cowboys",27,"Green Bay Packers",13,40,14,TRUE,"11/14/1999",1999,"November","1990s",68,51,7
"7574","199911140nor","New Orleans Saints",24,"San Francisco 49ers",6,30,18,TRUE,"11/14/1999",1999,"November","1990s",72,NA,NA
"7575","199911140buf","Buffalo Bills",23,"Miami Dolphins",3,26,20,TRUE,"11/14/1999",1999,"November","1990s",50,68,19
"7576","199911140cin","Cincinnati Bengals",14,"Tennessee Titans",24,38,-10,FALSE,"11/14/1999",1999,"November","1990s",60,65,13
"7577","199911140pit","Pittsburgh Steelers",15,"Cleveland Browns",16,31,-1,FALSE,"11/14/1999",1999,"November","1990s",53,71,15
"7578","199911140phi","Philadelphia Eagles",35,"Washington Redskins",28,63,7,TRUE,"11/14/1999",1999,"November","1990s",52,82,9
"7579","199911140chi","Chicago Bears",24,"Minnesota Vikings",27,51,-3,FALSE,"11/14/1999",1999,"November","1990s",54,49,15
"7580","199911140sea","Seattle Seahawks",20,"Denver Broncos",17,37,3,TRUE,"11/14/1999",1999,"November","1990s",72,NA,NA
"7581","199911150nwe","New England Patriots",17,"New York Jets",24,41,-7,FALSE,"11/15/1999",1999,"November","1990s",43,57,19
"7582","199911210jax","Jacksonville Jaguars",41,"New Orleans Saints",23,64,18,TRUE,"11/21/1999",1999,"November","1990s",62,92,9
"7583","199911210cle","Cleveland Browns",17,"Carolina Panthers",31,48,-14,FALSE,"11/21/1999",1999,"November","1990s",44,88,4
"7584","199911210gnb","Green Bay Packers",26,"Detroit Lions",17,43,9,TRUE,"11/21/1999",1999,"November","1990s",41,86,11
"7585","199911210mia","Miami Dolphins",27,"New England Patriots",17,44,10,TRUE,"11/21/1999",1999,"November","1990s",71,81,7
"7586","199911210was","Washington Redskins",23,"New York Giants",13,36,10,TRUE,"11/21/1999",1999,"November","1990s",58,81,5
"7587","199911210phi","Philadelphia Eagles",17,"Indianapolis Colts",44,61,-27,FALSE,"11/21/1999",1999,"November","1990s",59,87,2
"7588","199911210sfo","San Francisco 49ers",7,"St. Louis Rams",23,30,-16,FALSE,"11/21/1999",1999,"November","1990s",54,74,13
"7589","199911210tam","Tampa Bay Buccaneers",19,"Atlanta Falcons",10,29,9,TRUE,"11/21/1999",1999,"November","1990s",69,87,8
"7590","199911210kan","Kansas City Chiefs",19,"Seattle Seahawks",31,50,-12,FALSE,"11/21/1999",1999,"November","1990s",50,62,16
"7591","199911210oti","Tennessee Titans",16,"Pittsburgh Steelers",10,26,6,TRUE,"11/21/1999",1999,"November","1990s",57,91,7
"7592","199911210crd","Arizona Cardinals",13,"Dallas Cowboys",9,22,4,TRUE,"11/21/1999",1999,"November","1990s",62,38,6
"7593","199911210nyj","New York Jets",17,"Buffalo Bills",7,24,10,TRUE,"11/21/1999",1999,"November","1990s",58,82,8
"7594","199911210sdg","San Diego Chargers",20,"Chicago Bears",23,43,-3,FALSE,"11/21/1999",1999,"November","1990s",60,81,7
"7595","199911210cin","Cincinnati Bengals",31,"Baltimore Ravens",34,65,-3,FALSE,"11/21/1999",1999,"November","1990s",55,93,7
"7596","199911220den","Denver Broncos",27,"Oakland Raiders",21,48,6,TRUE,"11/22/1999",1999,"November","1990s",30,90,9
"7597","199911250dal","Dallas Cowboys",20,"Miami Dolphins",0,20,20,TRUE,"11/25/1999",1999,"November","1990s",50,54,10
"7598","199911250det","Detroit Lions",21,"Chicago Bears",17,38,4,TRUE,"11/25/1999",1999,"November","1990s",72,NA,NA
"7599","199911280ram","St. Louis Rams",43,"New Orleans Saints",12,55,31,TRUE,"11/28/1999",1999,"November","1990s",72,NA,NA
"7600","199911280rav","Baltimore Ravens",23,"Jacksonville Jaguars",30,53,-7,FALSE,"11/28/1999",1999,"November","1990s",46,61,10
"7601","199911280min","Minnesota Vikings",35,"San Diego Chargers",27,62,8,TRUE,"11/28/1999",1999,"November","1990s",72,NA,NA
"7602","199911280rai","Oakland Raiders",34,"Kansas City Chiefs",37,71,-3,FALSE,"11/28/1999",1999,"November","1990s",56,73,8
"7603","199911280sea","Seattle Seahawks",3,"Tampa Bay Buccaneers",16,19,-13,FALSE,"11/28/1999",1999,"November","1990s",72,NA,NA
"7604","199911280clt","Indianapolis Colts",13,"New York Jets",6,19,7,TRUE,"11/28/1999",1999,"November","1990s",72,NA,NA
"7605","199911280nyg","New York Giants",24,"Arizona Cardinals",34,58,-10,FALSE,"11/28/1999",1999,"November","1990s",50,48,17
"7606","199911280car","Carolina Panthers",34,"Atlanta Falcons",28,62,6,TRUE,"11/28/1999",1999,"November","1990s",52,57,5
"7607","199911280cle","Cleveland Browns",21,"Tennessee Titans",33,54,-12,FALSE,"11/28/1999",1999,"November","1990s",37,73,10
"7608","199911280pit","Pittsburgh Steelers",20,"Cincinnati Bengals",27,47,-7,FALSE,"11/28/1999",1999,"November","1990s",38,73,10
"7609","199911280buf","Buffalo Bills",17,"New England Patriots",7,24,10,TRUE,"11/28/1999",1999,"November","1990s",39,67,16
"7610","199911280was","Washington Redskins",20,"Philadelphia Eagles",17,37,3,TRUE,"11/28/1999",1999,"November","1990s",51,51,11
"7611","199911290sfo","San Francisco 49ers",3,"Green Bay Packers",20,23,-17,FALSE,"11/29/1999",1999,"November","1990s",56,84,7
"7612","199912020jax","Jacksonville Jaguars",20,"Pittsburgh Steelers",6,26,14,TRUE,"12/2/1999",1999,"December","1990s",45,43,10
"7613","199912050det","Detroit Lions",33,"Washington Redskins",17,50,16,TRUE,"12/5/1999",1999,"December","1990s",72,NA,NA
"7614","199912050car","Carolina Panthers",21,"St. Louis Rams",34,55,-13,FALSE,"12/5/1999",1999,"December","1990s",55,72,9
"7615","199912050crd","Arizona Cardinals",21,"Philadelphia Eagles",17,38,4,TRUE,"12/5/1999",1999,"December","1990s",55,28,5
"7616","199912050nwe","New England Patriots",13,"Dallas Cowboys",6,19,7,TRUE,"12/5/1999",1999,"December","1990s",49,74,9
"7617","199912050rav","Baltimore Ravens",41,"Tennessee Titans",14,55,27,TRUE,"12/5/1999",1999,"December","1990s",52,72,6
"7618","199912050mia","Miami Dolphins",34,"Indianapolis Colts",37,71,-3,FALSE,"12/5/1999",1999,"December","1990s",73,71,13
"7619","199912050den","Denver Broncos",10,"Kansas City Chiefs",16,26,-6,FALSE,"12/5/1999",1999,"December","1990s",26,56,14
"7620","199912050atl","Atlanta Falcons",35,"New Orleans Saints",12,47,23,TRUE,"12/5/1999",1999,"December","1990s",72,NA,NA
"7621","199912050nyg","New York Giants",41,"New York Jets",28,69,13,TRUE,"12/5/1999",1999,"December","1990s",55,81,10
"7622","199912050rai","Oakland Raiders",30,"Seattle Seahawks",21,51,9,TRUE,"12/5/1999",1999,"December","1990s",50,66,8
"7623","199912050chi","Chicago Bears",19,"Green Bay Packers",35,54,-16,FALSE,"12/5/1999",1999,"December","1990s",42,96,14
"7624","199912050sdg","San Diego Chargers",23,"Cleveland Browns",10,33,13,TRUE,"12/5/1999",1999,"December","1990s",56,31,6
"7625","199912050cin","Cincinnati Bengals",44,"San Francisco 49ers",30,74,14,TRUE,"12/5/1999",1999,"December","1990s",55,83,13
"7626","199912060tam","Tampa Bay Buccaneers",24,"Minnesota Vikings",17,41,7,TRUE,"12/6/1999",1999,"December","1990s",68,86,8
"7627","199912090oti","Tennessee Titans",21,"Oakland Raiders",14,35,7,TRUE,"12/9/1999",1999,"December","1990s",54,69,9
"7628","199912120gnb","Green Bay Packers",31,"Carolina Panthers",33,64,-2,FALSE,"12/12/1999",1999,"December","1990s",31,87,4
"7629","199912120was","Washington Redskins",28,"Arizona Cardinals",3,31,25,TRUE,"12/12/1999",1999,"December","1990s",43,44,8
"7630","199912120pit","Pittsburgh Steelers",24,"Baltimore Ravens",31,55,-7,FALSE,"12/12/1999",1999,"December","1990s",32,69,4
"7631","199912120nyj","New York Jets",28,"Miami Dolphins",20,48,8,TRUE,"12/12/1999",1999,"December","1990s",40,55,16
"7632","199912120dal","Dallas Cowboys",20,"Philadelphia Eagles",10,30,10,TRUE,"12/12/1999",1999,"December","1990s",50,92,16
"7633","199912120sea","Seattle Seahawks",16,"San Diego Chargers",19,35,-3,FALSE,"12/12/1999",1999,"December","1990s",72,NA,NA
"7634","199912120buf","Buffalo Bills",17,"New York Giants",19,36,-2,FALSE,"12/12/1999",1999,"December","1990s",30,74,6
"7635","199912120clt","Indianapolis Colts",20,"New England Patriots",15,35,5,TRUE,"12/12/1999",1999,"December","1990s",72,NA,NA
"7636","199912120nor","New Orleans Saints",14,"St. Louis Rams",30,44,-16,FALSE,"12/12/1999",1999,"December","1990s",72,NA,NA
"7637","199912120kan","Kansas City Chiefs",31,"Minnesota Vikings",28,59,3,TRUE,"12/12/1999",1999,"December","1990s",42,85,6
"7638","199912120sfo","San Francisco 49ers",26,"Atlanta Falcons",7,33,19,TRUE,"12/12/1999",1999,"December","1990s",50,84,4
"7639","199912120tam","Tampa Bay Buccaneers",23,"Detroit Lions",16,39,7,TRUE,"12/12/1999",1999,"December","1990s",71,78,6
"7640","199912120cin","Cincinnati Bengals",44,"Cleveland Browns",28,72,16,TRUE,"12/12/1999",1999,"December","1990s",38,86,6
"7641","199912130jax","Jacksonville Jaguars",27,"Denver Broncos",24,51,3,TRUE,"12/13/1999",1999,"December","1990s",65,83,10
"7642","199912180kan","Kansas City Chiefs",35,"Pittsburgh Steelers",19,54,16,TRUE,"12/18/1999",1999,"December","1990s",27,82,10
"7643","199912180car","Carolina Panthers",41,"San Francisco 49ers",24,65,17,TRUE,"12/18/1999",1999,"December","1990s",43,54,5
"7644","199912190phi","Philadelphia Eagles",24,"New England Patriots",9,33,15,TRUE,"12/19/1999",1999,"December","1990s",38,61,12
"7645","199912190crd","Arizona Cardinals",21,"Buffalo Bills",31,52,-10,FALSE,"12/19/1999",1999,"December","1990s",57,29,4
"7646","199912190oti","Tennessee Titans",30,"Atlanta Falcons",17,47,13,TRUE,"12/19/1999",1999,"December","1990s",49,76,6
"7647","199912190ram","St. Louis Rams",31,"New York Giants",10,41,21,TRUE,"12/19/1999",1999,"December","1990s",72,NA,NA
"7648","199912190rav","Baltimore Ravens",31,"New Orleans Saints",8,39,23,TRUE,"12/19/1999",1999,"December","1990s",40,71,11
"7649","199912190chi","Chicago Bears",28,"Detroit Lions",10,38,18,TRUE,"12/19/1999",1999,"December","1990s",28,85,9
"7650","199912190mia","Miami Dolphins",12,"San Diego Chargers",9,21,3,TRUE,"12/19/1999",1999,"December","1990s",76,74,6
"7651","199912190rai","Oakland Raiders",45,"Tampa Bay Buccaneers",0,45,45,TRUE,"12/19/1999",1999,"December","1990s",53,64,9
"7652","199912190den","Denver Broncos",36,"Seattle Seahawks",30,66,6,TRUE,"12/19/1999",1999,"December","1990s",30,53,14
"7653","199912190clt","Indianapolis Colts",24,"Washington Redskins",21,45,3,TRUE,"12/19/1999",1999,"December","1990s",72,NA,NA
"7654","199912190dal","Dallas Cowboys",21,"New York Jets",22,43,-1,FALSE,"12/19/1999",1999,"December","1990s",48,78,12
"7655","199912190cle","Cleveland Browns",14,"Jacksonville Jaguars",24,38,-10,FALSE,"12/19/1999",1999,"December","1990s",33,66,8
"7656","199912200min","Minnesota Vikings",24,"Green Bay Packers",20,44,4,TRUE,"12/20/1999",1999,"December","1990s",72,NA,NA
"7657","199912240nor","New Orleans Saints",31,"Dallas Cowboys",24,55,7,TRUE,"12/24/1999",1999,"December","1990s",72,NA,NA
"7658","199912250det","Detroit Lions",7,"Denver Broncos",17,24,-10,FALSE,"12/25/1999",1999,"December","1990s",72,NA,NA
"7659","199912260sfo","San Francisco 49ers",20,"Washington Redskins",26,46,-6,FALSE,"12/26/1999",1999,"December","1990s",50,78,3
"7660","199912260rav","Baltimore Ravens",22,"Cincinnati Bengals",0,22,22,TRUE,"12/26/1999",1999,"December","1990s",28,54,9
"7661","199912260oti","Tennessee Titans",41,"Jacksonville Jaguars",14,55,27,TRUE,"12/26/1999",1999,"December","1990s",36,63,9
"7662","199912260tam","Tampa Bay Buccaneers",29,"Green Bay Packers",10,39,19,TRUE,"12/26/1999",1999,"December","1990s",47,62,9
"7663","199912260sdg","San Diego Chargers",23,"Oakland Raiders",20,43,3,TRUE,"12/26/1999",1999,"December","1990s",60,34,6
"7664","199912260atl","Atlanta Falcons",37,"Arizona Cardinals",14,51,23,TRUE,"12/26/1999",1999,"December","1990s",72,NA,NA
"7665","199912260pit","Pittsburgh Steelers",30,"Carolina Panthers",20,50,10,TRUE,"12/26/1999",1999,"December","1990s",26,58,15
"7666","199912260sea","Seattle Seahawks",23,"Kansas City Chiefs",14,37,9,TRUE,"12/26/1999",1999,"December","1990s",72,NA,NA
"7667","199912260nyg","New York Giants",17,"Minnesota Vikings",34,51,-17,FALSE,"12/26/1999",1999,"December","1990s",30,52,15
"7668","199912260nwe","New England Patriots",10,"Buffalo Bills",13,23,-3,FALSE,"12/26/1999",1999,"December","1990s",29,48,18
"7669","199912260ram","St. Louis Rams",34,"Chicago Bears",12,46,22,TRUE,"12/26/1999",1999,"December","1990s",72,NA,NA
"7670","199912260cle","Cleveland Browns",28,"Indianapolis Colts",29,57,-1,FALSE,"12/26/1999",1999,"December","1990s",27,68,19
"7671","199912270mia","Miami Dolphins",31,"New York Jets",38,69,-7,FALSE,"12/27/1999",1999,"December","1990s",58,69,7
"7672","200001020nyj","New York Jets",19,"Seattle Seahawks",9,28,10,TRUE,"1/2/2000",2000,"January","2000s",48,89,7
"7673","200001020dal","Dallas Cowboys",26,"New York Giants",18,44,8,TRUE,"1/2/2000",2000,"January","2000s",68,78,14
"7674","200001020kan","Kansas City Chiefs",38,"Oakland Raiders",41,79,-3,FALSE,"1/2/2000",2000,"January","2000s",50,59,18
"7675","200001020car","Carolina Panthers",45,"New Orleans Saints",13,58,32,TRUE,"1/2/2000",2000,"January","2000s",56,91,7
"7676","200001020was","Washington Redskins",21,"Miami Dolphins",10,31,11,TRUE,"1/2/2000",2000,"January","2000s",53,74,14
"7677","200001020nwe","New England Patriots",20,"Baltimore Ravens",3,23,17,TRUE,"1/2/2000",2000,"January","2000s",42,86,10
"7678","200001020phi","Philadelphia Eagles",38,"St. Louis Rams",31,69,7,TRUE,"1/2/2000",2000,"January","2000s",47,83,9
"7679","200001020gnb","Green Bay Packers",49,"Arizona Cardinals",24,73,25,TRUE,"1/2/2000",2000,"January","2000s",32,91,15
"7680","200001020min","Minnesota Vikings",24,"Detroit Lions",17,41,7,TRUE,"1/2/2000",2000,"January","2000s",72,NA,NA
"7681","200001020pit","Pittsburgh Steelers",36,"Tennessee Titans",47,83,-11,FALSE,"1/2/2000",2000,"January","2000s",53,59,10
"7682","200001020jax","Jacksonville Jaguars",24,"Cincinnati Bengals",7,31,17,TRUE,"1/2/2000",2000,"January","2000s",63,79,4
"7683","200001020buf","Buffalo Bills",31,"Indianapolis Colts",6,37,25,TRUE,"1/2/2000",2000,"January","2000s",44,76,14
"7684","200001020chi","Chicago Bears",6,"Tampa Bay Buccaneers",20,26,-14,FALSE,"1/2/2000",2000,"January","2000s",48,81,15
"7685","200001020den","Denver Broncos",6,"San Diego Chargers",12,18,-6,FALSE,"1/2/2000",2000,"January","2000s",32,58,10
"7686","200001030atl","Atlanta Falcons",34,"San Francisco 49ers",29,63,5,TRUE,"1/3/2000",2000,"January","2000s",72,NA,NA
"7687","200001080was","Washington Redskins",27,"Detroit Lions",13,40,14,TRUE,"1/8/2000",2000,"January","2000s",39,48,8
"7688","200001080oti","Tennessee Titans",22,"Buffalo Bills",16,38,6,TRUE,"1/8/2000",2000,"January","2000s",37,82,4
"7689","200001090sea","Seattle Seahawks",17,"Miami Dolphins",20,37,-3,FALSE,"1/9/2000",2000,"January","2000s",72,NA,NA
"7690","200001090min","Minnesota Vikings",27,"Dallas Cowboys",10,37,17,TRUE,"1/9/2000",2000,"January","2000s",72,NA,NA
"7691","200001150tam","Tampa Bay Buccaneers",14,"Washington Redskins",13,27,1,TRUE,"1/15/2000",2000,"January","2000s",52,53,11
"7692","200001150jax","Jacksonville Jaguars",62,"Miami Dolphins",7,69,55,TRUE,"1/15/2000",2000,"January","2000s",46,45,13
"7693","200001160clt","Indianapolis Colts",16,"Tennessee Titans",19,35,-3,FALSE,"1/16/2000",2000,"January","2000s",72,NA,NA
"7694","200001160ram","St. Louis Rams",49,"Minnesota Vikings",37,86,12,TRUE,"1/16/2000",2000,"January","2000s",72,NA,NA
"7695","200001230ram","St. Louis Rams",11,"Tampa Bay Buccaneers",6,17,5,TRUE,"1/23/2000",2000,"January","2000s",72,NA,NA
"7696","200001230jax","Jacksonville Jaguars",14,"Tennessee Titans",33,47,-19,FALSE,"1/23/2000",2000,"January","2000s",58,68,10
"7697","200001300oti","Tennessee Titans",16,"St. Louis Rams",23,39,-7,FALSE,"1/30/2000",2000,"January","2000s",72,NA,NA
"7698","200009030nyg","New York Giants",21,"Arizona Cardinals",16,37,5,TRUE,"9/3/2000",2000,"September","2000s",78,84,7
"7699","200009030buf","Buffalo Bills",16,"Tennessee Titans",13,29,3,TRUE,"9/3/2000",2000,"September","2000s",70,82,7
"7700","200009030mia","Miami Dolphins",23,"Seattle Seahawks",0,23,23,TRUE,"9/3/2000",2000,"September","2000s",84,74,9
"7701","200009030was","Washington Redskins",20,"Carolina Panthers",17,37,3,TRUE,"9/3/2000",2000,"September","2000s",76,92,7
"7702","200009030kan","Kansas City Chiefs",14,"Indianapolis Colts",27,41,-13,FALSE,"9/3/2000",2000,"September","2000s",86,51,9
"7703","200009030gnb","Green Bay Packers",16,"New York Jets",20,36,-4,FALSE,"9/3/2000",2000,"September","2000s",69,87,13
"7704","200009030nor","New Orleans Saints",10,"Detroit Lions",14,24,-4,FALSE,"9/3/2000",2000,"September","2000s",72,NA,NA
"7705","200009030min","Minnesota Vikings",30,"Chicago Bears",27,57,3,TRUE,"9/3/2000",2000,"September","2000s",72,NA,NA
"7706","200009030cle","Cleveland Browns",7,"Jacksonville Jaguars",27,34,-20,FALSE,"9/3/2000",2000,"September","2000s",75,86,8
"7707","200009030dal","Dallas Cowboys",14,"Philadelphia Eagles",41,55,-27,FALSE,"9/3/2000",2000,"September","2000s",95,32,7
"7708","200009030nwe","New England Patriots",16,"Tampa Bay Buccaneers",21,37,-5,FALSE,"9/3/2000",2000,"September","2000s",63,95,8
"7709","200009030atl","Atlanta Falcons",36,"San Francisco 49ers",28,64,8,TRUE,"9/3/2000",2000,"September","2000s",72,NA,NA
"7710","200009030pit","Pittsburgh Steelers",0,"Baltimore Ravens",16,16,-16,FALSE,"9/3/2000",2000,"September","2000s",73,90,5
"7711","200009030rai","Oakland Raiders",9,"San Diego Chargers",6,15,3,TRUE,"9/3/2000",2000,"September","2000s",60,77,12
"7712","200009040ram","St. Louis Rams",41,"Denver Broncos",36,77,5,TRUE,"9/4/2000",2000,"September","2000s",72,NA,NA
"7713","200009100cin","Cincinnati Bengals",7,"Cleveland Browns",24,31,-17,FALSE,"9/10/2000",2000,"September","2000s",74,91,7
"7714","200009100min","Minnesota Vikings",13,"Miami Dolphins",7,20,6,TRUE,"9/10/2000",2000,"September","2000s",72,NA,NA
"7715","200009100crd","Arizona Cardinals",32,"Dallas Cowboys",31,63,1,TRUE,"9/10/2000",2000,"September","2000s",92,31,5
"7716","200009100oti","Tennessee Titans",17,"Kansas City Chiefs",14,31,3,TRUE,"9/10/2000",2000,"September","2000s",78,71,8
"7717","200009100den","Denver Broncos",42,"Atlanta Falcons",14,56,28,TRUE,"9/10/2000",2000,"September","2000s",71,26,10
"7718","200009100sea","Seattle Seahawks",34,"St. Louis Rams",37,71,-3,FALSE,"9/10/2000",2000,"September","2000s",56,93,8
"7719","200009100sfo","San Francisco 49ers",22,"Carolina Panthers",38,60,-16,FALSE,"9/10/2000",2000,"September","2000s",59,76,11
"7720","200009100rav","Baltimore Ravens",39,"Jacksonville Jaguars",36,75,3,TRUE,"9/10/2000",2000,"September","2000s",74,80,4
"7721","200009100sdg","San Diego Chargers",27,"New Orleans Saints",28,55,-1,FALSE,"9/10/2000",2000,"September","2000s",67,78,7
"7722","200009100tam","Tampa Bay Buccaneers",41,"Chicago Bears",0,41,41,TRUE,"9/10/2000",2000,"September","2000s",82,76,9
"7723","200009100clt","Indianapolis Colts",31,"Oakland Raiders",38,69,-7,FALSE,"9/10/2000",2000,"September","2000s",72,NA,NA
"7724","200009100phi","Philadelphia Eagles",18,"New York Giants",33,51,-15,FALSE,"9/10/2000",2000,"September","2000s",74,82,7
"7725","200009100det","Detroit Lions",15,"Washington Redskins",10,25,5,TRUE,"9/10/2000",2000,"September","2000s",72,NA,NA
"7726","200009100buf","Buffalo Bills",27,"Green Bay Packers",18,45,9,TRUE,"9/10/2000",2000,"September","2000s",73,80,7
"7727","200009110nyj","New York Jets",20,"New England Patriots",19,39,1,TRUE,"9/11/2000",2000,"September","2000s",73,74,9
"7728","200009170jax","Jacksonville Jaguars",13,"Cincinnati Bengals",0,13,13,TRUE,"9/17/2000",2000,"September","2000s",74,88,12
"7729","200009170gnb","Green Bay Packers",6,"Philadelphia Eagles",3,9,3,TRUE,"9/17/2000",2000,"September","2000s",60,63,9
"7730","200009170car","Carolina Panthers",10,"Atlanta Falcons",15,25,-5,FALSE,"9/17/2000",2000,"September","2000s",59,64,8
"7731","200009170chi","Chicago Bears",7,"New York Giants",14,21,-7,FALSE,"9/17/2000",2000,"September","2000s",64,52,10
"7732","200009170det","Detroit Lions",10,"Tampa Bay Buccaneers",31,41,-21,FALSE,"9/17/2000",2000,"September","2000s",72,NA,NA
"7733","200009170ram","St. Louis Rams",41,"San Francisco 49ers",24,65,17,TRUE,"9/17/2000",2000,"September","2000s",72,NA,NA
"7734","200009170kan","Kansas City Chiefs",42,"San Diego Chargers",10,52,32,TRUE,"9/17/2000",2000,"September","2000s",69,44,9
"7735","200009170nyj","New York Jets",27,"Buffalo Bills",14,41,13,TRUE,"9/17/2000",2000,"September","2000s",63,51,13
"7736","200009170mia","Miami Dolphins",19,"Baltimore Ravens",6,25,13,TRUE,"9/17/2000",2000,"September","2000s",83,76,16
"7737","200009170nwe","New England Patriots",13,"Minnesota Vikings",21,34,-8,FALSE,"9/17/2000",2000,"September","2000s",59,61,16
"7738","200009170sea","Seattle Seahawks",20,"New Orleans Saints",10,30,10,TRUE,"9/17/2000",2000,"September","2000s",62,83,5
"7739","200009170cle","Cleveland Browns",23,"Pittsburgh Steelers",20,43,3,TRUE,"9/17/2000",2000,"September","2000s",57,68,14
"7740","200009170rai","Oakland Raiders",24,"Denver Broncos",33,57,-9,FALSE,"9/17/2000",2000,"September","2000s",68,74,8
"7741","200009180was","Washington Redskins",21,"Dallas Cowboys",27,48,-6,FALSE,"9/18/2000",2000,"September","2000s",63,74,8
"7742","200009240pit","Pittsburgh Steelers",20,"Tennessee Titans",23,43,-3,FALSE,"9/24/2000",2000,"September","2000s",62,92,11
"7743","200009240crd","Arizona Cardinals",3,"Green Bay Packers",29,32,-26,FALSE,"9/24/2000",2000,"September","2000s",80,28,6
"7744","200009240rav","Baltimore Ravens",37,"Cincinnati Bengals",0,37,37,TRUE,"9/24/2000",2000,"September","2000s",70,89,6
"7745","200009240rai","Oakland Raiders",36,"Cleveland Browns",10,46,26,TRUE,"9/24/2000",2000,"September","2000s",62,83,8
"7746","200009240nyg","New York Giants",6,"Washington Redskins",16,22,-10,FALSE,"9/24/2000",2000,"September","2000s",71,88,11
"7747","200009240mia","Miami Dolphins",10,"New England Patriots",3,13,7,TRUE,"9/24/2000",2000,"September","2000s",84,74,9
"7748","200009240nor","New Orleans Saints",7,"Philadelphia Eagles",21,28,-14,FALSE,"9/24/2000",2000,"September","2000s",72,NA,NA
"7749","200009240den","Denver Broncos",22,"Kansas City Chiefs",23,45,-1,FALSE,"9/24/2000",2000,"September","2000s",33,89,11
"7750","200009240tam","Tampa Bay Buccaneers",17,"New York Jets",21,38,-4,FALSE,"9/24/2000",2000,"September","2000s",82,84,6
"7751","200009240chi","Chicago Bears",14,"Detroit Lions",21,35,-7,FALSE,"9/24/2000",2000,"September","2000s",54,85,12
"7752","200009240sdg","San Diego Chargers",12,"Seattle Seahawks",20,32,-8,FALSE,"9/24/2000",2000,"September","2000s",68,70,8
"7753","200009240dal","Dallas Cowboys",24,"San Francisco 49ers",41,65,-17,FALSE,"9/24/2000",2000,"September","2000s",72,80,15
"7754","200009240atl","Atlanta Falcons",20,"St. Louis Rams",41,61,-21,FALSE,"9/24/2000",2000,"September","2000s",72,NA,NA
"7755","200009250clt","Indianapolis Colts",43,"Jacksonville Jaguars",14,57,29,TRUE,"9/25/2000",2000,"September","2000s",72,NA,NA
"7756","200010010cin","Cincinnati Bengals",16,"Miami Dolphins",31,47,-15,FALSE,"10/1/2000",2000,"October","2000s",62,79,6
"7757","200010010sfo","San Francisco 49ers",27,"Arizona Cardinals",20,47,7,TRUE,"10/1/2000",2000,"October","2000s",65,76,13
"7758","200010010car","Carolina Panthers",13,"Dallas Cowboys",16,29,-3,FALSE,"10/1/2000",2000,"October","2000s",63,78,10
"7759","200010010buf","Buffalo Bills",16,"Indianapolis Colts",18,34,-2,FALSE,"10/1/2000",2000,"October","2000s",60,68,9
"7760","200010010det","Detroit Lions",24,"Minnesota Vikings",31,55,-7,FALSE,"10/1/2000",2000,"October","2000s",72,NA,NA
"7761","200010010was","Washington Redskins",20,"Tampa Bay Buccaneers",17,37,3,TRUE,"10/1/2000",2000,"October","2000s",60,92,5
"7762","200010010ram","St. Louis Rams",57,"San Diego Chargers",31,88,26,TRUE,"10/1/2000",2000,"October","2000s",72,NA,NA
"7763","200010010cle","Cleveland Browns",0,"Baltimore Ravens",12,12,-12,FALSE,"10/1/2000",2000,"October","2000s",62,75,12
"7764","200010010oti","Tennessee Titans",28,"New York Giants",14,42,14,TRUE,"10/1/2000",2000,"October","2000s",66,73,6
"7765","200010010den","Denver Broncos",19,"New England Patriots",28,47,-9,FALSE,"10/1/2000",2000,"October","2000s",69,29,12
"7766","200010010jax","Jacksonville Jaguars",13,"Pittsburgh Steelers",24,37,-11,FALSE,"10/1/2000",2000,"October","2000s",73,80,17
"7767","200010010gnb","Green Bay Packers",24,"Chicago Bears",27,51,-3,FALSE,"10/1/2000",2000,"October","2000s",64,66,13
"7768","200010010phi","Philadelphia Eagles",38,"Atlanta Falcons",10,48,28,TRUE,"10/1/2000",2000,"October","2000s",60,76,3
"7769","200010020kan","Kansas City Chiefs",24,"Seattle Seahawks",17,41,7,TRUE,"10/2/2000",2000,"October","2000s",74,49,13
"7770","200010080sfo","San Francisco 49ers",28,"Oakland Raiders",34,62,-6,FALSE,"10/8/2000",2000,"October","2000s",58,80,14
"7771","200010080nwe","New England Patriots",24,"Indianapolis Colts",16,40,8,TRUE,"10/8/2000",2000,"October","2000s",50,53,14
"7772","200010080nyj","New York Jets",3,"Pittsburgh Steelers",20,23,-17,FALSE,"10/8/2000",2000,"October","2000s",50,55,15
"7773","200010080car","Carolina Panthers",26,"Seattle Seahawks",3,29,23,TRUE,"10/8/2000",2000,"October","2000s",50,48,13
"7774","200010080mia","Miami Dolphins",22,"Buffalo Bills",13,35,9,TRUE,"10/8/2000",2000,"October","2000s",82,77,6
"7775","200010080cin","Cincinnati Bengals",14,"Tennessee Titans",23,37,-9,FALSE,"10/8/2000",2000,"October","2000s",38,74,10
"7776","200010080chi","Chicago Bears",10,"New Orleans Saints",31,41,-21,FALSE,"10/8/2000",2000,"October","2000s",39,63,18
"7777","200010080phi","Philadelphia Eagles",14,"Washington Redskins",17,31,-3,FALSE,"10/8/2000",2000,"October","2000s",48,57,12
"7778","200010080atl","Atlanta Falcons",6,"New York Giants",13,19,-7,FALSE,"10/8/2000",2000,"October","2000s",72,NA,NA
"7779","200010080jax","Jacksonville Jaguars",10,"Baltimore Ravens",15,25,-5,FALSE,"10/8/2000",2000,"October","2000s",71,79,12
"7780","200010080det","Detroit Lions",31,"Green Bay Packers",24,55,7,TRUE,"10/8/2000",2000,"October","2000s",72,NA,NA
"7781","200010080sdg","San Diego Chargers",7,"Denver Broncos",21,28,-14,FALSE,"10/8/2000",2000,"October","2000s",68,83,8
"7782","200010080crd","Arizona Cardinals",29,"Cleveland Browns",21,50,8,TRUE,"10/8/2000",2000,"October","2000s",85,30,12
"7783","200010090min","Minnesota Vikings",30,"Tampa Bay Buccaneers",23,53,7,TRUE,"10/9/2000",2000,"October","2000s",72,NA,NA
"7784","200010150nor","New Orleans Saints",24,"Carolina Panthers",6,30,18,TRUE,"10/15/2000",2000,"October","2000s",72,NA,NA
"7785","200010150buf","Buffalo Bills",27,"San Diego Chargers",24,51,3,TRUE,"10/15/2000",2000,"October","2000s",60,83,8
"7786","200010150crd","Arizona Cardinals",14,"Philadelphia Eagles",33,47,-19,FALSE,"10/15/2000",2000,"October","2000s",71,36,4
"7787","200010150nyg","New York Giants",19,"Dallas Cowboys",14,33,5,TRUE,"10/15/2000",2000,"October","2000s",72,46,8
"7788","200010150sea","Seattle Seahawks",24,"Indianapolis Colts",37,61,-13,FALSE,"10/15/2000",2000,"October","2000s",46,88,5
"7789","200010150pit","Pittsburgh Steelers",15,"Cincinnati Bengals",0,15,15,TRUE,"10/15/2000",2000,"October","2000s",60,63,6
"7790","200010150kan","Kansas City Chiefs",17,"Oakland Raiders",20,37,-3,FALSE,"10/15/2000",2000,"October","2000s",60,94,9
"7791","200010150ram","St. Louis Rams",45,"Atlanta Falcons",29,74,16,TRUE,"10/15/2000",2000,"October","2000s",72,NA,NA
"7792","200010150gnb","Green Bay Packers",31,"San Francisco 49ers",28,59,3,TRUE,"10/15/2000",2000,"October","2000s",51,81,10
"7793","200010150den","Denver Broncos",44,"Cleveland Browns",10,54,34,TRUE,"10/15/2000",2000,"October","2000s",47,49,8
"7794","200010150chi","Chicago Bears",16,"Minnesota Vikings",28,44,-12,FALSE,"10/15/2000",2000,"October","2000s",60,65,9
"7795","200010150nwe","New England Patriots",17,"New York Jets",34,51,-17,FALSE,"10/15/2000",2000,"October","2000s",67,54,14
"7796","200010150was","Washington Redskins",10,"Baltimore Ravens",3,13,7,TRUE,"10/15/2000",2000,"October","2000s",64,70,7
"7797","200010160oti","Tennessee Titans",27,"Jacksonville Jaguars",13,40,14,TRUE,"10/16/2000",2000,"October","2000s",67,64,3
"7798","200010190tam","Tampa Bay Buccaneers",14,"Detroit Lions",28,42,-14,FALSE,"10/19/2000",2000,"October","2000s",72,67,4
"7799","200010220rav","Baltimore Ravens",6,"Tennessee Titans",14,20,-8,FALSE,"10/22/2000",2000,"October","2000s",60,61,8
"7800","200010220dal","Dallas Cowboys",48,"Arizona Cardinals",7,55,41,TRUE,"10/22/2000",2000,"October","2000s",68,94,16
"7801","200010220car","Carolina Panthers",34,"San Francisco 49ers",16,50,18,TRUE,"10/22/2000",2000,"October","2000s",65,71,6
"7802","200010220min","Minnesota Vikings",31,"Buffalo Bills",27,58,4,TRUE,"10/22/2000",2000,"October","2000s",72,NA,NA
"7803","200010220rai","Oakland Raiders",31,"Seattle Seahawks",3,34,28,TRUE,"10/22/2000",2000,"October","2000s",66,28,26
"7804","200010220kan","Kansas City Chiefs",54,"St. Louis Rams",34,88,20,TRUE,"10/22/2000",2000,"October","2000s",62,88,13
"7805","200010220cin","Cincinnati Bengals",31,"Denver Broncos",21,52,10,TRUE,"10/22/2000",2000,"October","2000s",64,82,4
"7806","200010220clt","Indianapolis Colts",30,"New England Patriots",23,53,7,TRUE,"10/22/2000",2000,"October","2000s",72,NA,NA
"7807","200010220phi","Philadelphia Eagles",13,"Chicago Bears",9,22,4,TRUE,"10/22/2000",2000,"October","2000s",60,56,9
"7808","200010220atl","Atlanta Falcons",19,"New Orleans Saints",21,40,-2,FALSE,"10/22/2000",2000,"October","2000s",72,NA,NA
"7809","200010220pit","Pittsburgh Steelers",22,"Cleveland Browns",0,22,22,TRUE,"10/22/2000",2000,"October","2000s",59,60,5
"7810","200010220jax","Jacksonville Jaguars",16,"Washington Redskins",35,51,-19,FALSE,"10/22/2000",2000,"October","2000s",72,82,10
"7811","200010230nyj","New York Jets",40,"Miami Dolphins",37,77,3,TRUE,"10/23/2000",2000,"October","2000s",53,54,10
"7812","200010290dal","Dallas Cowboys",17,"Jacksonville Jaguars",23,40,-6,FALSE,"10/29/2000",2000,"October","2000s",69,88,12
"7813","200010290cle","Cleveland Browns",3,"Cincinnati Bengals",12,15,-9,FALSE,"10/29/2000",2000,"October","2000s",41,81,7
"7814","200010290mia","Miami Dolphins",28,"Green Bay Packers",20,48,8,TRUE,"10/29/2000",2000,"October","2000s",75,68,8
"7815","200010290sfo","San Francisco 49ers",24,"St. Louis Rams",34,58,-10,FALSE,"10/29/2000",2000,"October","2000s",56,81,9
"7816","200010290sea","Seattle Seahawks",19,"Kansas City Chiefs",24,43,-5,FALSE,"10/29/2000",2000,"October","2000s",51,75,8
"7817","200010290tam","Tampa Bay Buccaneers",41,"Minnesota Vikings",13,54,28,TRUE,"10/29/2000",2000,"October","2000s",72,86,5
"7818","200010290rav","Baltimore Ravens",6,"Pittsburgh Steelers",9,15,-3,FALSE,"10/29/2000",2000,"October","2000s",47,36,12
"7819","200010290buf","Buffalo Bills",23,"New York Jets",20,43,3,TRUE,"10/29/2000",2000,"October","2000s",39,56,11
"7820","200010290crd","Arizona Cardinals",10,"New Orleans Saints",21,31,-11,FALSE,"10/29/2000",2000,"October","2000s",62,70,6
"7821","200010290sdg","San Diego Chargers",13,"Oakland Raiders",15,28,-2,FALSE,"10/29/2000",2000,"October","2000s",62,70,6
"7822","200010290clt","Indianapolis Colts",30,"Detroit Lions",18,48,12,TRUE,"10/29/2000",2000,"October","2000s",72,NA,NA
"7823","200010290nyg","New York Giants",24,"Philadelphia Eagles",7,31,17,TRUE,"10/29/2000",2000,"October","2000s",43,49,19
"7824","200010290atl","Atlanta Falcons",13,"Carolina Panthers",12,25,1,TRUE,"10/29/2000",2000,"October","2000s",72,NA,NA
"7825","200010300was","Washington Redskins",21,"Tennessee Titans",27,48,-6,FALSE,"10/30/2000",2000,"October","2000s",52,35,14
"7826","200011050phi","Philadelphia Eagles",16,"Dallas Cowboys",13,29,3,TRUE,"11/5/2000",2000,"November","2000s",51,57,14
"7827","200011050ram","St. Louis Rams",24,"Carolina Panthers",27,51,-3,FALSE,"11/5/2000",2000,"November","2000s",72,NA,NA
"7828","200011050chi","Chicago Bears",27,"Indianapolis Colts",24,51,3,TRUE,"11/5/2000",2000,"November","2000s",46,54,8
"7829","200011050nyj","New York Jets",23,"Denver Broncos",30,53,-7,FALSE,"11/5/2000",2000,"November","2000s",52,55,20
"7830","200011050crd","Arizona Cardinals",16,"Washington Redskins",15,31,1,TRUE,"11/5/2000",2000,"November","2000s",59,69,7
"7831","200011050nor","New Orleans Saints",31,"San Francisco 49ers",15,46,16,TRUE,"11/5/2000",2000,"November","2000s",72,NA,NA
"7832","200011050det","Detroit Lions",8,"Miami Dolphins",23,31,-15,FALSE,"11/5/2000",2000,"November","2000s",72,NA,NA
"7833","200011050sea","Seattle Seahawks",17,"San Diego Chargers",15,32,2,TRUE,"11/5/2000",2000,"November","2000s",47,85,11
"7834","200011050oti","Tennessee Titans",9,"Pittsburgh Steelers",7,16,2,TRUE,"11/5/2000",2000,"November","2000s",54,73,8
"7835","200011050cin","Cincinnati Bengals",7,"Baltimore Ravens",27,34,-20,FALSE,"11/5/2000",2000,"November","2000s",44,65,7
"7836","200011050nwe","New England Patriots",13,"Buffalo Bills",16,29,-3,FALSE,"11/5/2000",2000,"November","2000s",46,94,12
"7837","200011050rai","Oakland Raiders",49,"Kansas City Chiefs",31,80,18,TRUE,"11/5/2000",2000,"November","2000s",56,89,10
"7838","200011050cle","Cleveland Browns",3,"New York Giants",24,27,-21,FALSE,"11/5/2000",2000,"November","2000s",45,75,7
"7839","200011050atl","Atlanta Falcons",14,"Tampa Bay Buccaneers",27,41,-13,FALSE,"11/5/2000",2000,"November","2000s",72,NA,NA
"7840","200011060gnb","Green Bay Packers",26,"Minnesota Vikings",20,46,6,TRUE,"11/6/2000",2000,"November","2000s",49,68,17
"7841","200011120clt","Indianapolis Colts",23,"New York Jets",15,38,8,TRUE,"11/12/2000",2000,"November","2000s",72,NA,NA
"7842","200011120tam","Tampa Bay Buccaneers",20,"Green Bay Packers",15,35,5,TRUE,"11/12/2000",2000,"November","2000s",64,70,5
"7843","200011120oti","Tennessee Titans",23,"Baltimore Ravens",24,47,-1,FALSE,"11/12/2000",2000,"November","2000s",46,67,4
"7844","200011120min","Minnesota Vikings",31,"Arizona Cardinals",14,45,17,TRUE,"11/12/2000",2000,"November","2000s",72,NA,NA
"7845","200011120sfo","San Francisco 49ers",21,"Kansas City Chiefs",7,28,14,TRUE,"11/12/2000",2000,"November","2000s",48,72,8
"7846","200011120jax","Jacksonville Jaguars",21,"Seattle Seahawks",28,49,-7,FALSE,"11/12/2000",2000,"November","2000s",62,66,5
"7847","200011120buf","Buffalo Bills",20,"Chicago Bears",3,23,17,TRUE,"11/12/2000",2000,"November","2000s",39,80,11
"7848","200011120car","Carolina Panthers",10,"New Orleans Saints",20,30,-10,FALSE,"11/12/2000",2000,"November","2000s",50,59,5
"7849","200011120nyg","New York Giants",24,"St. Louis Rams",38,62,-14,FALSE,"11/12/2000",2000,"November","2000s",50,76,15
"7850","200011120sdg","San Diego Chargers",7,"Miami Dolphins",17,24,-10,FALSE,"11/12/2000",2000,"November","2000s",54,60,7
"7851","200011120dal","Dallas Cowboys",23,"Cincinnati Bengals",6,29,17,TRUE,"11/12/2000",2000,"November","2000s",48,96,12
"7852","200011120pit","Pittsburgh Steelers",23,"Philadelphia Eagles",26,49,-3,FALSE,"11/12/2000",2000,"November","2000s",41,76,8
"7853","200011120det","Detroit Lions",13,"Atlanta Falcons",10,23,3,TRUE,"11/12/2000",2000,"November","2000s",72,NA,NA
"7854","200011120cle","Cleveland Browns",19,"New England Patriots",11,30,8,TRUE,"11/12/2000",2000,"November","2000s",43,82,10
"7855","200011130den","Denver Broncos",27,"Oakland Raiders",24,51,3,TRUE,"11/13/2000",2000,"November","2000s",14,57,11
"7856","200011190chi","Chicago Bears",13,"Tampa Bay Buccaneers",10,23,3,TRUE,"11/19/2000",2000,"November","2000s",30,68,13
"7857","200011190pit","Pittsburgh Steelers",24,"Jacksonville Jaguars",34,58,-10,FALSE,"11/19/2000",2000,"November","2000s",31,59,9
"7858","200011190nor","New Orleans Saints",22,"Oakland Raiders",31,53,-9,FALSE,"11/19/2000",2000,"November","2000s",72,NA,NA
"7859","200011190phi","Philadelphia Eagles",34,"Arizona Cardinals",9,43,25,TRUE,"11/19/2000",2000,"November","2000s",38,57,9
"7860","200011190gnb","Green Bay Packers",26,"Indianapolis Colts",24,50,2,TRUE,"11/19/2000",2000,"November","2000s",26,79,10
"7861","200011190nyg","New York Giants",21,"Detroit Lions",31,52,-10,FALSE,"11/19/2000",2000,"November","2000s",40,56,11
"7862","200011190rav","Baltimore Ravens",27,"Dallas Cowboys",0,27,27,TRUE,"11/19/2000",2000,"November","2000s",36,56,6
"7863","200011190mia","Miami Dolphins",3,"New York Jets",20,23,-17,FALSE,"11/19/2000",2000,"November","2000s",78,78,9
"7864","200011190nwe","New England Patriots",16,"Cincinnati Bengals",13,29,3,TRUE,"11/19/2000",2000,"November","2000s",40,53,9
"7865","200011190den","Denver Broncos",38,"San Diego Chargers",37,75,1,TRUE,"11/19/2000",2000,"November","2000s",28,57,11
"7866","200011190min","Minnesota Vikings",31,"Carolina Panthers",17,48,14,TRUE,"11/19/2000",2000,"November","2000s",72,NA,NA
"7867","200011190kan","Kansas City Chiefs",17,"Buffalo Bills",21,38,-4,FALSE,"11/19/2000",2000,"November","2000s",36,57,16
"7868","200011190sfo","San Francisco 49ers",16,"Atlanta Falcons",6,22,10,TRUE,"11/19/2000",2000,"November","2000s",51,70,6
"7869","200011190oti","Tennessee Titans",24,"Cleveland Browns",10,34,14,TRUE,"11/19/2000",2000,"November","2000s",38,57,6
"7870","200011200ram","St. Louis Rams",20,"Washington Redskins",33,53,-13,FALSE,"11/20/2000",2000,"November","2000s",72,NA,NA
"7871","200011230det","Detroit Lions",34,"New England Patriots",9,43,25,TRUE,"11/23/2000",2000,"November","2000s",72,NA,NA
"7872","200011230dal","Dallas Cowboys",15,"Minnesota Vikings",27,42,-12,FALSE,"11/23/2000",2000,"November","2000s",53,97,9
"7873","200011260sdg","San Diego Chargers",17,"Kansas City Chiefs",16,33,1,TRUE,"11/26/2000",2000,"November","2000s",56,78,5
"7874","200011260nyj","New York Jets",17,"Chicago Bears",10,27,7,TRUE,"11/26/2000",2000,"November","2000s",46,95,18
"7875","200011260cin","Cincinnati Bengals",28,"Pittsburgh Steelers",48,76,-20,FALSE,"11/26/2000",2000,"November","2000s",44,91,11
"7876","200011260sea","Seattle Seahawks",31,"Denver Broncos",38,69,-7,FALSE,"11/26/2000",2000,"November","2000s",45,91,11
"7877","200011260tam","Tampa Bay Buccaneers",31,"Buffalo Bills",17,48,14,TRUE,"11/26/2000",2000,"November","2000s",67,95,6
"7878","200011260jax","Jacksonville Jaguars",16,"Tennessee Titans",13,29,3,TRUE,"11/26/2000",2000,"November","2000s",60,89,7
"7879","200011260crd","Arizona Cardinals",7,"New York Giants",31,38,-24,FALSE,"11/26/2000",2000,"November","2000s",57,34,5
"7880","200011260ram","St. Louis Rams",24,"New Orleans Saints",31,55,-7,FALSE,"11/26/2000",2000,"November","2000s",72,NA,NA
"7881","200011260clt","Indianapolis Colts",14,"Miami Dolphins",17,31,-3,FALSE,"11/26/2000",2000,"November","2000s",72,NA,NA
"7882","200011260rai","Oakland Raiders",41,"Atlanta Falcons",14,55,27,TRUE,"11/26/2000",2000,"November","2000s",48,90,6
"7883","200011260was","Washington Redskins",20,"Philadelphia Eagles",23,43,-3,FALSE,"11/26/2000",2000,"November","2000s",50,90,10
"7884","200011260rav","Baltimore Ravens",44,"Cleveland Browns",7,51,37,TRUE,"11/26/2000",2000,"November","2000s",50,88,13
"7885","200011270car","Carolina Panthers",31,"Green Bay Packers",14,45,17,TRUE,"11/27/2000",2000,"November","2000s",47,71,6
"7886","200011300min","Minnesota Vikings",24,"Detroit Lions",17,41,7,TRUE,"11/30/2000",2000,"November","2000s",72,NA,NA
"7887","200012030sdg","San Diego Chargers",17,"San Francisco 49ers",45,62,-28,FALSE,"12/3/2000",2000,"December","2000s",54,92,6
"7888","200012030pit","Pittsburgh Steelers",21,"Oakland Raiders",20,41,1,TRUE,"12/3/2000",2000,"December","2000s",23,60,8
"7889","200012030was","Washington Redskins",7,"New York Giants",9,16,-2,FALSE,"12/3/2000",2000,"December","2000s",29,51,14
"7890","200012030phi","Philadelphia Eagles",13,"Tennessee Titans",15,28,-2,FALSE,"12/3/2000",2000,"December","2000s",28,54,11
"7891","200012030car","Carolina Panthers",16,"St. Louis Rams",3,19,13,TRUE,"12/3/2000",2000,"December","2000s",35,58,13
"7892","200012030cin","Cincinnati Bengals",24,"Arizona Cardinals",13,37,11,TRUE,"12/3/2000",2000,"December","2000s",28,57,15
"7893","200012030tam","Tampa Bay Buccaneers",27,"Dallas Cowboys",7,34,20,TRUE,"12/3/2000",2000,"December","2000s",59,89,9
"7894","200012030buf","Buffalo Bills",6,"Miami Dolphins",33,39,-27,FALSE,"12/3/2000",2000,"December","2000s",21,78,6
"7895","200012030nyj","New York Jets",27,"Indianapolis Colts",17,44,10,TRUE,"12/3/2000",2000,"December","2000s",29,52,10
"7896","200012030chi","Chicago Bears",6,"Green Bay Packers",28,34,-22,FALSE,"12/3/2000",2000,"December","2000s",30,64,8
"7897","200012030nor","New Orleans Saints",23,"Denver Broncos",38,61,-15,FALSE,"12/3/2000",2000,"December","2000s",72,NA,NA
"7898","200012030jax","Jacksonville Jaguars",48,"Cleveland Browns",0,48,48,TRUE,"12/3/2000",2000,"December","2000s",49,88,15
"7899","200012030atl","Atlanta Falcons",10,"Seattle Seahawks",30,40,-20,FALSE,"12/3/2000",2000,"December","2000s",72,NA,NA
"7900","200012040nwe","New England Patriots",30,"Kansas City Chiefs",24,54,6,TRUE,"12/4/2000",2000,"December","2000s",34,40,10
"7901","200012100kan","Kansas City Chiefs",15,"Carolina Panthers",14,29,1,TRUE,"12/10/2000",2000,"December","2000s",34,80,14
"7902","200012100nyg","New York Giants",30,"Pittsburgh Steelers",10,40,20,TRUE,"12/10/2000",2000,"December","2000s",32,63,9
"7903","200012100den","Denver Broncos",31,"Seattle Seahawks",24,55,7,TRUE,"12/10/2000",2000,"December","2000s",28,66,13
"7904","200012100gnb","Green Bay Packers",26,"Detroit Lions",13,39,13,TRUE,"12/10/2000",2000,"December","2000s",24,79,11
"7905","200012100dal","Dallas Cowboys",32,"Washington Redskins",13,45,19,TRUE,"12/10/2000",2000,"December","2000s",54,91,12
"7906","200012100jax","Jacksonville Jaguars",44,"Arizona Cardinals",10,54,34,TRUE,"12/10/2000",2000,"December","2000s",56,91,8
"7907","200012100rai","Oakland Raiders",31,"New York Jets",7,38,24,TRUE,"12/10/2000",2000,"December","2000s",54,92,6
"7908","200012100oti","Tennessee Titans",35,"Cincinnati Bengals",3,38,32,TRUE,"12/10/2000",2000,"December","2000s",46,79,7
"7909","200012100rav","Baltimore Ravens",24,"San Diego Chargers",3,27,21,TRUE,"12/10/2000",2000,"December","2000s",31,76,4
"7910","200012100mia","Miami Dolphins",13,"Tampa Bay Buccaneers",16,29,-3,FALSE,"12/10/2000",2000,"December","2000s",73,92,12
"7911","200012100ram","St. Louis Rams",40,"Minnesota Vikings",29,69,11,TRUE,"12/10/2000",2000,"December","2000s",72,NA,NA
"7912","200012100sfo","San Francisco 49ers",27,"New Orleans Saints",31,58,-4,FALSE,"12/10/2000",2000,"December","2000s",54,87,8
"7913","200012100chi","Chicago Bears",24,"New England Patriots",17,41,7,TRUE,"12/10/2000",2000,"December","2000s",31,76,10
"7914","200012100cle","Cleveland Browns",24,"Philadelphia Eagles",35,59,-11,FALSE,"12/10/2000",2000,"December","2000s",29,74,10
"7915","200012110clt","Indianapolis Colts",44,"Buffalo Bills",20,64,24,TRUE,"12/11/2000",2000,"December","2000s",72,NA,NA
"7916","200012160pit","Pittsburgh Steelers",24,"Washington Redskins",3,27,21,TRUE,"12/16/2000",2000,"December","2000s",37,79,9
"7917","200012160sea","Seattle Seahawks",27,"Oakland Raiders",24,51,3,TRUE,"12/16/2000",2000,"December","2000s",42,75,16
"7918","200012170mia","Miami Dolphins",13,"Indianapolis Colts",20,33,-7,FALSE,"12/17/2000",2000,"December","2000s",77,84,8
"7919","200012170cin","Cincinnati Bengals",17,"Jacksonville Jaguars",14,31,3,TRUE,"12/17/2000",2000,"December","2000s",22,81,21
"7920","200012170crd","Arizona Cardinals",7,"Baltimore Ravens",13,20,-6,FALSE,"12/17/2000",2000,"December","2000s",55,39,4
"7921","200012170sfo","San Francisco 49ers",17,"Chicago Bears",0,17,17,TRUE,"12/17/2000",2000,"December","2000s",53,73,6
"7922","200012170nor","New Orleans Saints",23,"Atlanta Falcons",7,30,16,TRUE,"12/17/2000",2000,"December","2000s",72,NA,NA
"7923","200012170car","Carolina Panthers",30,"San Diego Chargers",22,52,8,TRUE,"12/17/2000",2000,"December","2000s",47,67,16
"7924","200012170min","Minnesota Vikings",28,"Green Bay Packers",33,61,-5,FALSE,"12/17/2000",2000,"December","2000s",72,NA,NA
"7925","200012170buf","Buffalo Bills",10,"New England Patriots",13,23,-3,FALSE,"12/17/2000",2000,"December","2000s",40,91,22
"7926","200012170kan","Kansas City Chiefs",20,"Denver Broncos",7,27,13,TRUE,"12/17/2000",2000,"December","2000s",5,64,17
"7927","200012170dal","Dallas Cowboys",13,"New York Giants",17,30,-4,FALSE,"12/17/2000",2000,"December","2000s",32,48,10
"7928","200012170nyj","New York Jets",7,"Detroit Lions",10,17,-3,FALSE,"12/17/2000",2000,"December","2000s",54,96,19
"7929","200012170cle","Cleveland Browns",0,"Tennessee Titans",24,24,-24,FALSE,"12/17/2000",2000,"December","2000s",34,93,22
"7930","200012180tam","Tampa Bay Buccaneers",38,"St. Louis Rams",35,73,3,TRUE,"12/18/2000",2000,"December","2000s",47,54,9
"7931","200012230sea","Seattle Seahawks",23,"Buffalo Bills",42,65,-19,FALSE,"12/23/2000",2000,"December","2000s",44,88,10
"7932","200012230den","Denver Broncos",38,"San Francisco 49ers",9,47,29,TRUE,"12/23/2000",2000,"December","2000s",34,53,11
"7933","200012230nyg","New York Giants",28,"Jacksonville Jaguars",25,53,3,TRUE,"12/23/2000",2000,"December","2000s",22,54,20
"7934","200012240phi","Philadelphia Eagles",16,"Cincinnati Bengals",7,23,9,TRUE,"12/24/2000",2000,"December","2000s",26,62,8
"7935","200012240sdg","San Diego Chargers",21,"Pittsburgh Steelers",34,55,-13,FALSE,"12/24/2000",2000,"December","2000s",53,84,5
"7936","200012240clt","Indianapolis Colts",31,"Minnesota Vikings",10,41,21,TRUE,"12/24/2000",2000,"December","2000s",72,NA,NA
"7937","200012240det","Detroit Lions",20,"Chicago Bears",23,43,-3,FALSE,"12/24/2000",2000,"December","2000s",72,NA,NA
"7938","200012240atl","Atlanta Falcons",29,"Kansas City Chiefs",13,42,16,TRUE,"12/24/2000",2000,"December","2000s",72,NA,NA
"7939","200012240rav","Baltimore Ravens",34,"New York Jets",20,54,14,TRUE,"12/24/2000",2000,"December","2000s",24,61,3
"7940","200012240nwe","New England Patriots",24,"Miami Dolphins",27,51,-3,FALSE,"12/24/2000",2000,"December","2000s",26,56,12
"7941","200012240rai","Oakland Raiders",52,"Carolina Panthers",9,61,43,TRUE,"12/24/2000",2000,"December","2000s",50,86,6
"7942","200012240nor","New Orleans Saints",21,"St. Louis Rams",26,47,-5,FALSE,"12/24/2000",2000,"December","2000s",72,NA,NA
"7943","200012240gnb","Green Bay Packers",17,"Tampa Bay Buccaneers",14,31,3,TRUE,"12/24/2000",2000,"December","2000s",6,72,12
"7944","200012240was","Washington Redskins",20,"Arizona Cardinals",3,23,17,TRUE,"12/24/2000",2000,"December","2000s",28,60,9
"7945","200012250oti","Tennessee Titans",31,"Dallas Cowboys",0,31,31,TRUE,"12/25/2000",2000,"December","2000s",20,56,10
"7946","200012300mia","Miami Dolphins",23,"Indianapolis Colts",17,40,6,TRUE,"12/30/2000",2000,"December","2000s",56,75,10
"7947","200012300nor","New Orleans Saints",31,"St. Louis Rams",28,59,3,TRUE,"12/30/2000",2000,"December","2000s",72,NA,NA
"7948","200012310phi","Philadelphia Eagles",21,"Tampa Bay Buccaneers",3,24,18,TRUE,"12/31/2000",2000,"December","2000s",27,59,21
"7949","200012310rav","Baltimore Ravens",21,"Denver Broncos",3,24,18,TRUE,"12/31/2000",2000,"December","2000s",28,48,21
"7950","200101060min","Minnesota Vikings",34,"New Orleans Saints",16,50,18,TRUE,"1/6/2001",2001,"January","2000s",72,NA,NA
"7951","200101060rai","Oakland Raiders",27,"Miami Dolphins",0,27,27,TRUE,"1/6/2001",2001,"January","2000s",46,81,4
"7952","200101070nyg","New York Giants",20,"Philadelphia Eagles",10,30,10,TRUE,"1/7/2001",2001,"January","2000s",35,59,10
"7953","200101070oti","Tennessee Titans",10,"Baltimore Ravens",24,34,-14,FALSE,"1/7/2001",2001,"January","2000s",43,48,6
"7954","200101140rai","Oakland Raiders",3,"Baltimore Ravens",16,19,-13,FALSE,"1/14/2001",2001,"January","2000s",50,83,7
"7955","200101140nyg","New York Giants",41,"Minnesota Vikings",0,41,41,TRUE,"1/14/2001",2001,"January","2000s",37,66,6
"7956","200101280nyg","New York Giants",7,"Baltimore Ravens",34,41,-27,FALSE,"1/28/2001",2001,"January","2000s",57,80,5
"7957","200109090sfo","San Francisco 49ers",16,"Atlanta Falcons",13,29,3,TRUE,"9/9/2001",2001,"September","2000s",62,70,12
"7958","200109090min","Minnesota Vikings",13,"Carolina Panthers",24,37,-11,FALSE,"9/9/2001",2001,"September","2000s",72,NA,NA
"7959","200109090dal","Dallas Cowboys",6,"Tampa Bay Buccaneers",10,16,-4,FALSE,"9/9/2001",2001,"September","2000s",75,78,13
"7960","200109090buf","Buffalo Bills",6,"New Orleans Saints",24,30,-18,FALSE,"9/9/2001",2001,"September","2000s",80,58,12
"7961","200109090jax","Jacksonville Jaguars",21,"Pittsburgh Steelers",3,24,18,TRUE,"9/9/2001",2001,"September","2000s",80,78,10
"7962","200109090nyj","New York Jets",24,"Indianapolis Colts",45,69,-21,FALSE,"9/9/2001",2001,"September","2000s",76,70,12
"7963","200109090rav","Baltimore Ravens",17,"Chicago Bears",6,23,11,TRUE,"9/9/2001",2001,"September","2000s",72,79,6
"7964","200109090phi","Philadelphia Eagles",17,"St. Louis Rams",20,37,-3,FALSE,"9/9/2001",2001,"September","2000s",76,74,8
"7965","200109090cin","Cincinnati Bengals",23,"New England Patriots",17,40,6,TRUE,"9/9/2001",2001,"September","2000s",75,84,11
"7966","200109090gnb","Green Bay Packers",28,"Detroit Lions",6,34,22,TRUE,"9/9/2001",2001,"September","2000s",61,93,7
"7967","200109090kan","Kansas City Chiefs",24,"Oakland Raiders",27,51,-3,FALSE,"9/9/2001",2001,"September","2000s",64,78,10
"7968","200109090sdg","San Diego Chargers",30,"Washington Redskins",3,33,27,TRUE,"9/9/2001",2001,"September","2000s",66,88,9
"7969","200109090cle","Cleveland Browns",6,"Seattle Seahawks",9,15,-3,FALSE,"9/9/2001",2001,"September","2000s",79,68,14
"7970","200109090oti","Tennessee Titans",23,"Miami Dolphins",31,54,-8,FALSE,"9/9/2001",2001,"September","2000s",79,75,14
"7971","200109100den","Denver Broncos",31,"New York Giants",20,51,11,TRUE,"9/10/2001",2001,"September","2000s",62,32,12
"7972","200109230crd","Arizona Cardinals",17,"Denver Broncos",38,55,-21,FALSE,"9/23/2001",2001,"September","2000s",91,18,6
"7973","200109230dal","Dallas Cowboys",21,"San Diego Chargers",32,53,-11,FALSE,"9/23/2001",2001,"September","2000s",76,80,7
"7974","200109230chi","Chicago Bears",17,"Minnesota Vikings",10,27,7,TRUE,"9/23/2001",2001,"September","2000s",61,86,9
"7975","200109230sea","Seattle Seahawks",3,"Philadelphia Eagles",27,30,-24,FALSE,"9/23/2001",2001,"September","2000s",63,77,3
"7976","200109230jax","Jacksonville Jaguars",13,"Tennessee Titans",6,19,7,TRUE,"9/23/2001",2001,"September","2000s",78,86,8
"7977","200109230cle","Cleveland Browns",24,"Detroit Lions",14,38,10,TRUE,"9/23/2001",2001,"September","2000s",63,69,9
"7978","200109230cin","Cincinnati Bengals",21,"Baltimore Ravens",10,31,11,TRUE,"9/23/2001",2001,"September","2000s",66,73,6
"7979","200109230kan","Kansas City Chiefs",3,"New York Giants",13,16,-10,FALSE,"9/23/2001",2001,"September","2000s",64,85,14
"7980","200109230clt","Indianapolis Colts",42,"Buffalo Bills",26,68,16,TRUE,"9/23/2001",2001,"September","2000s",72,NA,NA
"7981","200109230mia","Miami Dolphins",18,"Oakland Raiders",15,33,3,TRUE,"9/23/2001",2001,"September","2000s",83,72,9
"7982","200109230atl","Atlanta Falcons",24,"Carolina Panthers",16,40,8,TRUE,"9/23/2001",2001,"September","2000s",72,NA,NA
"7983","200109230nwe","New England Patriots",3,"New York Jets",10,13,-7,FALSE,"9/23/2001",2001,"September","2000s",68,79,7
"7984","200109230sfo","San Francisco 49ers",26,"St. Louis Rams",30,56,-4,FALSE,"9/23/2001",2001,"September","2000s",58,86,13
"7985","200109240gnb","Green Bay Packers",37,"Washington Redskins",0,37,37,TRUE,"9/24/2001",2001,"September","2000s",46,72,18
"7986","200109300nyg","New York Giants",21,"New Orleans Saints",13,34,8,TRUE,"9/30/2001",2001,"September","2000s",54,63,20
"7987","200109300crd","Arizona Cardinals",14,"Atlanta Falcons",34,48,-20,FALSE,"9/30/2001",2001,"September","2000s",92,18,15
"7988","200109300den","Denver Broncos",13,"Baltimore Ravens",20,33,-7,FALSE,"9/30/2001",2001,"September","2000s",62,52,11
"7989","200109300rai","Oakland Raiders",38,"Seattle Seahawks",14,52,24,TRUE,"9/30/2001",2001,"September","2000s",66,66,8
"7990","200109300nwe","New England Patriots",44,"Indianapolis Colts",13,57,31,TRUE,"9/30/2001",2001,"September","2000s",55,69,22
"7991","200109300sdg","San Diego Chargers",28,"Cincinnati Bengals",14,42,14,TRUE,"9/30/2001",2001,"September","2000s",66,90,6
"7992","200109300was","Washington Redskins",13,"Kansas City Chiefs",45,58,-32,FALSE,"9/30/2001",2001,"September","2000s",57,59,17
"7993","200109300phi","Philadelphia Eagles",40,"Dallas Cowboys",18,58,22,TRUE,"9/30/2001",2001,"September","2000s",55,61,19
"7994","200109300jax","Jacksonville Jaguars",14,"Cleveland Browns",23,37,-9,FALSE,"9/30/2001",2001,"September","2000s",67,67,19
"7995","200109300ram","St. Louis Rams",42,"Miami Dolphins",10,52,32,TRUE,"9/30/2001",2001,"September","2000s",72,NA,NA
"7996","200109300buf","Buffalo Bills",3,"Pittsburgh Steelers",20,23,-17,FALSE,"9/30/2001",2001,"September","2000s",53,66,6
"7997","200109300car","Carolina Panthers",7,"Green Bay Packers",28,35,-21,FALSE,"9/30/2001",2001,"September","2000s",57,61,11
"7998","200109300min","Minnesota Vikings",20,"Tampa Bay Buccaneers",16,36,4,TRUE,"9/30/2001",2001,"September","2000s",72,NA,NA
"7999","200110010nyj","New York Jets",17,"San Francisco 49ers",19,36,-2,FALSE,"10/1/2001",2001,"October","2000s",54,66,17
"8000","200110070rav","Baltimore Ravens",26,"Tennessee Titans",7,33,19,TRUE,"10/7/2001",2001,"October","2000s",48,52,14
"8001","200110070phi","Philadelphia Eagles",20,"Arizona Cardinals",21,41,-1,FALSE,"10/7/2001",2001,"October","2000s",52,44,16
"8002","200110070nyg","New York Giants",23,"Washington Redskins",9,32,14,TRUE,"10/7/2001",2001,"October","2000s",54,47,17
"8003","200110070sea","Seattle Seahawks",24,"Jacksonville Jaguars",15,39,9,TRUE,"10/7/2001",2001,"October","2000s",52,75,8
"8004","200110070rai","Oakland Raiders",28,"Dallas Cowboys",21,49,7,TRUE,"10/7/2001",2001,"October","2000s",58,83,8
"8005","200110070pit","Pittsburgh Steelers",16,"Cincinnati Bengals",7,23,9,TRUE,"10/7/2001",2001,"October","2000s",42,57,13
"8006","200110070den","Denver Broncos",20,"Kansas City Chiefs",6,26,14,TRUE,"10/7/2001",2001,"October","2000s",61,28,13
"8007","200110070mia","Miami Dolphins",30,"New England Patriots",10,40,20,TRUE,"10/7/2001",2001,"October","2000s",82,80,7
"8008","200110070cle","Cleveland Browns",20,"San Diego Chargers",16,36,4,TRUE,"10/7/2001",2001,"October","2000s",44,52,14
"8009","200110070tam","Tampa Bay Buccaneers",14,"Green Bay Packers",10,24,4,TRUE,"10/7/2001",2001,"October","2000s",81,81,8
"8010","200110070nor","New Orleans Saints",28,"Minnesota Vikings",15,43,13,TRUE,"10/7/2001",2001,"October","2000s",72,NA,NA
"8011","200110070sfo","San Francisco 49ers",24,"Carolina Panthers",14,38,10,TRUE,"10/7/2001",2001,"October","2000s",59,81,9
"8012","200110070atl","Atlanta Falcons",3,"Chicago Bears",31,34,-28,FALSE,"10/7/2001",2001,"October","2000s",72,NA,NA
"8013","200110070buf","Buffalo Bills",36,"New York Jets",42,78,-6,FALSE,"10/7/2001",2001,"October","2000s",42,61,16
"8014","200110080det","Detroit Lions",0,"St. Louis Rams",35,35,-35,FALSE,"10/8/2001",2001,"October","2000s",72,NA,NA
"8015","200110140chi","Chicago Bears",20,"Arizona Cardinals",13,33,7,TRUE,"10/14/2001",2001,"October","2000s",54,80,11
"8016","200110140clt","Indianapolis Colts",18,"Oakland Raiders",23,41,-5,FALSE,"10/14/2001",2001,"October","2000s",72,NA,NA
"8017","200110140oti","Tennessee Titans",31,"Tampa Bay Buccaneers",28,59,3,TRUE,"10/14/2001",2001,"October","2000s",66,75,12
"8018","200110140min","Minnesota Vikings",31,"Detroit Lions",26,57,5,TRUE,"10/14/2001",2001,"October","2000s",72,NA,NA
"8019","200110140sea","Seattle Seahawks",34,"Denver Broncos",21,55,13,TRUE,"10/14/2001",2001,"October","2000s",53,87,12
"8020","200110140gnb","Green Bay Packers",31,"Baltimore Ravens",23,54,8,TRUE,"10/14/2001",2001,"October","2000s",53,80,12
"8021","200110140nyj","New York Jets",21,"Miami Dolphins",17,38,4,TRUE,"10/14/2001",2001,"October","2000s",62,80,11
"8022","200110140atl","Atlanta Falcons",31,"San Francisco 49ers",37,68,-6,FALSE,"10/14/2001",2001,"October","2000s",72,NA,NA
"8023","200110140car","Carolina Panthers",25,"New Orleans Saints",27,52,-2,FALSE,"10/14/2001",2001,"October","2000s",70,84,15
"8024","200110140nwe","New England Patriots",29,"San Diego Chargers",26,55,3,TRUE,"10/14/2001",2001,"October","2000s",54,100,10
"8025","200110140cin","Cincinnati Bengals",24,"Cleveland Browns",14,38,10,TRUE,"10/14/2001",2001,"October","2000s",62,82,19
"8026","200110140ram","St. Louis Rams",15,"New York Giants",14,29,1,TRUE,"10/14/2001",2001,"October","2000s",72,NA,NA
"8027","200110140kan","Kansas City Chiefs",17,"Pittsburgh Steelers",20,37,-3,FALSE,"10/14/2001",2001,"October","2000s",53,61,14
"8028","200110150dal","Dallas Cowboys",9,"Washington Redskins",7,16,2,TRUE,"10/15/2001",2001,"October","2000s",65,60,16
"8029","200110180jax","Jacksonville Jaguars",10,"Buffalo Bills",13,23,-3,FALSE,"10/18/2001",2001,"October","2000s",62,73,15
"8030","200110210clt","Indianapolis Colts",17,"New England Patriots",38,55,-21,FALSE,"10/21/2001",2001,"October","2000s",72,NA,NA
"8031","200110210tam","Tampa Bay Buccaneers",10,"Pittsburgh Steelers",17,27,-7,FALSE,"10/21/2001",2001,"October","2000s",77,84,8
"8032","200110210det","Detroit Lions",24,"Tennessee Titans",27,51,-3,FALSE,"10/21/2001",2001,"October","2000s",72,NA,NA
"8033","200110210cin","Cincinnati Bengals",0,"Chicago Bears",24,24,-24,FALSE,"10/21/2001",2001,"October","2000s",60,74,8
"8034","200110210crd","Arizona Cardinals",24,"Kansas City Chiefs",16,40,8,TRUE,"10/21/2001",2001,"October","2000s",79,23,7
"8035","200110210sdg","San Diego Chargers",27,"Denver Broncos",10,37,17,TRUE,"10/21/2001",2001,"October","2000s",64,86,6
"8036","200110210was","Washington Redskins",17,"Carolina Panthers",14,31,3,TRUE,"10/21/2001",2001,"October","2000s",62,68,9
"8037","200110210min","Minnesota Vikings",35,"Green Bay Packers",13,48,22,TRUE,"10/21/2001",2001,"October","2000s",72,NA,NA
"8038","200110210nor","New Orleans Saints",13,"Atlanta Falcons",20,33,-7,FALSE,"10/21/2001",2001,"October","2000s",72,NA,NA
"8039","200110210cle","Cleveland Browns",24,"Baltimore Ravens",14,38,10,TRUE,"10/21/2001",2001,"October","2000s",60,71,15
"8040","200110210nyj","New York Jets",14,"St. Louis Rams",34,48,-20,FALSE,"10/21/2001",2001,"October","2000s",64,55,10
"8041","200110220nyg","New York Giants",9,"Philadelphia Eagles",10,19,-1,FALSE,"10/22/2001",2001,"October","2000s",65,66,11
"8042","200110250kan","Kansas City Chiefs",28,"Indianapolis Colts",35,63,-7,FALSE,"10/25/2001",2001,"October","2000s",48,50,16
"8043","200110280ram","St. Louis Rams",31,"New Orleans Saints",34,65,-3,FALSE,"10/28/2001",2001,"October","2000s",72,NA,NA
"8044","200110280sea","Seattle Seahawks",20,"Miami Dolphins",24,44,-4,FALSE,"10/28/2001",2001,"October","2000s",40,91,5
"8045","200110280phi","Philadelphia Eagles",10,"Oakland Raiders",20,30,-10,FALSE,"10/28/2001",2001,"October","2000s",46,45,15
"8046","200110280sdg","San Diego Chargers",27,"Buffalo Bills",24,51,3,TRUE,"10/28/2001",2001,"October","2000s",65,82,7
"8047","200110280rav","Baltimore Ravens",18,"Jacksonville Jaguars",17,35,1,TRUE,"10/28/2001",2001,"October","2000s",44,45,10
"8048","200110280dal","Dallas Cowboys",17,"Arizona Cardinals",3,20,14,TRUE,"10/28/2001",2001,"October","2000s",58,52,12
"8049","200110280chi","Chicago Bears",37,"San Francisco 49ers",31,68,6,TRUE,"10/28/2001",2001,"October","2000s",40,59,12
"8050","200110280det","Detroit Lions",27,"Cincinnati Bengals",31,58,-4,FALSE,"10/28/2001",2001,"October","2000s",72,NA,NA
"8051","200110280den","Denver Broncos",31,"New England Patriots",20,51,11,TRUE,"10/28/2001",2001,"October","2000s",62,24,14
"8052","200110280tam","Tampa Bay Buccaneers",41,"Minnesota Vikings",14,55,27,TRUE,"10/28/2001",2001,"October","2000s",59,51,11
"8053","200110280was","Washington Redskins",35,"New York Giants",21,56,14,TRUE,"10/28/2001",2001,"October","2000s",46,46,15
"8054","200110280car","Carolina Panthers",12,"New York Jets",13,25,-1,FALSE,"10/28/2001",2001,"October","2000s",40,52,8
"8055","200110290pit","Pittsburgh Steelers",34,"Tennessee Titans",7,41,27,TRUE,"10/29/2001",2001,"October","2000s",41,55,6
"8056","200111040atl","Atlanta Falcons",10,"New England Patriots",24,34,-14,FALSE,"11/4/2001",2001,"November","2000s",72,NA,NA
"8057","200111040sfo","San Francisco 49ers",21,"Detroit Lions",13,34,8,TRUE,"11/4/2001",2001,"November","2000s",56,87,13
"8058","200111040oti","Tennessee Titans",28,"Jacksonville Jaguars",24,52,4,TRUE,"11/4/2001",2001,"November","2000s",58,44,7
"8059","200111040was","Washington Redskins",27,"Seattle Seahawks",14,41,13,TRUE,"11/4/2001",2001,"November","2000s",58,47,9
"8060","200111040crd","Arizona Cardinals",7,"Philadelphia Eagles",21,28,-14,FALSE,"11/4/2001",2001,"November","2000s",83,30,12
"8061","200111040nyg","New York Giants",27,"Dallas Cowboys",24,51,3,TRUE,"11/4/2001",2001,"November","2000s",56,47,10
"8062","200111040pit","Pittsburgh Steelers",10,"Baltimore Ravens",13,23,-3,FALSE,"11/4/2001",2001,"November","2000s",50,60,13
"8063","200111040gnb","Green Bay Packers",21,"Tampa Bay Buccaneers",20,41,1,TRUE,"11/4/2001",2001,"November","2000s",46,53,10
"8064","200111040nor","New Orleans Saints",9,"New York Jets",16,25,-7,FALSE,"11/4/2001",2001,"November","2000s",72,NA,NA
"8065","200111040chi","Chicago Bears",27,"Cleveland Browns",21,48,6,TRUE,"11/4/2001",2001,"November","2000s",53,58,8
"8066","200111040buf","Buffalo Bills",14,"Indianapolis Colts",30,44,-16,FALSE,"11/4/2001",2001,"November","2000s",48,76,14
"8067","200111040mia","Miami Dolphins",23,"Carolina Panthers",6,29,17,TRUE,"11/4/2001",2001,"November","2000s",77,80,17
"8068","200111040sdg","San Diego Chargers",20,"Kansas City Chiefs",25,45,-5,FALSE,"11/4/2001",2001,"November","2000s",65,91,10
"8069","200111050rai","Oakland Raiders",38,"Denver Broncos",28,66,10,TRUE,"11/5/2001",2001,"November","2000s",56,82,8
"8070","200111110det","Detroit Lions",17,"Tampa Bay Buccaneers",20,37,-3,FALSE,"11/11/2001",2001,"November","2000s",72,NA,NA
"8071","200111110phi","Philadelphia Eagles",48,"Minnesota Vikings",17,65,31,TRUE,"11/11/2001",2001,"November","2000s",50,40,16
"8072","200111110sfo","San Francisco 49ers",28,"New Orleans Saints",27,55,1,TRUE,"11/11/2001",2001,"November","2000s",62,88,13
"8073","200111110cle","Cleveland Browns",12,"Pittsburgh Steelers",15,27,-3,FALSE,"11/11/2001",2001,"November","2000s",44,70,14
"8074","200111110atl","Atlanta Falcons",20,"Dallas Cowboys",13,33,7,TRUE,"11/11/2001",2001,"November","2000s",72,NA,NA
"8075","200111110jax","Jacksonville Jaguars",30,"Cincinnati Bengals",13,43,17,TRUE,"11/11/2001",2001,"November","2000s",63,76,5
"8076","200111110chi","Chicago Bears",12,"Green Bay Packers",20,32,-8,FALSE,"11/11/2001",2001,"November","2000s",44,66,10
"8077","200111110nwe","New England Patriots",21,"Buffalo Bills",11,32,10,TRUE,"11/11/2001",2001,"November","2000s",44,60,15
"8078","200111110clt","Indianapolis Colts",24,"Miami Dolphins",27,51,-3,FALSE,"11/11/2001",2001,"November","2000s",72,NA,NA
"8079","200111110crd","Arizona Cardinals",10,"New York Giants",17,27,-7,FALSE,"11/11/2001",2001,"November","2000s",73,40,6
"8080","200111110sea","Seattle Seahawks",34,"Oakland Raiders",27,61,7,TRUE,"11/11/2001",2001,"November","2000s",49,79,5
"8081","200111110ram","St. Louis Rams",48,"Carolina Panthers",14,62,34,TRUE,"11/11/2001",2001,"November","2000s",72,NA,NA
"8082","200111110nyj","New York Jets",27,"Kansas City Chiefs",7,34,20,TRUE,"11/11/2001",2001,"November","2000s",50,39,16
"8083","200111110den","Denver Broncos",26,"San Diego Chargers",16,42,10,TRUE,"11/11/2001",2001,"November","2000s",44,35,10
"8084","200111120oti","Tennessee Titans",10,"Baltimore Ravens",16,26,-6,FALSE,"11/12/2001",2001,"November","2000s",50,59,8
"8085","200111180tam","Tampa Bay Buccaneers",24,"Chicago Bears",27,51,-3,FALSE,"11/18/2001",2001,"November","2000s",72,73,7
"8086","200111180dal","Dallas Cowboys",3,"Philadelphia Eagles",36,39,-33,FALSE,"11/18/2001",2001,"November","2000s",66,72,11
"8087","200111180rai","Oakland Raiders",34,"San Diego Chargers",24,58,10,TRUE,"11/18/2001",2001,"November","2000s",54,81,7
"8088","200111180crd","Arizona Cardinals",45,"Detroit Lions",38,83,7,TRUE,"11/18/2001",2001,"November","2000s",70,36,6
"8089","200111180gnb","Green Bay Packers",20,"Atlanta Falcons",23,43,-3,FALSE,"11/18/2001",2001,"November","2000s",54,87,11
"8090","200111180mia","Miami Dolphins",0,"New York Jets",24,24,-24,FALSE,"11/18/2001",2001,"November","2000s",75,76,11
"8091","200111180buf","Buffalo Bills",20,"Seattle Seahawks",23,43,-3,FALSE,"11/18/2001",2001,"November","2000s",45,75,10
"8092","200111180cin","Cincinnati Bengals",7,"Tennessee Titans",20,27,-13,FALSE,"11/18/2001",2001,"November","2000s",54,81,5
"8093","200111180pit","Pittsburgh Steelers",20,"Jacksonville Jaguars",7,27,13,TRUE,"11/18/2001",2001,"November","2000s",41,88,4
"8094","200111180nor","New Orleans Saints",34,"Indianapolis Colts",20,54,14,TRUE,"11/18/2001",2001,"November","2000s",72,NA,NA
"8095","200111180rav","Baltimore Ravens",17,"Cleveland Browns",27,44,-10,FALSE,"11/18/2001",2001,"November","2000s",43,86,4
"8096","200111180nwe","New England Patriots",17,"St. Louis Rams",24,41,-7,FALSE,"11/18/2001",2001,"November","2000s",44,73,11
"8097","200111180car","Carolina Panthers",22,"San Francisco 49ers",25,47,-3,FALSE,"11/18/2001",2001,"November","2000s",55,76,5
"8098","200111180den","Denver Broncos",10,"Washington Redskins",17,27,-7,FALSE,"11/18/2001",2001,"November","2000s",42,60,15
"8099","200111190min","Minnesota Vikings",28,"New York Giants",16,44,12,TRUE,"11/19/2001",2001,"November","2000s",72,NA,NA
"8100","200111220dal","Dallas Cowboys",24,"Denver Broncos",26,50,-2,FALSE,"11/22/2001",2001,"November","2000s",56,69,15
"8101","200111220det","Detroit Lions",27,"Green Bay Packers",29,56,-2,FALSE,"11/22/2001",2001,"November","2000s",72,NA,NA
"8102","200111250nwe","New England Patriots",34,"New Orleans Saints",17,51,17,TRUE,"11/25/2001",2001,"November","2000s",52,86,11
"8103","200111250kan","Kansas City Chiefs",19,"Seattle Seahawks",7,26,12,TRUE,"11/25/2001",2001,"November","2000s",46,78,16
"8104","200111250clt","Indianapolis Colts",21,"San Francisco 49ers",40,61,-19,FALSE,"11/25/2001",2001,"November","2000s",72,NA,NA
"8105","200111250phi","Philadelphia Eagles",3,"Washington Redskins",13,16,-10,FALSE,"11/25/2001",2001,"November","2000s",64,74,15
"8106","200111250cle","Cleveland Browns",18,"Cincinnati Bengals",0,18,18,TRUE,"11/25/2001",2001,"November","2000s",59,80,20
"8107","200111250min","Minnesota Vikings",6,"Chicago Bears",13,19,-7,FALSE,"11/25/2001",2001,"November","2000s",72,NA,NA
"8108","200111250car","Carolina Panthers",7,"Atlanta Falcons",10,17,-3,FALSE,"11/25/2001",2001,"November","2000s",67,88,12
"8109","200111250jax","Jacksonville Jaguars",21,"Baltimore Ravens",24,45,-3,FALSE,"11/25/2001",2001,"November","2000s",72,80,8
"8110","200111250oti","Tennessee Titans",24,"Pittsburgh Steelers",34,58,-10,FALSE,"11/25/2001",2001,"November","2000s",59,68,8
"8111","200111250buf","Buffalo Bills",27,"Miami Dolphins",34,61,-7,FALSE,"11/25/2001",2001,"November","2000s",61,74,23
"8112","200111250sdg","San Diego Chargers",17,"Arizona Cardinals",20,37,-3,FALSE,"11/25/2001",2001,"November","2000s",60,69,13
"8113","200111250nyg","New York Giants",10,"Oakland Raiders",28,38,-18,FALSE,"11/25/2001",2001,"November","2000s",62,77,14
"8114","200111260ram","St. Louis Rams",17,"Tampa Bay Buccaneers",24,41,-7,FALSE,"11/26/2001",2001,"November","2000s",72,NA,NA
"8115","200111290kan","Kansas City Chiefs",10,"Philadelphia Eagles",23,33,-13,FALSE,"11/29/2001",2001,"November","2000s",31,84,9
"8116","200112020pit","Pittsburgh Steelers",21,"Minnesota Vikings",16,37,5,TRUE,"12/2/2001",2001,"December","2000s",45,69,5
"8117","200112020rav","Baltimore Ravens",39,"Indianapolis Colts",27,66,12,TRUE,"12/2/2001",2001,"December","2000s",50,62,7
"8118","200112020cin","Cincinnati Bengals",13,"Tampa Bay Buccaneers",16,29,-3,FALSE,"12/2/2001",2001,"December","2000s",42,83,4
"8119","200112020rai","Oakland Raiders",31,"Arizona Cardinals",34,65,-3,FALSE,"12/2/2001",2001,"December","2000s",54,84,23
"8120","200112020was","Washington Redskins",14,"Dallas Cowboys",20,34,-6,FALSE,"12/2/2001",2001,"December","2000s",52,59,12
"8121","200112020chi","Chicago Bears",13,"Detroit Lions",10,23,3,TRUE,"12/2/2001",2001,"December","2000s",37,85,8
"8122","200112020cle","Cleveland Browns",15,"Tennessee Titans",31,46,-16,FALSE,"12/2/2001",2001,"December","2000s",43,82,7
"8123","200112020sfo","San Francisco 49ers",35,"Buffalo Bills",0,35,35,TRUE,"12/2/2001",2001,"December","2000s",55,88,24
"8124","200112020atl","Atlanta Falcons",6,"St. Louis Rams",35,41,-29,FALSE,"12/2/2001",2001,"December","2000s",72,NA,NA
"8125","200112020nor","New Orleans Saints",27,"Carolina Panthers",23,50,4,TRUE,"12/2/2001",2001,"December","2000s",72,NA,NA
"8126","200112020mia","Miami Dolphins",21,"Denver Broncos",10,31,11,TRUE,"12/2/2001",2001,"December","2000s",74,82,7
"8127","200112020sea","Seattle Seahawks",13,"San Diego Chargers",10,23,3,TRUE,"12/2/2001",2001,"December","2000s",42,86,19
"8128","200112020nyj","New York Jets",16,"New England Patriots",17,33,-1,FALSE,"12/2/2001",2001,"December","2000s",53,55,11
"8129","200112030jax","Jacksonville Jaguars",21,"Green Bay Packers",28,49,-7,FALSE,"12/3/2001",2001,"December","2000s",63,89,11
"8130","200112090pit","Pittsburgh Steelers",18,"New York Jets",7,25,11,TRUE,"12/9/2001",2001,"December","2000s",39,86,8
"8131","200112090cin","Cincinnati Bengals",10,"Jacksonville Jaguars",14,24,-4,FALSE,"12/9/2001",2001,"December","2000s",40,74,8
"8132","200112090ram","St. Louis Rams",27,"San Francisco 49ers",14,41,13,TRUE,"12/9/2001",2001,"December","2000s",72,NA,NA
"8133","200112090atl","Atlanta Falcons",10,"New Orleans Saints",28,38,-18,FALSE,"12/9/2001",2001,"December","2000s",72,NA,NA
"8134","200112090min","Minnesota Vikings",42,"Tennessee Titans",24,66,18,TRUE,"12/9/2001",2001,"December","2000s",72,NA,NA
"8135","200112090rai","Oakland Raiders",28,"Kansas City Chiefs",26,54,2,TRUE,"12/9/2001",2001,"December","2000s",51,73,15
"8136","200112090gnb","Green Bay Packers",17,"Chicago Bears",7,24,10,TRUE,"12/9/2001",2001,"December","2000s",28,72,10
"8137","200112090buf","Buffalo Bills",25,"Carolina Panthers",24,49,1,TRUE,"12/9/2001",2001,"December","2000s",36,85,8
"8138","200112090crd","Arizona Cardinals",10,"Washington Redskins",20,30,-10,FALSE,"12/9/2001",2001,"December","2000s",58,29,9
"8139","200112090nwe","New England Patriots",27,"Cleveland Browns",16,43,11,TRUE,"12/9/2001",2001,"December","2000s",34,84,12
"8140","200112090phi","Philadelphia Eagles",24,"San Diego Chargers",14,38,10,TRUE,"12/9/2001",2001,"December","2000s",43,81,16
"8141","200112090tam","Tampa Bay Buccaneers",15,"Detroit Lions",12,27,3,TRUE,"12/9/2001",2001,"December","2000s",75,88,5
"8142","200112090dal","Dallas Cowboys",20,"New York Giants",13,33,7,TRUE,"12/9/2001",2001,"December","2000s",42,46,12
"8143","200112090den","Denver Broncos",20,"Seattle Seahawks",7,27,13,TRUE,"12/9/2001",2001,"December","2000s",38,32,13
"8144","200112100mia","Miami Dolphins",41,"Indianapolis Colts",6,47,35,TRUE,"12/10/2001",2001,"December","2000s",76,79,11
"8145","200112150nyg","New York Giants",17,"Arizona Cardinals",13,30,4,TRUE,"12/15/2001",2001,"December","2000s",51,65,22
"8146","200112150sdg","San Diego Chargers",6,"Oakland Raiders",13,19,-7,FALSE,"12/15/2001",2001,"December","2000s",52,72,10
"8147","200112160sea","Seattle Seahawks",29,"Dallas Cowboys",3,32,26,TRUE,"12/16/2001",2001,"December","2000s",47,94,18
"8148","200112160cle","Cleveland Browns",10,"Jacksonville Jaguars",15,25,-5,FALSE,"12/16/2001",2001,"December","2000s",38,72,9
"8149","200112160buf","Buffalo Bills",9,"New England Patriots",12,21,-3,FALSE,"12/16/2001",2001,"December","2000s",30,91,7
"8150","200112160det","Detroit Lions",27,"Minnesota Vikings",24,51,3,TRUE,"12/16/2001",2001,"December","2000s",72,NA,NA
"8151","200112160clt","Indianapolis Colts",41,"Atlanta Falcons",27,68,14,TRUE,"12/16/2001",2001,"December","2000s",72,NA,NA
"8152","200112160sfo","San Francisco 49ers",21,"Miami Dolphins",0,21,21,TRUE,"12/16/2001",2001,"December","2000s",49,76,6
"8153","200112160was","Washington Redskins",6,"Philadelphia Eagles",20,26,-14,FALSE,"12/16/2001",2001,"December","2000s",42,56,9
"8154","200112160nyj","New York Jets",15,"Cincinnati Bengals",14,29,1,TRUE,"12/16/2001",2001,"December","2000s",37,55,12
"8155","200112160oti","Tennessee Titans",26,"Green Bay Packers",20,46,6,TRUE,"12/16/2001",2001,"December","2000s",55,70,13
"8156","200112160rav","Baltimore Ravens",21,"Pittsburgh Steelers",26,47,-5,FALSE,"12/16/2001",2001,"December","2000s",37,64,4
"8157","200112160chi","Chicago Bears",27,"Tampa Bay Buccaneers",3,30,24,TRUE,"12/16/2001",2001,"December","2000s",41,92,12
"8158","200112160kan","Kansas City Chiefs",26,"Denver Broncos",23,49,3,TRUE,"12/16/2001",2001,"December","2000s",46,94,10
"8159","200112170nor","New Orleans Saints",21,"St. Louis Rams",34,55,-13,FALSE,"12/17/2001",2001,"December","2000s",72,NA,NA
"8160","200112220nwe","New England Patriots",20,"Miami Dolphins",13,33,7,TRUE,"12/22/2001",2001,"December","2000s",32,52,16
"8161","200112220rai","Oakland Raiders",10,"Tennessee Titans",13,23,-3,FALSE,"12/22/2001",2001,"December","2000s",51,84,12
"8162","200112220sfo","San Francisco 49ers",13,"Philadelphia Eagles",3,16,10,TRUE,"12/22/2001",2001,"December","2000s",51,83,13
"8163","200112230gnb","Green Bay Packers",30,"Cleveland Browns",7,37,23,TRUE,"12/23/2001",2001,"December","2000s",30,82,17
"8164","200112230nyg","New York Giants",27,"Seattle Seahawks",24,51,3,TRUE,"12/23/2001",2001,"December","2000s",39,56,9
"8165","200112230car","Carolina Panthers",32,"St. Louis Rams",38,70,-6,FALSE,"12/23/2001",2001,"December","2000s",44,66,9
"8166","200112230clt","Indianapolis Colts",28,"New York Jets",29,57,-1,FALSE,"12/23/2001",2001,"December","2000s",72,NA,NA
"8167","200112230was","Washington Redskins",15,"Chicago Bears",20,35,-5,FALSE,"12/23/2001",2001,"December","2000s",41,58,11
"8168","200112230crd","Arizona Cardinals",17,"Dallas Cowboys",10,27,7,TRUE,"12/23/2001",2001,"December","2000s",51,46,6
"8169","200112230tam","Tampa Bay Buccaneers",48,"New Orleans Saints",21,69,27,TRUE,"12/23/2001",2001,"December","2000s",67,71,8
"8170","200112230rav","Baltimore Ravens",16,"Cincinnati Bengals",0,16,16,TRUE,"12/23/2001",2001,"December","2000s",36,68,7
"8171","200112230kan","Kansas City Chiefs",20,"San Diego Chargers",17,37,3,TRUE,"12/23/2001",2001,"December","2000s",28,58,17
"8172","200112230min","Minnesota Vikings",3,"Jacksonville Jaguars",33,36,-30,FALSE,"12/23/2001",2001,"December","2000s",72,NA,NA
"8173","200112230pit","Pittsburgh Steelers",47,"Detroit Lions",14,61,33,TRUE,"12/23/2001",2001,"December","2000s",40,63,8
"8174","200112230atl","Atlanta Falcons",33,"Buffalo Bills",30,63,3,TRUE,"12/23/2001",2001,"December","2000s",72,NA,NA
"8175","200112290tam","Tampa Bay Buccaneers",22,"Baltimore Ravens",10,32,12,TRUE,"12/29/2001",2001,"December","2000s",67,76,9
"8176","200112300mia","Miami Dolphins",21,"Atlanta Falcons",14,35,7,TRUE,"12/30/2001",2001,"December","2000s",70,77,4
"8177","200112300det","Detroit Lions",0,"Chicago Bears",24,24,-24,FALSE,"12/30/2001",2001,"December","2000s",72,NA,NA
"8178","200112300gnb","Green Bay Packers",24,"Minnesota Vikings",13,37,11,TRUE,"12/30/2001",2001,"December","2000s",13,67,14
"8179","200112300ram","St. Louis Rams",42,"Indianapolis Colts",17,59,25,TRUE,"12/30/2001",2001,"December","2000s",72,NA,NA
"8180","200112300oti","Tennessee Titans",38,"Cleveland Browns",41,79,-3,FALSE,"12/30/2001",2001,"December","2000s",24,59,7
"8181","200112300nyj","New York Jets",9,"Buffalo Bills",14,23,-5,FALSE,"12/30/2001",2001,"December","2000s",29,47,19
"8182","200112300cin","Cincinnati Bengals",26,"Pittsburgh Steelers",23,49,3,TRUE,"12/30/2001",2001,"December","2000s",17,65,11
"8183","200112300dal","Dallas Cowboys",27,"San Francisco 49ers",21,48,6,TRUE,"12/30/2001",2001,"December","2000s",34,50,12
"8184","200112300den","Denver Broncos",23,"Oakland Raiders",17,40,6,TRUE,"12/30/2001",2001,"December","2000s",21,76,10
"8185","200112300car","Carolina Panthers",7,"Arizona Cardinals",30,37,-23,FALSE,"12/30/2001",2001,"December","2000s",36,46,7
"8186","200112300nor","New Orleans Saints",10,"Washington Redskins",40,50,-30,FALSE,"12/30/2001",2001,"December","2000s",72,NA,NA
"8187","200112300phi","Philadelphia Eagles",24,"New York Giants",21,45,3,TRUE,"12/30/2001",2001,"December","2000s",28,45,16
"8188","200112300jax","Jacksonville Jaguars",26,"Kansas City Chiefs",30,56,-4,FALSE,"12/30/2001",2001,"December","2000s",55,66,10
"8189","200112300sdg","San Diego Chargers",22,"Seattle Seahawks",25,47,-3,FALSE,"12/30/2001",2001,"December","2000s",59,80,5
"8190","200201060ram","St. Louis Rams",31,"Atlanta Falcons",13,44,18,TRUE,"1/6/2002",2002,"January","2000s",72,NA,NA
"8191","200201060clt","Indianapolis Colts",29,"Denver Broncos",10,39,19,TRUE,"1/6/2002",2002,"January","2000s",72,NA,NA
"8192","200201060sea","Seattle Seahawks",21,"Kansas City Chiefs",18,39,3,TRUE,"1/6/2002",2002,"January","2000s",46,86,10
"8193","200201060pit","Pittsburgh Steelers",28,"Cleveland Browns",7,35,21,TRUE,"1/6/2002",2002,"January","2000s",32,66,6
"8194","200201060chi","Chicago Bears",33,"Jacksonville Jaguars",13,46,20,TRUE,"1/6/2002",2002,"January","2000s",32,82,12
"8195","200201060car","Carolina Panthers",6,"New England Patriots",38,44,-32,FALSE,"1/6/2002",2002,"January","2000s",35,79,6
"8196","200201060was","Washington Redskins",20,"Arizona Cardinals",17,37,3,TRUE,"1/6/2002",2002,"January","2000s",35,65,9
"8197","200201060nyg","New York Giants",25,"Green Bay Packers",34,59,-9,FALSE,"1/6/2002",2002,"January","2000s",38,49,10
"8198","200201060mia","Miami Dolphins",34,"Buffalo Bills",7,41,27,TRUE,"1/6/2002",2002,"January","2000s",70,72,13
"8199","200201060tam","Tampa Bay Buccaneers",13,"Philadelphia Eagles",17,30,-4,FALSE,"1/6/2002",2002,"January","2000s",62,78,11
"8200","200201060rai","Oakland Raiders",22,"New York Jets",24,46,-2,FALSE,"1/6/2002",2002,"January","2000s",54,90,6
"8201","200201060det","Detroit Lions",15,"Dallas Cowboys",10,25,5,TRUE,"1/6/2002",2002,"January","2000s",72,NA,NA
"8202","200201060oti","Tennessee Titans",21,"Cincinnati Bengals",23,44,-2,FALSE,"1/6/2002",2002,"January","2000s",38,84,9
"8203","200201060nor","New Orleans Saints",0,"San Francisco 49ers",38,38,-38,FALSE,"1/6/2002",2002,"January","2000s",72,NA,NA
"8204","200201070rav","Baltimore Ravens",19,"Minnesota Vikings",3,22,16,TRUE,"1/7/2002",2002,"January","2000s",35,98,10
"8205","200201120rai","Oakland Raiders",38,"New York Jets",24,62,14,TRUE,"1/12/2002",2002,"January","2000s",49,91,7
"8206","200201120phi","Philadelphia Eagles",31,"Tampa Bay Buccaneers",9,40,22,TRUE,"1/12/2002",2002,"January","2000s",42,66,13
"8207","200201130mia","Miami Dolphins",3,"Baltimore Ravens",20,23,-17,FALSE,"1/13/2002",2002,"January","2000s",68,82,7
"8208","200201130gnb","Green Bay Packers",25,"San Francisco 49ers",15,40,10,TRUE,"1/13/2002",2002,"January","2000s",26,77,10
"8209","200201190nwe","New England Patriots",16,"Oakland Raiders",13,29,3,TRUE,"1/19/2002",2002,"January","2000s",28,54,13
"8210","200201190chi","Chicago Bears",19,"Philadelphia Eagles",33,52,-14,FALSE,"1/19/2002",2002,"January","2000s",18,63,6
"8211","200201200pit","Pittsburgh Steelers",27,"Baltimore Ravens",10,37,17,TRUE,"1/20/2002",2002,"January","2000s",26,79,10
"8212","200201200ram","St. Louis Rams",45,"Green Bay Packers",17,62,28,TRUE,"1/20/2002",2002,"January","2000s",72,NA,NA
"8213","200201270pit","Pittsburgh Steelers",17,"New England Patriots",24,41,-7,FALSE,"1/27/2002",2002,"January","2000s",43,46,9
"8214","200201270ram","St. Louis Rams",29,"Philadelphia Eagles",24,53,5,TRUE,"1/27/2002",2002,"January","2000s",72,NA,NA
"8215","200202030nwe","New England Patriots",20,"St. Louis Rams",17,37,3,TRUE,"2/3/2002",2002,"Feburary","2000s",56,NA,5
"8216","200209050nyg","New York Giants",13,"San Francisco 49ers",16,29,-3,FALSE,"9/5/2002",2002,"September","2000s",75,58,12
"8217","200209080chi","Chicago Bears",27,"Minnesota Vikings",23,50,4,TRUE,"9/8/2002",2002,"September","2000s",76,75,5
"8218","200209080tam","Tampa Bay Buccaneers",20,"New Orleans Saints",26,46,-6,FALSE,"9/8/2002",2002,"September","2000s",82,75,7
"8219","200209080buf","Buffalo Bills",31,"New York Jets",37,68,-6,FALSE,"9/8/2002",2002,"September","2000s",75,50,7
"8220","200209080was","Washington Redskins",31,"Arizona Cardinals",23,54,8,TRUE,"9/8/2002",2002,"September","2000s",73,70,5
"8221","200209080oti","Tennessee Titans",27,"Philadelphia Eagles",24,51,3,TRUE,"9/8/2002",2002,"September","2000s",78,60,4
"8222","200209080jax","Jacksonville Jaguars",25,"Indianapolis Colts",28,53,-3,FALSE,"9/8/2002",2002,"September","2000s",82,77,14
"8223","200209080cle","Cleveland Browns",39,"Kansas City Chiefs",40,79,-1,FALSE,"9/8/2002",2002,"September","2000s",78,54,7
"8224","200209080rai","Oakland Raiders",31,"Seattle Seahawks",17,48,14,TRUE,"9/8/2002",2002,"September","2000s",61,72,9
"8225","200209080cin","Cincinnati Bengals",6,"San Diego Chargers",34,40,-28,FALSE,"9/8/2002",2002,"September","2000s",81,50,5
"8226","200209080car","Carolina Panthers",10,"Baltimore Ravens",7,17,3,TRUE,"9/8/2002",2002,"September","2000s",73,66,8
"8227","200209080htx","Houston Texans",19,"Dallas Cowboys",10,29,9,TRUE,"9/8/2002",2002,"September","2000s",72,NA,NA
"8228","200209080den","Denver Broncos",23,"St. Louis Rams",16,39,7,TRUE,"9/8/2002",2002,"September","2000s",73,45,13
"8229","200209080mia","Miami Dolphins",49,"Detroit Lions",21,70,28,TRUE,"9/8/2002",2002,"September","2000s",83,80,9
"8230","200209080gnb","Green Bay Packers",37,"Atlanta Falcons",34,71,3,TRUE,"9/8/2002",2002,"September","2000s",72,78,6
"8231","200209090nwe","New England Patriots",30,"Pittsburgh Steelers",14,44,16,TRUE,"9/9/2002",2002,"September","2000s",78,60,8
"8232","200209150dal","Dallas Cowboys",21,"Tennessee Titans",13,34,8,TRUE,"9/15/2002",2002,"September","2000s",79,62,12
"8233","200209150nyj","New York Jets",7,"New England Patriots",44,51,-37,FALSE,"9/15/2002",2002,"September","2000s",75,92,13
"8234","200209150atl","Atlanta Falcons",13,"Chicago Bears",14,27,-1,FALSE,"9/15/2002",2002,"September","2000s",72,NA,NA
"8235","200209150sdg","San Diego Chargers",24,"Houston Texans",3,27,21,TRUE,"9/15/2002",2002,"September","2000s",68,85,8
"8236","200209150ram","St. Louis Rams",21,"New York Giants",26,47,-5,FALSE,"9/15/2002",2002,"September","2000s",72,NA,NA
"8237","200209150nor","New Orleans Saints",35,"Green Bay Packers",20,55,15,TRUE,"9/15/2002",2002,"September","2000s",72,NA,NA
"8238","200209150car","Carolina Panthers",31,"Detroit Lions",7,38,24,TRUE,"9/15/2002",2002,"September","2000s",70,98,10
"8239","200209150clt","Indianapolis Colts",13,"Miami Dolphins",21,34,-8,FALSE,"9/15/2002",2002,"September","2000s",72,NA,NA
"8240","200209150sea","Seattle Seahawks",13,"Arizona Cardinals",24,37,-11,FALSE,"9/15/2002",2002,"September","2000s",61,78,7
"8241","200209150sfo","San Francisco 49ers",14,"Denver Broncos",24,38,-10,FALSE,"9/15/2002",2002,"September","2000s",62,79,16
"8242","200209150min","Minnesota Vikings",39,"Buffalo Bills",45,84,-6,FALSE,"9/15/2002",2002,"September","2000s",72,NA,NA
"8243","200209150cle","Cleveland Browns",20,"Cincinnati Bengals",7,27,13,TRUE,"9/15/2002",2002,"September","2000s",72,92,10
"8244","200209150rav","Baltimore Ravens",0,"Tampa Bay Buccaneers",25,25,-25,FALSE,"9/15/2002",2002,"September","2000s",73,94,8
"8245","200209150pit","Pittsburgh Steelers",17,"Oakland Raiders",30,47,-13,FALSE,"9/15/2002",2002,"September","2000s",71,93,7
"8246","200209150kan","Kansas City Chiefs",16,"Jacksonville Jaguars",23,39,-7,FALSE,"9/15/2002",2002,"September","2000s",67,77,9
"8247","200209160was","Washington Redskins",7,"Philadelphia Eagles",37,44,-30,FALSE,"9/16/2002",2002,"September","2000s",75,84,12
"8248","200209220chi","Chicago Bears",23,"New Orleans Saints",29,52,-6,FALSE,"9/22/2002",2002,"September","2000s",59,69,11
"8249","200209220oti","Tennessee Titans",28,"Cleveland Browns",31,59,-3,FALSE,"9/22/2002",2002,"September","2000s",72,77,7
"8250","200209220den","Denver Broncos",28,"Buffalo Bills",23,51,5,TRUE,"9/22/2002",2002,"September","2000s",52,55,13
"8251","200209220nwe","New England Patriots",41,"Kansas City Chiefs",38,79,3,TRUE,"9/22/2002",2002,"September","2000s",74,74,12
"8252","200209220htx","Houston Texans",3,"Indianapolis Colts",23,26,-20,FALSE,"9/22/2002",2002,"September","2000s",72,NA,NA
"8253","200209220mia","Miami Dolphins",30,"New York Jets",3,33,27,TRUE,"9/22/2002",2002,"September","2000s",83,75,12
"8254","200209220det","Detroit Lions",31,"Green Bay Packers",37,68,-6,FALSE,"9/22/2002",2002,"September","2000s",72,NA,NA
"8255","200209220crd","Arizona Cardinals",15,"San Diego Chargers",23,38,-8,FALSE,"9/22/2002",2002,"September","2000s",89,17,6
"8256","200209220phi","Philadelphia Eagles",44,"Dallas Cowboys",13,57,31,TRUE,"9/22/2002",2002,"September","2000s",77,69,9
"8257","200209220nyg","New York Giants",9,"Seattle Seahawks",6,15,3,TRUE,"9/22/2002",2002,"September","2000s",76,78,12
"8258","200209220min","Minnesota Vikings",14,"Carolina Panthers",21,35,-7,FALSE,"9/22/2002",2002,"September","2000s",72,NA,NA
"8259","200209220sfo","San Francisco 49ers",20,"Washington Redskins",10,30,10,TRUE,"9/22/2002",2002,"September","2000s",61,83,14
"8260","200209220atl","Atlanta Falcons",30,"Cincinnati Bengals",3,33,27,TRUE,"9/22/2002",2002,"September","2000s",72,NA,NA
"8261","200209230tam","Tampa Bay Buccaneers",26,"St. Louis Rams",14,40,12,TRUE,"9/23/2002",2002,"September","2000s",80,82,8
"8262","200209290jax","Jacksonville Jaguars",28,"New York Jets",3,31,25,TRUE,"9/29/2002",2002,"September","2000s",83,76,9
"8263","200209290rai","Oakland Raiders",52,"Tennessee Titans",25,77,27,TRUE,"9/29/2002",2002,"September","2000s",60,79,9
"8264","200209290det","Detroit Lions",26,"New Orleans Saints",21,47,5,TRUE,"9/29/2002",2002,"September","2000s",72,NA,NA
"8265","200209290kan","Kansas City Chiefs",48,"Miami Dolphins",30,78,18,TRUE,"9/29/2002",2002,"September","2000s",77,60,14
"8266","200209290sea","Seattle Seahawks",48,"Minnesota Vikings",23,71,25,TRUE,"9/29/2002",2002,"September","2000s",57,69,11
"8267","200209290ram","St. Louis Rams",10,"Dallas Cowboys",13,23,-3,FALSE,"9/29/2002",2002,"September","2000s",72,NA,NA
"8268","200209290cin","Cincinnati Bengals",7,"Tampa Bay Buccaneers",35,42,-28,FALSE,"9/29/2002",2002,"September","2000s",65,74,5
"8269","200209290phi","Philadelphia Eagles",35,"Houston Texans",17,52,18,TRUE,"9/29/2002",2002,"September","2000s",65,64,7
"8270","200209290sdg","San Diego Chargers",21,"New England Patriots",14,35,7,TRUE,"9/29/2002",2002,"September","2000s",67,77,9
"8271","200209290buf","Buffalo Bills",33,"Chicago Bears",27,60,6,TRUE,"9/29/2002",2002,"September","2000s",57,76,9
"8272","200209290crd","Arizona Cardinals",21,"New York Giants",7,28,14,TRUE,"9/29/2002",2002,"September","2000s",83,28,10
"8273","200209290pit","Pittsburgh Steelers",16,"Cleveland Browns",13,29,3,TRUE,"9/29/2002",2002,"September","2000s",59,81,2
"8274","200209290gnb","Green Bay Packers",17,"Carolina Panthers",14,31,3,TRUE,"9/29/2002",2002,"September","2000s",61,86,7
"8275","200209300rav","Baltimore Ravens",34,"Denver Broncos",23,57,11,TRUE,"9/30/2002",2002,"September","2000s",64,78,3
"8276","200210060jax","Jacksonville Jaguars",28,"Philadelphia Eagles",25,53,3,TRUE,"10/6/2002",2002,"October","2000s",81,79,8
"8277","200210060atl","Atlanta Falcons",6,"Tampa Bay Buccaneers",20,26,-14,FALSE,"10/6/2002",2002,"October","2000s",72,NA,NA
"8278","200210060sfo","San Francisco 49ers",37,"St. Louis Rams",13,50,24,TRUE,"10/6/2002",2002,"October","2000s",69,56,9
"8279","200210060oti","Tennessee Titans",14,"Washington Redskins",31,45,-17,FALSE,"10/6/2002",2002,"October","2000s",65,72,6
"8280","200210060cle","Cleveland Browns",21,"Baltimore Ravens",26,47,-5,FALSE,"10/6/2002",2002,"October","2000s",57,68,10
"8281","200210060dal","Dallas Cowboys",17,"New York Giants",21,38,-4,FALSE,"10/6/2002",2002,"October","2000s",78,55,11
"8282","200210060mia","Miami Dolphins",26,"New England Patriots",13,39,13,TRUE,"10/6/2002",2002,"October","2000s",82,78,9
"8283","200210060nyj","New York Jets",25,"Kansas City Chiefs",29,54,-4,FALSE,"10/6/2002",2002,"October","2000s",63,65,13
"8284","200210060nor","New Orleans Saints",32,"Pittsburgh Steelers",29,61,3,TRUE,"10/6/2002",2002,"October","2000s",72,NA,NA
"8285","200210060den","Denver Broncos",26,"San Diego Chargers",9,35,17,TRUE,"10/6/2002",2002,"October","2000s",53,43,16
"8286","200210060buf","Buffalo Bills",31,"Oakland Raiders",49,80,-18,FALSE,"10/6/2002",2002,"October","2000s",55,69,9
"8287","200210060car","Carolina Panthers",13,"Arizona Cardinals",16,29,-3,FALSE,"10/6/2002",2002,"October","2000s",71,72,7
"8288","200210060clt","Indianapolis Colts",28,"Cincinnati Bengals",21,49,7,TRUE,"10/6/2002",2002,"October","2000s",72,NA,NA
"8289","200210070chi","Chicago Bears",21,"Green Bay Packers",34,55,-13,FALSE,"10/7/2002",2002,"October","2000s",50,59,10
"8290","200210130oti","Tennessee Titans",23,"Jacksonville Jaguars",14,37,9,TRUE,"10/13/2002",2002,"October","2000s",63,73,10
"8291","200210130clt","Indianapolis Colts",22,"Baltimore Ravens",20,42,2,TRUE,"10/13/2002",2002,"October","2000s",72,NA,NA
"8292","200210130ram","St. Louis Rams",28,"Oakland Raiders",13,41,15,TRUE,"10/13/2002",2002,"October","2000s",72,NA,NA
"8293","200210130min","Minnesota Vikings",31,"Detroit Lions",24,55,7,TRUE,"10/13/2002",2002,"October","2000s",72,NA,NA
"8294","200210130nyg","New York Giants",10,"Atlanta Falcons",17,27,-7,FALSE,"10/13/2002",2002,"October","2000s",59,97,10
"8295","200210130cin","Cincinnati Bengals",7,"Pittsburgh Steelers",34,41,-27,FALSE,"10/13/2002",2002,"October","2000s",58,76,12
"8296","200210130sdg","San Diego Chargers",35,"Kansas City Chiefs",34,69,1,TRUE,"10/13/2002",2002,"October","2000s",65,81,9
"8297","200210130dal","Dallas Cowboys",14,"Carolina Panthers",13,27,1,TRUE,"10/13/2002",2002,"October","2000s",63,58,19
"8298","200210130was","Washington Redskins",27,"New Orleans Saints",43,70,-16,FALSE,"10/13/2002",2002,"October","2000s",65,92,7
"8299","200210130den","Denver Broncos",22,"Miami Dolphins",24,46,-2,FALSE,"10/13/2002",2002,"October","2000s",45,45,8
"8300","200210130htx","Houston Texans",24,"Buffalo Bills",31,55,-7,FALSE,"10/13/2002",2002,"October","2000s",72,NA,NA
"8301","200210130nwe","New England Patriots",10,"Green Bay Packers",28,38,-18,FALSE,"10/13/2002",2002,"October","2000s",57,93,14
"8302","200210130tam","Tampa Bay Buccaneers",17,"Cleveland Browns",3,20,14,TRUE,"10/13/2002",2002,"October","2000s",79,82,7
"8303","200210140sea","Seattle Seahawks",21,"San Francisco 49ers",28,49,-7,FALSE,"10/14/2002",2002,"October","2000s",51,72,11
"8304","200210200crd","Arizona Cardinals",9,"Dallas Cowboys",6,15,3,TRUE,"10/20/2002",2002,"October","2000s",74,34,5
"8305","200210200phi","Philadelphia Eagles",20,"Tampa Bay Buccaneers",10,30,10,TRUE,"10/20/2002",2002,"October","2000s",57,65,9
"8306","200210200rav","Baltimore Ravens",17,"Jacksonville Jaguars",10,27,7,TRUE,"10/20/2002",2002,"October","2000s",56,74,4
"8307","200210200det","Detroit Lions",23,"Chicago Bears",20,43,3,TRUE,"10/20/2002",2002,"October","2000s",72,NA,NA
"8308","200210200rai","Oakland Raiders",21,"San Diego Chargers",27,48,-6,FALSE,"10/20/2002",2002,"October","2000s",60,85,9
"8309","200210200nyj","New York Jets",20,"Minnesota Vikings",7,27,13,TRUE,"10/20/2002",2002,"October","2000s",56,64,13
"8310","200210200atl","Atlanta Falcons",30,"Carolina Panthers",0,30,30,TRUE,"10/20/2002",2002,"October","2000s",72,NA,NA
"8311","200210200gnb","Green Bay Packers",30,"Washington Redskins",9,39,21,TRUE,"10/20/2002",2002,"October","2000s",38,61,11
"8312","200210200mia","Miami Dolphins",10,"Buffalo Bills",23,33,-13,FALSE,"10/20/2002",2002,"October","2000s",80,80,5
"8313","200210200ram","St. Louis Rams",37,"Seattle Seahawks",20,57,17,TRUE,"10/20/2002",2002,"October","2000s",72,NA,NA
"8314","200210200cle","Cleveland Browns",34,"Houston Texans",17,51,17,TRUE,"10/20/2002",2002,"October","2000s",46,76,8
"8315","200210200nor","New Orleans Saints",35,"San Francisco 49ers",27,62,8,TRUE,"10/20/2002",2002,"October","2000s",72,NA,NA
"8316","200210200kan","Kansas City Chiefs",34,"Denver Broncos",37,71,-3,FALSE,"10/20/2002",2002,"October","2000s",45,68,7
"8317","200210210pit","Pittsburgh Steelers",28,"Indianapolis Colts",10,38,18,TRUE,"10/21/2002",2002,"October","2000s",44,78,4
"8318","200210270jax","Jacksonville Jaguars",19,"Houston Texans",21,40,-2,FALSE,"10/27/2002",2002,"October","2000s",73,82,7
"8319","200210270sfo","San Francisco 49ers",38,"Arizona Cardinals",28,66,10,TRUE,"10/27/2002",2002,"October","2000s",56,77,9
"8320","200210270rav","Baltimore Ravens",18,"Pittsburgh Steelers",31,49,-13,FALSE,"10/27/2002",2002,"October","2000s",54,77,7
"8321","200210270nor","New Orleans Saints",35,"Atlanta Falcons",37,72,-2,FALSE,"10/27/2002",2002,"October","2000s",72,NA,NA
"8322","200210270was","Washington Redskins",26,"Indianapolis Colts",21,47,5,TRUE,"10/27/2002",2002,"October","2000s",58,74,8
"8323","200210270min","Minnesota Vikings",25,"Chicago Bears",7,32,18,TRUE,"10/27/2002",2002,"October","2000s",72,NA,NA
"8324","200210270cin","Cincinnati Bengals",24,"Tennessee Titans",30,54,-6,FALSE,"10/27/2002",2002,"October","2000s",50,82,6
"8325","200210270dal","Dallas Cowboys",14,"Seattle Seahawks",17,31,-3,FALSE,"10/27/2002",2002,"October","2000s",60,88,8
"8326","200210270kan","Kansas City Chiefs",20,"Oakland Raiders",10,30,10,TRUE,"10/27/2002",2002,"October","2000s",41,88,11
"8327","200210270nwe","New England Patriots",16,"Denver Broncos",24,40,-8,FALSE,"10/27/2002",2002,"October","2000s",50,70,14
"8328","200210270buf","Buffalo Bills",24,"Detroit Lions",17,41,7,TRUE,"10/27/2002",2002,"October","2000s",46,71,12
"8329","200210270nyj","New York Jets",21,"Cleveland Browns",24,45,-3,FALSE,"10/27/2002",2002,"October","2000s",54,66,14
"8330","200210270car","Carolina Panthers",9,"Tampa Bay Buccaneers",12,21,-3,FALSE,"10/27/2002",2002,"October","2000s",63,82,5
"8331","200210280phi","Philadelphia Eagles",17,"New York Giants",3,20,14,TRUE,"10/28/2002",2002,"October","2000s",51,60,7
"8332","200211030atl","Atlanta Falcons",20,"Baltimore Ravens",17,37,3,TRUE,"11/3/2002",2002,"November","2000s",72,NA,NA
"8333","200211030sea","Seattle Seahawks",3,"Washington Redskins",14,17,-11,FALSE,"11/3/2002",2002,"November","2000s",41,57,3
"8334","200211030clt","Indianapolis Colts",15,"Tennessee Titans",23,38,-8,FALSE,"11/3/2002",2002,"November","2000s",72,NA,NA
"8335","200211030htx","Houston Texans",3,"Cincinnati Bengals",38,41,-35,FALSE,"11/3/2002",2002,"November","2000s",72,NA,NA
"8336","200211030crd","Arizona Cardinals",14,"St. Louis Rams",27,41,-13,FALSE,"11/3/2002",2002,"November","2000s",70,33,4
"8337","200211030sdg","San Diego Chargers",13,"New York Jets",44,57,-31,FALSE,"11/3/2002",2002,"November","2000s",60,79,8
"8338","200211030nyg","New York Giants",24,"Jacksonville Jaguars",17,41,7,TRUE,"11/3/2002",2002,"November","2000s",43,55,13
"8339","200211030tam","Tampa Bay Buccaneers",38,"Minnesota Vikings",24,62,14,TRUE,"11/3/2002",2002,"November","2000s",68,68,6
"8340","200211030chi","Chicago Bears",13,"Philadelphia Eagles",19,32,-6,FALSE,"11/3/2002",2002,"November","2000s",35,90,8
"8341","200211030rai","Oakland Raiders",20,"San Francisco 49ers",23,43,-3,FALSE,"11/3/2002",2002,"November","2000s",55,48,6
"8342","200211030buf","Buffalo Bills",7,"New England Patriots",38,45,-31,FALSE,"11/3/2002",2002,"November","2000s",36,68,10
"8343","200211030cle","Cleveland Browns",20,"Pittsburgh Steelers",23,43,-3,FALSE,"11/3/2002",2002,"November","2000s",39,66,8
"8344","200211030det","Detroit Lions",9,"Dallas Cowboys",7,16,2,TRUE,"11/3/2002",2002,"November","2000s",72,NA,NA
"8345","200211040gnb","Green Bay Packers",24,"Miami Dolphins",10,34,14,TRUE,"11/4/2002",2002,"November","2000s",37,65,8
"8346","200211100rav","Baltimore Ravens",38,"Cincinnati Bengals",27,65,11,TRUE,"11/10/2002",2002,"November","2000s",58,84,8
"8347","200211100nyj","New York Jets",13,"Miami Dolphins",10,23,3,TRUE,"11/10/2002",2002,"November","2000s",59,83,11
"8348","200211100jax","Jacksonville Jaguars",26,"Washington Redskins",7,33,19,TRUE,"11/10/2002",2002,"November","2000s",73,82,11
"8349","200211100oti","Tennessee Titans",17,"Houston Texans",10,27,7,TRUE,"11/10/2002",2002,"November","2000s",71,73,17
"8350","200211100phi","Philadelphia Eagles",13,"Indianapolis Colts",35,48,-22,FALSE,"11/10/2002",2002,"November","2000s",63,75,12
"8351","200211100chi","Chicago Bears",30,"New England Patriots",33,63,-3,FALSE,"11/10/2002",2002,"November","2000s",60,85,19
"8352","200211100car","Carolina Panthers",24,"New Orleans Saints",34,58,-10,FALSE,"11/10/2002",2002,"November","2000s",64,86,10
"8353","200211100gnb","Green Bay Packers",40,"Detroit Lions",14,54,26,TRUE,"11/10/2002",2002,"November","2000s",52,90,10
"8354","200211100crd","Arizona Cardinals",6,"Seattle Seahawks",27,33,-21,FALSE,"11/10/2002",2002,"November","2000s",73,42,13
"8355","200211100ram","St. Louis Rams",28,"San Diego Chargers",24,52,4,TRUE,"11/10/2002",2002,"November","2000s",72,NA,NA
"8356","200211100pit","Pittsburgh Steelers",34,"Atlanta Falcons",34,68,0,FALSE,"11/10/2002",2002,"November","2000s",59,72,11
"8357","200211100sfo","San Francisco 49ers",17,"Kansas City Chiefs",13,30,4,TRUE,"11/10/2002",2002,"November","2000s",59,85,13
"8358","200211100min","Minnesota Vikings",20,"New York Giants",27,47,-7,FALSE,"11/10/2002",2002,"November","2000s",72,NA,NA
"8359","200211110den","Denver Broncos",10,"Oakland Raiders",34,44,-24,FALSE,"11/11/2002",2002,"November","2000s",36,47,11
"8360","200211170atl","Atlanta Falcons",24,"New Orleans Saints",17,41,7,TRUE,"11/17/2002",2002,"November","2000s",72,NA,NA
"8361","200211170phi","Philadelphia Eagles",38,"Arizona Cardinals",14,52,24,TRUE,"11/17/2002",2002,"November","2000s",43,92,17
"8362","200211170min","Minnesota Vikings",31,"Green Bay Packers",21,52,10,TRUE,"11/17/2002",2002,"November","2000s",72,NA,NA
"8363","200211170sea","Seattle Seahawks",9,"Denver Broncos",31,40,-22,FALSE,"11/17/2002",2002,"November","2000s",49,84,14
"8364","200211170htx","Houston Texans",21,"Jacksonville Jaguars",24,45,-3,FALSE,"11/17/2002",2002,"November","2000s",72,NA,NA
"8365","200211170mia","Miami Dolphins",26,"Baltimore Ravens",7,33,19,TRUE,"11/17/2002",2002,"November","2000s",70,87,13
"8366","200211170sdg","San Diego Chargers",20,"San Francisco 49ers",17,37,3,TRUE,"11/17/2002",2002,"November","2000s",63,32,5
"8367","200211170cin","Cincinnati Bengals",20,"Cleveland Browns",27,47,-7,FALSE,"11/17/2002",2002,"November","2000s",35,83,12
"8368","200211170nyg","New York Giants",19,"Washington Redskins",17,36,2,TRUE,"11/17/2002",2002,"November","2000s",41,93,22
"8369","200211170clt","Indianapolis Colts",20,"Dallas Cowboys",3,23,17,TRUE,"11/17/2002",2002,"November","2000s",72,NA,NA
"8370","200211170tam","Tampa Bay Buccaneers",23,"Carolina Panthers",10,33,13,TRUE,"11/17/2002",2002,"November","2000s",63,77,17
"8371","200211170oti","Tennessee Titans",31,"Pittsburgh Steelers",23,54,8,TRUE,"11/17/2002",2002,"November","2000s",39,63,10
"8372","200211170det","Detroit Lions",14,"New York Jets",31,45,-17,FALSE,"11/17/2002",2002,"November","2000s",72,NA,NA
"8373","200211170rai","Oakland Raiders",27,"New England Patriots",20,47,7,TRUE,"11/17/2002",2002,"November","2000s",55,84,7
"8374","200211170kan","Kansas City Chiefs",17,"Buffalo Bills",16,33,1,TRUE,"11/17/2002",2002,"November","2000s",39,74,12
"8375","200211180ram","St. Louis Rams",21,"Chicago Bears",16,37,5,TRUE,"11/18/2002",2002,"November","2000s",72,NA,NA
"8376","200211240was","Washington Redskins",20,"St. Louis Rams",17,37,3,TRUE,"11/24/2002",2002,"November","2000s",44,64,6
"8377","200211240mia","Miami Dolphins",30,"San Diego Chargers",3,33,27,TRUE,"11/24/2002",2002,"November","2000s",67,69,7
"8378","200211240nwe","New England Patriots",24,"Minnesota Vikings",17,41,7,TRUE,"11/24/2002",2002,"November","2000s",40,57,20
"8379","200211240sea","Seattle Seahawks",39,"Kansas City Chiefs",32,71,7,TRUE,"11/24/2002",2002,"November","2000s",44,92,5
"8380","200211240rav","Baltimore Ravens",13,"Tennessee Titans",12,25,1,TRUE,"11/24/2002",2002,"November","2000s",42,60,7
"8381","200211240htx","Houston Texans",16,"New York Giants",14,30,2,TRUE,"11/24/2002",2002,"November","2000s",72,NA,NA
"8382","200211240den","Denver Broncos",20,"Indianapolis Colts",23,43,-3,FALSE,"11/24/2002",2002,"November","2000s",27,76,13
"8383","200211240dal","Dallas Cowboys",21,"Jacksonville Jaguars",19,40,2,TRUE,"11/24/2002",2002,"November","2000s",60,73,16
"8384","200211240tam","Tampa Bay Buccaneers",21,"Green Bay Packers",7,28,14,TRUE,"11/24/2002",2002,"November","2000s",53,76,5
"8385","200211240nyj","New York Jets",31,"Buffalo Bills",13,44,18,TRUE,"11/24/2002",2002,"November","2000s",44,53,18
"8386","200211240chi","Chicago Bears",20,"Detroit Lions",17,37,3,TRUE,"11/24/2002",2002,"November","2000s",35,71,9
"8387","200211240pit","Pittsburgh Steelers",29,"Cincinnati Bengals",21,50,8,TRUE,"11/24/2002",2002,"November","2000s",40,65,10
"8388","200211240nor","New Orleans Saints",15,"Cleveland Browns",24,39,-9,FALSE,"11/24/2002",2002,"November","2000s",72,NA,NA
"8389","200211240crd","Arizona Cardinals",20,"Oakland Raiders",41,61,-21,FALSE,"11/24/2002",2002,"November","2000s",64,24,6
"8390","200211240car","Carolina Panthers",0,"Atlanta Falcons",41,41,-41,FALSE,"11/24/2002",2002,"November","2000s",46,56,1
"8391","200211250sfo","San Francisco 49ers",17,"Philadelphia Eagles",38,55,-21,FALSE,"11/25/2002",2002,"November","2000s",56,71,8
"8392","200211280det","Detroit Lions",12,"New England Patriots",20,32,-8,FALSE,"11/28/2002",2002,"November","2000s",72,NA,NA
"8393","200211280dal","Dallas Cowboys",27,"Washington Redskins",20,47,7,TRUE,"11/28/2002",2002,"November","2000s",42,59,6
"8394","200212010nor","New Orleans Saints",23,"Tampa Bay Buccaneers",20,43,3,TRUE,"12/1/2002",2002,"December","2000s",72,NA,NA
"8395","200212010buf","Buffalo Bills",38,"Miami Dolphins",21,59,17,TRUE,"12/1/2002",2002,"December","2000s",24,73,17
"8396","200212010cin","Cincinnati Bengals",23,"Baltimore Ravens",27,50,-4,FALSE,"12/1/2002",2002,"December","2000s",26,57,13
"8397","200212010clt","Indianapolis Colts",19,"Houston Texans",3,22,16,TRUE,"12/1/2002",2002,"December","2000s",72,NA,NA
"8398","200212010sdg","San Diego Chargers",30,"Denver Broncos",27,57,3,TRUE,"12/1/2002",2002,"December","2000s",58,77,6
"8399","200212010nyg","New York Giants",29,"Tennessee Titans",32,61,-3,FALSE,"12/1/2002",2002,"December","2000s",37,48,25
"8400","200212010phi","Philadelphia Eagles",10,"St. Louis Rams",3,13,7,TRUE,"12/1/2002",2002,"December","2000s",36,43,21
"8401","200212010sfo","San Francisco 49ers",31,"Seattle Seahawks",24,55,7,TRUE,"12/1/2002",2002,"December","2000s",56,81,5
"8402","200212010gnb","Green Bay Packers",30,"Chicago Bears",20,50,10,TRUE,"12/1/2002",2002,"December","2000s",19,58,12
"8403","200212010min","Minnesota Vikings",24,"Atlanta Falcons",30,54,-6,FALSE,"12/1/2002",2002,"December","2000s",72,NA,NA
"8404","200212010cle","Cleveland Browns",6,"Carolina Panthers",13,19,-7,FALSE,"12/1/2002",2002,"December","2000s",26,61,19
"8405","200212010jax","Jacksonville Jaguars",23,"Pittsburgh Steelers",25,48,-2,FALSE,"12/1/2002",2002,"December","2000s",55,65,11
"8406","200212010kan","Kansas City Chiefs",49,"Arizona Cardinals",0,49,49,TRUE,"12/1/2002",2002,"December","2000s",32,46,14
"8407","200212020rai","Oakland Raiders",26,"New York Jets",20,46,6,TRUE,"12/2/2002",2002,"December","2000s",51,80,3
"8408","200212080nwe","New England Patriots",27,"Buffalo Bills",17,44,10,TRUE,"12/8/2002",2002,"December","2000s",35,63,17
"8409","200212080jax","Jacksonville Jaguars",20,"Cleveland Browns",21,41,-1,FALSE,"12/8/2002",2002,"December","2000s",56,84,9
"8410","200212080sdg","San Diego Chargers",7,"Oakland Raiders",27,34,-20,FALSE,"12/8/2002",2002,"December","2000s",58,80,7
"8411","200212080rav","Baltimore Ravens",25,"New Orleans Saints",37,62,-12,FALSE,"12/8/2002",2002,"December","2000s",30,75,6
"8412","200212080car","Carolina Panthers",52,"Cincinnati Bengals",31,83,21,TRUE,"12/8/2002",2002,"December","2000s",35,89,1
"8413","200212080sea","Seattle Seahawks",20,"Philadelphia Eagles",27,47,-7,FALSE,"12/8/2002",2002,"December","2000s",38,98,5
"8414","200212080was","Washington Redskins",21,"New York Giants",27,48,-6,FALSE,"12/8/2002",2002,"December","2000s",36,70,6
"8415","200212080oti","Tennessee Titans",27,"Indianapolis Colts",17,44,10,TRUE,"12/8/2002",2002,"December","2000s",35,82,6
"8416","200212080crd","Arizona Cardinals",23,"Detroit Lions",20,43,3,TRUE,"12/8/2002",2002,"December","2000s",57,50,4
"8417","200212080pit","Pittsburgh Steelers",6,"Houston Texans",24,30,-18,FALSE,"12/8/2002",2002,"December","2000s",33,85,14
"8418","200212080gnb","Green Bay Packers",26,"Minnesota Vikings",22,48,4,TRUE,"12/8/2002",2002,"December","2000s",19,58,12
"8419","200212080nyj","New York Jets",19,"Denver Broncos",13,32,6,TRUE,"12/8/2002",2002,"December","2000s",37,59,13
"8420","200212080tam","Tampa Bay Buccaneers",34,"Atlanta Falcons",10,44,24,TRUE,"12/8/2002",2002,"December","2000s",63,79,7
"8421","200212080kan","Kansas City Chiefs",49,"St. Louis Rams",10,59,39,TRUE,"12/8/2002",2002,"December","2000s",35,75,10
"8422","200212080dal","Dallas Cowboys",27,"San Francisco 49ers",31,58,-4,FALSE,"12/8/2002",2002,"December","2000s",51,89,8
"8423","200212090mia","Miami Dolphins",27,"Chicago Bears",9,36,18,TRUE,"12/9/2002",2002,"December","2000s",76,80,16
"8424","200212150atl","Atlanta Falcons",24,"Seattle Seahawks",30,54,-6,FALSE,"12/15/2002",2002,"December","2000s",72,NA,NA
"8425","200212150den","Denver Broncos",31,"Kansas City Chiefs",24,55,7,TRUE,"12/15/2002",2002,"December","2000s",45,27,12
"8426","200212150buf","Buffalo Bills",20,"San Diego Chargers",13,33,7,TRUE,"12/15/2002",2002,"December","2000s",36,82,15
"8427","200212150det","Detroit Lions",20,"Tampa Bay Buccaneers",23,43,-3,FALSE,"12/15/2002",2002,"December","2000s",72,NA,NA
"8428","200212150chi","Chicago Bears",20,"New York Jets",13,33,7,TRUE,"12/15/2002",2002,"December","2000s",35,83,12
"8429","200212150sfo","San Francisco 49ers",14,"Green Bay Packers",20,34,-6,FALSE,"12/15/2002",2002,"December","2000s",57,80,23
"8430","200212150pit","Pittsburgh Steelers",30,"Carolina Panthers",14,44,16,TRUE,"12/15/2002",2002,"December","2000s",36,78,13
"8431","200212150phi","Philadelphia Eagles",34,"Washington Redskins",21,55,13,TRUE,"12/15/2002",2002,"December","2000s",44,57,16
"8432","200212150htx","Houston Texans",19,"Baltimore Ravens",23,42,-4,FALSE,"12/15/2002",2002,"December","2000s",72,NA,NA
"8433","200212150ram","St. Louis Rams",30,"Arizona Cardinals",28,58,2,TRUE,"12/15/2002",2002,"December","2000s",72,NA,NA
"8434","200212150nor","New Orleans Saints",31,"Minnesota Vikings",32,63,-1,FALSE,"12/15/2002",2002,"December","2000s",72,NA,NA
"8435","200212150mia","Miami Dolphins",23,"Oakland Raiders",17,40,6,TRUE,"12/15/2002",2002,"December","2000s",61,67,9
"8436","200212150nyg","New York Giants",37,"Dallas Cowboys",7,44,30,TRUE,"12/15/2002",2002,"December","2000s",43,63,19
"8437","200212150cin","Cincinnati Bengals",15,"Jacksonville Jaguars",29,44,-14,FALSE,"12/15/2002",2002,"December","2000s",37,85,10
"8438","200212150cle","Cleveland Browns",23,"Indianapolis Colts",28,51,-5,FALSE,"12/15/2002",2002,"December","2000s",36,79,14
"8439","200212160oti","Tennessee Titans",24,"New England Patriots",7,31,17,TRUE,"12/16/2002",2002,"December","2000s",50,77,6
"8440","200212210min","Minnesota Vikings",20,"Miami Dolphins",17,37,3,TRUE,"12/21/2002",2002,"December","2000s",72,NA,NA
"8441","200212210dal","Dallas Cowboys",3,"Philadelphia Eagles",27,30,-24,FALSE,"12/21/2002",2002,"December","2000s",51,45,17
"8442","200212210crd","Arizona Cardinals",14,"San Francisco 49ers",17,31,-3,FALSE,"12/21/2002",2002,"December","2000s",46,77,12
"8443","200212220rav","Baltimore Ravens",13,"Cleveland Browns",14,27,-1,FALSE,"12/22/2002",2002,"December","2000s",44,45,10
"8444","200212220was","Washington Redskins",26,"Houston Texans",10,36,16,TRUE,"12/22/2002",2002,"December","2000s",46,47,10
"8445","200212220kan","Kansas City Chiefs",24,"San Diego Chargers",22,46,2,TRUE,"12/22/2002",2002,"December","2000s",30,63,11
"8446","200212220car","Carolina Panthers",24,"Chicago Bears",14,38,10,TRUE,"12/22/2002",2002,"December","2000s",48,49,9
"8447","200212220sea","Seattle Seahawks",30,"St. Louis Rams",10,40,20,TRUE,"12/22/2002",2002,"December","2000s",42,85,6
"8448","200212220atl","Atlanta Falcons",36,"Detroit Lions",15,51,21,TRUE,"12/22/2002",2002,"December","2000s",72,NA,NA
"8449","200212220nwe","New England Patriots",17,"New York Jets",30,47,-13,FALSE,"12/22/2002",2002,"December","2000s",40,53,17
"8450","200212220clt","Indianapolis Colts",27,"New York Giants",44,71,-17,FALSE,"12/22/2002",2002,"December","2000s",72,NA,NA
"8451","200212220gnb","Green Bay Packers",10,"Buffalo Bills",0,10,10,TRUE,"12/22/2002",2002,"December","2000s",28,70,21
"8452","200212220jax","Jacksonville Jaguars",10,"Tennessee Titans",28,38,-18,FALSE,"12/22/2002",2002,"December","2000s",53,60,8
"8453","200212220cin","Cincinnati Bengals",20,"New Orleans Saints",13,33,7,TRUE,"12/22/2002",2002,"December","2000s",42,60,15
"8454","200212220rai","Oakland Raiders",28,"Denver Broncos",16,44,12,TRUE,"12/22/2002",2002,"December","2000s",50,74,8
"8455","200212230tam","Tampa Bay Buccaneers",7,"Pittsburgh Steelers",17,24,-10,FALSE,"12/23/2002",2002,"December","2000s",60,77,7
"8456","200212280rai","Oakland Raiders",24,"Kansas City Chiefs",0,24,24,TRUE,"12/28/2002",2002,"December","2000s",55,86,17
"8457","200212280nyg","New York Giants",10,"Philadelphia Eagles",7,17,3,TRUE,"12/28/2002",2002,"December","2000s",34,66,12
"8458","200212290nor","New Orleans Saints",6,"Carolina Panthers",10,16,-4,FALSE,"12/29/2002",2002,"December","2000s",72,NA,NA
"8459","200212290nwe","New England Patriots",27,"Miami Dolphins",24,51,3,TRUE,"12/29/2002",2002,"December","2000s",34,72,13
"8460","200212290den","Denver Broncos",37,"Arizona Cardinals",7,44,30,TRUE,"12/29/2002",2002,"December","2000s",46,23,14
"8461","200212290nyj","New York Jets",42,"Green Bay Packers",17,59,25,TRUE,"12/29/2002",2002,"December","2000s",38,70,14
"8462","200212290sdg","San Diego Chargers",28,"Seattle Seahawks",31,59,-3,FALSE,"12/29/2002",2002,"December","2000s",56,82,9
"8463","200212290buf","Buffalo Bills",27,"Cincinnati Bengals",9,36,18,TRUE,"12/29/2002",2002,"December","2000s",32,84,11
"8464","200212290was","Washington Redskins",20,"Dallas Cowboys",14,34,6,TRUE,"12/29/2002",2002,"December","2000s",40,72,7
"8465","200212290pit","Pittsburgh Steelers",34,"Baltimore Ravens",31,65,3,TRUE,"12/29/2002",2002,"December","2000s",31,94,5
"8466","200212290chi","Chicago Bears",0,"Tampa Bay Buccaneers",15,15,-15,FALSE,"12/29/2002",2002,"December","2000s",28,85,10
"8467","200212290det","Detroit Lions",36,"Minnesota Vikings",38,74,-2,FALSE,"12/29/2002",2002,"December","2000s",72,NA,NA
"8468","200212290htx","Houston Texans",3,"Tennessee Titans",13,16,-10,FALSE,"12/29/2002",2002,"December","2000s",72,NA,NA
"8469","200212290clt","Indianapolis Colts",20,"Jacksonville Jaguars",13,33,7,TRUE,"12/29/2002",2002,"December","2000s",72,NA,NA
"8470","200212290cle","Cleveland Browns",24,"Atlanta Falcons",16,40,8,TRUE,"12/29/2002",2002,"December","2000s",33,94,7
"8471","200212300ram","St. Louis Rams",31,"San Francisco 49ers",20,51,11,TRUE,"12/30/2002",2002,"December","2000s",72,NA,NA
"8472","200301040gnb","Green Bay Packers",7,"Atlanta Falcons",27,34,-20,FALSE,"1/4/2003",2003,"January","2000s",20,75,3
"8473","200301040nyj","New York Jets",41,"Indianapolis Colts",0,41,41,TRUE,"1/4/2003",2003,"January","2000s",34,84,17
"8474","200301050sfo","San Francisco 49ers",39,"New York Giants",38,77,1,TRUE,"1/5/2003",2003,"January","2000s",53,96,6
"8475","200301050pit","Pittsburgh Steelers",36,"Cleveland Browns",33,69,3,TRUE,"1/5/2003",2003,"January","2000s",27,85,4
"8476","200301110oti","Tennessee Titans",34,"Pittsburgh Steelers",31,65,3,TRUE,"1/11/2003",2003,"January","2000s",29,45,9
"8477","200301110phi","Philadelphia Eagles",20,"Atlanta Falcons",6,26,14,TRUE,"1/11/2003",2003,"January","2000s",31,42,18
"8478","200301120rai","Oakland Raiders",30,"New York Jets",10,40,20,TRUE,"1/12/2003",2003,"January","2000s",56,87,9
"8479","200301120tam","Tampa Bay Buccaneers",31,"San Francisco 49ers",6,37,25,TRUE,"1/12/2003",2003,"January","2000s",51,50,8
"8480","200301190rai","Oakland Raiders",41,"Tennessee Titans",24,65,17,TRUE,"1/19/2003",2003,"January","2000s",48,89,6
"8481","200301190phi","Philadelphia Eagles",10,"Tampa Bay Buccaneers",27,37,-17,FALSE,"1/19/2003",2003,"January","2000s",20,62,13
"8482","200301260rai","Oakland Raiders",21,"Tampa Bay Buccaneers",48,69,-27,FALSE,"1/26/2003",2003,"January","2000s",67,42,5
"8483","200309040was","Washington Redskins",16,"New York Jets",13,29,3,TRUE,"9/4/2003",2003,"September","2000s",74,89,9
"8484","200309070dal","Dallas Cowboys",13,"Atlanta Falcons",27,40,-14,FALSE,"9/7/2003",2003,"September","2000s",75,51,6
"8485","200309070pit","Pittsburgh Steelers",34,"Baltimore Ravens",15,49,19,TRUE,"9/7/2003",2003,"September","2000s",64,71,4
"8486","200309070buf","Buffalo Bills",31,"New England Patriots",0,31,31,TRUE,"9/7/2003",2003,"September","2000s",64,82,11
"8487","200309070sea","Seattle Seahawks",27,"New Orleans Saints",10,37,17,TRUE,"9/7/2003",2003,"September","2000s",62,81,10
"8488","200309070sfo","San Francisco 49ers",49,"Chicago Bears",7,56,42,TRUE,"9/7/2003",2003,"September","2000s",63,75,15
"8489","200309070nyg","New York Giants",23,"St. Louis Rams",13,36,10,TRUE,"9/7/2003",2003,"September","2000s",72,55,6
"8490","200309070cin","Cincinnati Bengals",10,"Denver Broncos",30,40,-20,FALSE,"9/7/2003",2003,"September","2000s",65,75,5
"8491","200309070car","Carolina Panthers",24,"Jacksonville Jaguars",23,47,1,TRUE,"9/7/2003",2003,"September","2000s",67,79,9
"8492","200309070oti","Tennessee Titans",25,"Oakland Raiders",20,45,5,TRUE,"9/7/2003",2003,"September","2000s",70,72,6
"8493","200309070kan","Kansas City Chiefs",27,"San Diego Chargers",14,41,13,TRUE,"9/7/2003",2003,"September","2000s",70,58,7
"8494","200309070cle","Cleveland Browns",6,"Indianapolis Colts",9,15,-3,FALSE,"9/7/2003",2003,"September","2000s",65,72,4
"8495","200309070det","Detroit Lions",42,"Arizona Cardinals",24,66,18,TRUE,"9/7/2003",2003,"September","2000s",72,NA,NA
"8496","200309070gnb","Green Bay Packers",25,"Minnesota Vikings",30,55,-5,FALSE,"9/7/2003",2003,"September","2000s",68,86,7
"8497","200309070mia","Miami Dolphins",20,"Houston Texans",21,41,-1,FALSE,"9/7/2003",2003,"September","2000s",82,80,8
"8498","200309080phi","Philadelphia Eagles",0,"Tampa Bay Buccaneers",17,17,-17,FALSE,"9/8/2003",2003,"September","2000s",72,66,9
"8499","200309140gnb","Green Bay Packers",31,"Detroit Lions",6,37,25,TRUE,"9/14/2003",2003,"September","2000s",64,92,7
"8500","200309140crd","Arizona Cardinals",0,"Seattle Seahawks",38,38,-38,FALSE,"9/14/2003",2003,"September","2000s",92,17,8
"8501","200309140phi","Philadelphia Eagles",10,"New England Patriots",31,41,-21,FALSE,"9/14/2003",2003,"September","2000s",76,90,8
"8502","200309140nor","New Orleans Saints",31,"Houston Texans",10,41,21,TRUE,"9/14/2003",2003,"September","2000s",72,NA,NA
"8503","200309140min","Minnesota Vikings",24,"Chicago Bears",13,37,11,TRUE,"9/14/2003",2003,"September","2000s",72,NA,NA
"8504","200309140sdg","San Diego Chargers",13,"Denver Broncos",37,50,-24,FALSE,"9/14/2003",2003,"September","2000s",70,83,8
"8505","200309140clt","Indianapolis Colts",33,"Tennessee Titans",7,40,26,TRUE,"9/14/2003",2003,"September","2000s",72,NA,NA
"8506","200309140tam","Tampa Bay Buccaneers",9,"Carolina Panthers",12,21,-3,FALSE,"9/14/2003",2003,"September","2000s",81,61,5
"8507","200309140rav","Baltimore Ravens",33,"Cleveland Browns",13,46,20,TRUE,"9/14/2003",2003,"September","2000s",72,87,6
"8508","200309140nyj","New York Jets",10,"Miami Dolphins",21,31,-11,FALSE,"9/14/2003",2003,"September","2000s",73,92,13
"8509","200309140kan","Kansas City Chiefs",41,"Pittsburgh Steelers",20,61,21,TRUE,"9/14/2003",2003,"September","2000s",62,78,10
"8510","200309140rai","Oakland Raiders",23,"Cincinnati Bengals",20,43,3,TRUE,"9/14/2003",2003,"September","2000s",66,77,11
"8511","200309140jax","Jacksonville Jaguars",17,"Buffalo Bills",38,55,-21,FALSE,"9/14/2003",2003,"September","2000s",80,69,7
"8512","200309140atl","Atlanta Falcons",31,"Washington Redskins",33,64,-2,FALSE,"9/14/2003",2003,"September","2000s",72,NA,NA
"8513","200309140ram","St. Louis Rams",27,"San Francisco 49ers",24,51,3,TRUE,"9/14/2003",2003,"September","2000s",72,NA,NA
"8514","200309150nyg","New York Giants",32,"Dallas Cowboys",35,67,-3,FALSE,"9/15/2003",2003,"September","2000s",75,86,10
"8515","200309210crd","Arizona Cardinals",20,"Green Bay Packers",13,33,7,TRUE,"9/21/2003",2003,"September","2000s",90,13,6
"8516","200309210atl","Atlanta Falcons",10,"Tampa Bay Buccaneers",31,41,-21,FALSE,"9/21/2003",2003,"September","2000s",72,NA,NA
"8517","200309210nwe","New England Patriots",23,"New York Jets",16,39,7,TRUE,"9/21/2003",2003,"September","2000s",69,61,10
"8518","200309210sea","Seattle Seahawks",24,"St. Louis Rams",23,47,1,TRUE,"9/21/2003",2003,"September","2000s",58,74,10
"8519","200309210mia","Miami Dolphins",17,"Buffalo Bills",7,24,10,TRUE,"9/21/2003",2003,"September","2000s",84,74,15
"8520","200309210sdg","San Diego Chargers",10,"Baltimore Ravens",24,34,-14,FALSE,"9/21/2003",2003,"September","2000s",69,86,8
"8521","200309210clt","Indianapolis Colts",23,"Jacksonville Jaguars",13,36,10,TRUE,"9/21/2003",2003,"September","2000s",72,NA,NA
"8522","200309210sfo","San Francisco 49ers",12,"Cleveland Browns",13,25,-1,FALSE,"9/21/2003",2003,"September","2000s",70,62,9
"8523","200309210oti","Tennessee Titans",27,"New Orleans Saints",12,39,15,TRUE,"9/21/2003",2003,"September","2000s",70,73,7
"8524","200309210was","Washington Redskins",21,"New York Giants",24,45,-3,FALSE,"9/21/2003",2003,"September","2000s",72,79,8
"8525","200309210det","Detroit Lions",13,"Minnesota Vikings",23,36,-10,FALSE,"9/21/2003",2003,"September","2000s",72,NA,NA
"8526","200309210cin","Cincinnati Bengals",10,"Pittsburgh Steelers",17,27,-7,FALSE,"9/21/2003",2003,"September","2000s",63,73,5
"8527","200309210htx","Houston Texans",14,"Kansas City Chiefs",42,56,-28,FALSE,"9/21/2003",2003,"September","2000s",72,NA,NA
"8528","200309220den","Denver Broncos",31,"Oakland Raiders",10,41,21,TRUE,"9/22/2003",2003,"September","2000s",58,34,11
"8529","200309280nyj","New York Jets",6,"Dallas Cowboys",17,23,-11,FALSE,"9/28/2003",2003,"September","2000s",70,94,12
"8530","200309280rai","Oakland Raiders",34,"San Diego Chargers",31,65,3,TRUE,"9/28/2003",2003,"September","2000s",62,80,13
"8531","200309280nor","New Orleans Saints",21,"Indianapolis Colts",55,76,-34,FALSE,"9/28/2003",2003,"September","2000s",72,NA,NA
"8532","200309280den","Denver Broncos",20,"Detroit Lions",16,36,4,TRUE,"9/28/2003",2003,"September","2000s",54,37,8
"8533","200309280min","Minnesota Vikings",35,"San Francisco 49ers",7,42,28,TRUE,"9/28/2003",2003,"September","2000s",72,NA,NA
"8534","200309280pit","Pittsburgh Steelers",13,"Tennessee Titans",30,43,-17,FALSE,"9/28/2003",2003,"September","2000s",55,82,7
"8535","200309280rav","Baltimore Ravens",10,"Kansas City Chiefs",17,27,-7,FALSE,"9/28/2003",2003,"September","2000s",68,72,10
"8536","200309280ram","St. Louis Rams",37,"Arizona Cardinals",13,50,24,TRUE,"9/28/2003",2003,"September","2000s",72,NA,NA
"8537","200309280buf","Buffalo Bills",13,"Philadelphia Eagles",23,36,-10,FALSE,"9/28/2003",2003,"September","2000s",56,75,10
"8538","200309280cle","Cleveland Browns",14,"Cincinnati Bengals",21,35,-7,FALSE,"9/28/2003",2003,"September","2000s",54,71,10
"8539","200309280was","Washington Redskins",20,"New England Patriots",17,37,3,TRUE,"9/28/2003",2003,"September","2000s",69,74,11
"8540","200309280car","Carolina Panthers",23,"Atlanta Falcons",3,26,20,TRUE,"9/28/2003",2003,"September","2000s",67,73,7
"8541","200309280htx","Houston Texans",24,"Jacksonville Jaguars",20,44,4,TRUE,"9/28/2003",2003,"September","2000s",72,NA,NA
"8542","200309290chi","Chicago Bears",23,"Green Bay Packers",38,61,-15,FALSE,"9/29/2003",2003,"September","2000s",49,65,12
"8543","200310050nyg","New York Giants",10,"Miami Dolphins",23,33,-13,FALSE,"10/5/2003",2003,"October","2000s",54,60,12
"8544","200310050car","Carolina Panthers",19,"New Orleans Saints",13,32,6,TRUE,"10/5/2003",2003,"October","2000s",62,66,5
"8545","200310050phi","Philadelphia Eagles",27,"Washington Redskins",25,52,2,TRUE,"10/5/2003",2003,"October","2000s",53,65,12
"8546","200310050chi","Chicago Bears",24,"Oakland Raiders",21,45,3,TRUE,"10/5/2003",2003,"October","2000s",48,73,5
"8547","200310050gnb","Green Bay Packers",35,"Seattle Seahawks",13,48,22,TRUE,"10/5/2003",2003,"October","2000s",40,67,5
"8548","200310050atl","Atlanta Falcons",26,"Minnesota Vikings",39,65,-13,FALSE,"10/5/2003",2003,"October","2000s",72,NA,NA
"8549","200310050jax","Jacksonville Jaguars",27,"San Diego Chargers",21,48,6,TRUE,"10/5/2003",2003,"October","2000s",76,77,5
"8550","200310050sfo","San Francisco 49ers",24,"Detroit Lions",17,41,7,TRUE,"10/5/2003",2003,"October","2000s",61,77,12
"8551","200310050dal","Dallas Cowboys",24,"Arizona Cardinals",7,31,17,TRUE,"10/5/2003",2003,"October","2000s",73,76,8
"8552","200310050kan","Kansas City Chiefs",24,"Denver Broncos",23,47,1,TRUE,"10/5/2003",2003,"October","2000s",62,73,10
"8553","200310050pit","Pittsburgh Steelers",13,"Cleveland Browns",33,46,-20,FALSE,"10/5/2003",2003,"October","2000s",47,63,7
"8554","200310050buf","Buffalo Bills",22,"Cincinnati Bengals",16,38,6,TRUE,"10/5/2003",2003,"October","2000s",44,63,13
"8555","200310050nwe","New England Patriots",38,"Tennessee Titans",30,68,8,TRUE,"10/5/2003",2003,"October","2000s",54,60,14
"8556","200310060tam","Tampa Bay Buccaneers",35,"Indianapolis Colts",38,73,-3,FALSE,"10/6/2003",2003,"October","2000s",78,72,4
"8557","200310120nor","New Orleans Saints",20,"Chicago Bears",13,33,7,TRUE,"10/12/2003",2003,"October","2000s",72,NA,NA
"8558","200310120clt","Indianapolis Colts",20,"Carolina Panthers",23,43,-3,FALSE,"10/12/2003",2003,"October","2000s",72,NA,NA
"8559","200310120dal","Dallas Cowboys",23,"Philadelphia Eagles",21,44,2,TRUE,"10/12/2003",2003,"October","2000s",72,75,10
"8560","200310120was","Washington Redskins",13,"Tampa Bay Buccaneers",35,48,-22,FALSE,"10/12/2003",2003,"October","2000s",67,63,9
"8561","200310120oti","Tennessee Titans",38,"Houston Texans",17,55,21,TRUE,"10/12/2003",2003,"October","2000s",68,81,5
"8562","200310120sea","Seattle Seahawks",20,"San Francisco 49ers",19,39,1,TRUE,"10/12/2003",2003,"October","2000s",52,83,19
"8563","200310120crd","Arizona Cardinals",18,"Baltimore Ravens",26,44,-8,FALSE,"10/12/2003",2003,"October","2000s",85,42,6
"8564","200310120jax","Jacksonville Jaguars",10,"Miami Dolphins",24,34,-14,FALSE,"10/12/2003",2003,"October","2000s",73,98,9
"8565","200310120nyj","New York Jets",30,"Buffalo Bills",3,33,27,TRUE,"10/12/2003",2003,"October","2000s",64,68,15
"8566","200310120nwe","New England Patriots",17,"New York Giants",6,23,11,TRUE,"10/12/2003",2003,"October","2000s",54,95,9
"8567","200310120gnb","Green Bay Packers",34,"Kansas City Chiefs",40,74,-6,FALSE,"10/12/2003",2003,"October","2000s",56,72,16
"8568","200310120cle","Cleveland Browns",13,"Oakland Raiders",7,20,6,TRUE,"10/12/2003",2003,"October","2000s",62,65,11
"8569","200310120den","Denver Broncos",17,"Pittsburgh Steelers",14,31,3,TRUE,"10/12/2003",2003,"October","2000s",52,28,9
"8570","200310130ram","St. Louis Rams",36,"Atlanta Falcons",0,36,36,TRUE,"10/13/2003",2003,"October","2000s",72,NA,NA
"8571","200310190sea","Seattle Seahawks",24,"Chicago Bears",17,41,7,TRUE,"10/19/2003",2003,"October","2000s",60,78,10
"8572","200310190nyg","New York Giants",10,"Philadelphia Eagles",14,24,-4,FALSE,"10/19/2003",2003,"October","2000s",53,68,12
"8573","200310190cin","Cincinnati Bengals",34,"Baltimore Ravens",26,60,8,TRUE,"10/19/2003",2003,"October","2000s",56,67,5
"8574","200310190mia","Miami Dolphins",13,"New England Patriots",19,32,-6,FALSE,"10/19/2003",2003,"October","2000s",78,72,6
"8575","200310190htx","Houston Texans",14,"New York Jets",19,33,-5,FALSE,"10/19/2003",2003,"October","2000s",72,NA,NA
"8576","200310190det","Detroit Lions",7,"Dallas Cowboys",38,45,-31,FALSE,"10/19/2003",2003,"October","2000s",72,NA,NA
"8577","200310190car","Carolina Panthers",17,"Tennessee Titans",37,54,-20,FALSE,"10/19/2003",2003,"October","2000s",56,74,3
"8578","200310190ram","St. Louis Rams",34,"Green Bay Packers",24,58,10,TRUE,"10/19/2003",2003,"October","2000s",72,NA,NA
"8579","200310190min","Minnesota Vikings",28,"Denver Broncos",20,48,8,TRUE,"10/19/2003",2003,"October","2000s",72,NA,NA
"8580","200310190cle","Cleveland Browns",20,"San Diego Chargers",26,46,-6,FALSE,"10/19/2003",2003,"October","2000s",52,67,10
"8581","200310190buf","Buffalo Bills",24,"Washington Redskins",7,31,17,TRUE,"10/19/2003",2003,"October","2000s",44,88,9
"8582","200310190sfo","San Francisco 49ers",24,"Tampa Bay Buccaneers",7,31,17,TRUE,"10/19/2003",2003,"October","2000s",61,74,10
"8583","200310190atl","Atlanta Falcons",17,"New Orleans Saints",45,62,-28,FALSE,"10/19/2003",2003,"October","2000s",72,NA,NA
"8584","200310200rai","Oakland Raiders",10,"Kansas City Chiefs",17,27,-7,FALSE,"10/20/2003",2003,"October","2000s",63,74,6
"8585","200310260tam","Tampa Bay Buccaneers",16,"Dallas Cowboys",0,16,16,TRUE,"10/26/2003",2003,"October","2000s",78,72,8
"8586","200310260phi","Philadelphia Eagles",24,"New York Jets",17,41,7,TRUE,"10/26/2003",2003,"October","2000s",64,87,11
"8587","200310260pit","Pittsburgh Steelers",21,"St. Louis Rams",33,54,-12,FALSE,"10/26/2003",2003,"October","2000s",57,91,6
"8588","200310260nor","New Orleans Saints",20,"Carolina Panthers",23,43,-3,FALSE,"10/26/2003",2003,"October","2000s",72,NA,NA
"8589","200310260crd","Arizona Cardinals",16,"San Francisco 49ers",13,29,3,TRUE,"10/26/2003",2003,"October","2000s",76,6,14
"8590","200310260clt","Indianapolis Colts",30,"Houston Texans",21,51,9,TRUE,"10/26/2003",2003,"October","2000s",72,NA,NA
"8591","200310260jax","Jacksonville Jaguars",17,"Tennessee Titans",30,47,-13,FALSE,"10/26/2003",2003,"October","2000s",75,74,7
"8592","200310260cin","Cincinnati Bengals",27,"Seattle Seahawks",24,51,3,TRUE,"10/26/2003",2003,"October","2000s",51,88,10
"8593","200310260min","Minnesota Vikings",17,"New York Giants",29,46,-12,FALSE,"10/26/2003",2003,"October","2000s",72,NA,NA
"8594","200310260chi","Chicago Bears",24,"Detroit Lions",16,40,8,TRUE,"10/26/2003",2003,"October","2000s",43,75,10
"8595","200310260rav","Baltimore Ravens",26,"Denver Broncos",6,32,20,TRUE,"10/26/2003",2003,"October","2000s",64,87,9
"8596","200310260nwe","New England Patriots",9,"Cleveland Browns",3,12,6,TRUE,"10/26/2003",2003,"October","2000s",56,88,14
"8597","200310260kan","Kansas City Chiefs",38,"Buffalo Bills",5,43,33,TRUE,"10/26/2003",2003,"October","2000s",42,66,9
"8598","200310270sdg","San Diego Chargers",10,"Miami Dolphins",26,36,-16,FALSE,"10/27/2003",2003,"October","2000s",70,16,5
"8599","200311020sea","Seattle Seahawks",23,"Pittsburgh Steelers",16,39,7,TRUE,"11/2/2003",2003,"November","2000s",38,81,9
"8600","200311020dal","Dallas Cowboys",21,"Washington Redskins",14,35,7,TRUE,"11/2/2003",2003,"November","2000s",73,74,12
"8601","200311020crd","Arizona Cardinals",17,"Cincinnati Bengals",14,31,3,TRUE,"11/2/2003",2003,"November","2000s",65,52,8
"8602","200311020nyj","New York Jets",28,"New York Giants",31,59,-3,FALSE,"11/2/2003",2003,"November","2000s",65,71,7
"8603","200311020htx","Houston Texans",14,"Carolina Panthers",10,24,4,TRUE,"11/2/2003",2003,"November","2000s",72,NA,NA
"8604","200311020rav","Baltimore Ravens",24,"Jacksonville Jaguars",17,41,7,TRUE,"11/2/2003",2003,"November","2000s",65,83,3
"8605","200311020chi","Chicago Bears",20,"San Diego Chargers",7,27,13,TRUE,"11/2/2003",2003,"November","2000s",50,97,5
"8606","200311020mia","Miami Dolphins",17,"Indianapolis Colts",23,40,-6,FALSE,"11/2/2003",2003,"November","2000s",77,78,11
"8607","200311020atl","Atlanta Falcons",16,"Philadelphia Eagles",23,39,-7,FALSE,"11/2/2003",2003,"November","2000s",72,NA,NA
"8608","200311020det","Detroit Lions",23,"Oakland Raiders",13,36,10,TRUE,"11/2/2003",2003,"November","2000s",72,NA,NA
"8609","200311020min","Minnesota Vikings",27,"Green Bay Packers",30,57,-3,FALSE,"11/2/2003",2003,"November","2000s",72,NA,NA
"8610","200311020sfo","San Francisco 49ers",30,"St. Louis Rams",10,40,20,TRUE,"11/2/2003",2003,"November","2000s",52,74,10
"8611","200311020tam","Tampa Bay Buccaneers",14,"New Orleans Saints",17,31,-3,FALSE,"11/2/2003",2003,"November","2000s",76,72,9
"8612","200311030den","Denver Broncos",26,"New England Patriots",30,56,-4,FALSE,"11/3/2003",2003,"November","2000s",35,100,10
"8613","200311090ram","St. Louis Rams",33,"Baltimore Ravens",22,55,11,TRUE,"11/9/2003",2003,"November","2000s",72,NA,NA
"8614","200311090was","Washington Redskins",27,"Seattle Seahawks",20,47,7,TRUE,"11/9/2003",2003,"November","2000s",39,40,10
"8615","200311090sdg","San Diego Chargers",42,"Minnesota Vikings",28,70,14,TRUE,"11/9/2003",2003,"November","2000s",62,80,6
"8616","200311090oti","Tennessee Titans",31,"Miami Dolphins",7,38,24,TRUE,"11/9/2003",2003,"November","2000s",45,53,11
"8617","200311090cin","Cincinnati Bengals",34,"Houston Texans",27,61,7,TRUE,"11/9/2003",2003,"November","2000s",35,56,11
"8618","200311090kan","Kansas City Chiefs",41,"Cleveland Browns",20,61,21,TRUE,"11/9/2003",2003,"November","2000s",39,57,11
"8619","200311090det","Detroit Lions",12,"Chicago Bears",10,22,2,TRUE,"11/9/2003",2003,"November","2000s",72,NA,NA
"8620","200311090jax","Jacksonville Jaguars",28,"Indianapolis Colts",23,51,5,TRUE,"11/9/2003",2003,"November","2000s",69,87,23
"8621","200311090car","Carolina Panthers",27,"Tampa Bay Buccaneers",24,51,3,TRUE,"11/9/2003",2003,"November","2000s",49,59,11
"8622","200311090dal","Dallas Cowboys",10,"Buffalo Bills",6,16,4,TRUE,"11/9/2003",2003,"November","2000s",50,94,7
"8623","200311090pit","Pittsburgh Steelers",28,"Arizona Cardinals",15,43,13,TRUE,"11/9/2003",2003,"November","2000s",31,49,7
"8624","200311090nyg","New York Giants",7,"Atlanta Falcons",27,34,-20,FALSE,"11/9/2003",2003,"November","2000s",38,38,11
"8625","200311090rai","Oakland Raiders",24,"New York Jets",27,51,-3,FALSE,"11/9/2003",2003,"November","2000s",58,86,13
"8626","200311100gnb","Green Bay Packers",14,"Philadelphia Eagles",17,31,-3,FALSE,"11/10/2003",2003,"November","2000s",33,72,9
"8627","200311160cle","Cleveland Browns",44,"Arizona Cardinals",6,50,38,TRUE,"11/16/2003",2003,"November","2000s",45,85,7
"8628","200311160mia","Miami Dolphins",9,"Baltimore Ravens",6,15,3,TRUE,"11/16/2003",2003,"November","2000s",76,62,13
"8629","200311160rai","Oakland Raiders",28,"Minnesota Vikings",18,46,10,TRUE,"11/16/2003",2003,"November","2000s",49,84,4
"8630","200311160car","Carolina Panthers",20,"Washington Redskins",17,37,3,TRUE,"11/16/2003",2003,"November","2000s",54,69,6
"8631","200311160phi","Philadelphia Eagles",28,"New York Giants",10,38,18,TRUE,"11/16/2003",2003,"November","2000s",46,73,4
"8632","200311160tam","Tampa Bay Buccaneers",13,"Green Bay Packers",20,33,-7,FALSE,"11/16/2003",2003,"November","2000s",70,66,6
"8633","200311160chi","Chicago Bears",21,"St. Louis Rams",23,44,-2,FALSE,"11/16/2003",2003,"November","2000s",44,98,5
"8634","200311160clt","Indianapolis Colts",38,"New York Jets",31,69,7,TRUE,"11/16/2003",2003,"November","2000s",72,NA,NA
"8635","200311160nor","New Orleans Saints",23,"Atlanta Falcons",20,43,3,TRUE,"11/16/2003",2003,"November","2000s",72,NA,NA
"8636","200311160oti","Tennessee Titans",10,"Jacksonville Jaguars",3,13,7,TRUE,"11/16/2003",2003,"November","2000s",55,94,5
"8637","200311160sea","Seattle Seahawks",35,"Detroit Lions",14,49,21,TRUE,"11/16/2003",2003,"November","2000s",45,90,16
"8638","200311160den","Denver Broncos",37,"San Diego Chargers",8,45,29,TRUE,"11/16/2003",2003,"November","2000s",40,39,10
"8639","200311160buf","Buffalo Bills",10,"Houston Texans",12,22,-2,FALSE,"11/16/2003",2003,"November","2000s",43,83,5
"8640","200311160cin","Cincinnati Bengals",24,"Kansas City Chiefs",19,43,5,TRUE,"11/16/2003",2003,"November","2000s",47,90,8
"8641","200311160nwe","New England Patriots",12,"Dallas Cowboys",0,12,12,TRUE,"11/16/2003",2003,"November","2000s",38,37,13
"8642","200311170sfo","San Francisco 49ers",30,"Pittsburgh Steelers",14,44,16,TRUE,"11/17/2003",2003,"November","2000s",57,86,14
"8643","200311230gnb","Green Bay Packers",20,"San Francisco 49ers",10,30,10,TRUE,"11/23/2003",2003,"November","2000s",40,100,15
"8644","200311230den","Denver Broncos",10,"Chicago Bears",19,29,-9,FALSE,"11/23/2003",2003,"November","2000s",8,70,9
"8645","200311230cle","Cleveland Browns",6,"Pittsburgh Steelers",13,19,-7,FALSE,"11/23/2003",2003,"November","2000s",60,66,14
"8646","200311230htx","Houston Texans",20,"New England Patriots",23,43,-3,FALSE,"11/23/2003",2003,"November","2000s",72,NA,NA
"8647","200311230nyj","New York Jets",13,"Jacksonville Jaguars",10,23,3,TRUE,"11/23/2003",2003,"November","2000s",50,79,7
"8648","200311230kan","Kansas City Chiefs",27,"Oakland Raiders",24,51,3,TRUE,"11/23/2003",2003,"November","2000s",35,88,16
"8649","200311230sdg","San Diego Chargers",27,"Cincinnati Bengals",34,61,-7,FALSE,"11/23/2003",2003,"November","2000s",57,34,6
"8650","200311230phi","Philadelphia Eagles",33,"New Orleans Saints",20,53,13,TRUE,"11/23/2003",2003,"November","2000s",49,91,4
"8651","200311230rav","Baltimore Ravens",44,"Seattle Seahawks",41,85,3,TRUE,"11/23/2003",2003,"November","2000s",47,94,4
"8652","200311230crd","Arizona Cardinals",27,"St. Louis Rams",30,57,-3,FALSE,"11/23/2003",2003,"November","2000s",51,17,11
"8653","200311230mia","Miami Dolphins",24,"Washington Redskins",23,47,1,TRUE,"11/23/2003",2003,"November","2000s",75,65,11
"8654","200311230min","Minnesota Vikings",24,"Detroit Lions",14,38,10,TRUE,"11/23/2003",2003,"November","2000s",72,NA,NA
"8655","200311230dal","Dallas Cowboys",24,"Carolina Panthers",20,44,4,TRUE,"11/23/2003",2003,"November","2000s",59,62,25
"8656","200311230atl","Atlanta Falcons",31,"Tennessee Titans",38,69,-7,FALSE,"11/23/2003",2003,"November","2000s",72,NA,NA
"8657","200311230buf","Buffalo Bills",14,"Indianapolis Colts",17,31,-3,FALSE,"11/23/2003",2003,"November","2000s",56,62,12
"8658","200311240tam","Tampa Bay Buccaneers",19,"New York Giants",13,32,6,TRUE,"11/24/2003",2003,"November","2000s",72,68,8
"8659","200311270dal","Dallas Cowboys",21,"Miami Dolphins",40,61,-19,FALSE,"11/27/2003",2003,"November","2000s",56,72,18
"8660","200311270det","Detroit Lions",22,"Green Bay Packers",14,36,8,TRUE,"11/27/2003",2003,"November","2000s",72,NA,NA
"8661","200311300sdg","San Diego Chargers",24,"Kansas City Chiefs",28,52,-4,FALSE,"11/30/2003",2003,"November","2000s",58,48,4
"8662","200311300jax","Jacksonville Jaguars",17,"Tampa Bay Buccaneers",10,27,7,TRUE,"11/30/2003",2003,"November","2000s",48,50,8
"8663","200311300pit","Pittsburgh Steelers",20,"Cincinnati Bengals",24,44,-4,FALSE,"11/30/2003",2003,"November","2000s",36,67,14
"8664","200311300htx","Houston Texans",17,"Atlanta Falcons",13,30,4,TRUE,"11/30/2003",2003,"November","2000s",72,NA,NA
"8665","200311300rai","Oakland Raiders",8,"Denver Broncos",22,30,-14,FALSE,"11/30/2003",2003,"November","2000s",54,82,8
"8666","200311300rav","Baltimore Ravens",44,"San Francisco 49ers",6,50,38,TRUE,"11/30/2003",2003,"November","2000s",40,52,10
"8667","200311300nyg","New York Giants",7,"Buffalo Bills",24,31,-17,FALSE,"11/30/2003",2003,"November","2000s",43,46,18
"8668","200311300sea","Seattle Seahawks",34,"Cleveland Browns",7,41,27,TRUE,"11/30/2003",2003,"November","2000s",40,91,13
"8669","200311300chi","Chicago Bears",28,"Arizona Cardinals",3,31,25,TRUE,"11/30/2003",2003,"November","2000s",42,52,14
"8670","200311300ram","St. Louis Rams",48,"Minnesota Vikings",17,65,31,TRUE,"11/30/2003",2003,"November","2000s",72,NA,NA
"8671","200311300car","Carolina Panthers",16,"Philadelphia Eagles",25,41,-9,FALSE,"11/30/2003",2003,"November","2000s",41,47,5
"8672","200311300was","Washington Redskins",20,"New Orleans Saints",24,44,-4,FALSE,"11/30/2003",2003,"November","2000s",40,55,10
"8673","200311300clt","Indianapolis Colts",34,"New England Patriots",38,72,-4,FALSE,"11/30/2003",2003,"November","2000s",72,NA,NA
"8674","200312010nyj","New York Jets",24,"Tennessee Titans",17,41,7,TRUE,"12/1/2003",2003,"December","2000s",47,47,17
"8675","200312070phi","Philadelphia Eagles",36,"Dallas Cowboys",10,46,26,TRUE,"12/7/2003",2003,"December","2000s",28,63,20
"8676","200312070jax","Jacksonville Jaguars",27,"Houston Texans",0,27,27,TRUE,"12/7/2003",2003,"December","2000s",46,64,10
"8677","200312070min","Minnesota Vikings",34,"Seattle Seahawks",7,41,27,TRUE,"12/7/2003",2003,"December","2000s",72,NA,NA
"8678","200312070nor","New Orleans Saints",7,"Tampa Bay Buccaneers",14,21,-7,FALSE,"12/7/2003",2003,"December","2000s",72,NA,NA
"8679","200312070oti","Tennessee Titans",27,"Indianapolis Colts",29,56,-2,FALSE,"12/7/2003",2003,"December","2000s",35,75,3
"8680","200312070atl","Atlanta Falcons",20,"Carolina Panthers",14,34,6,TRUE,"12/7/2003",2003,"December","2000s",72,NA,NA
"8681","200312070nyg","New York Giants",7,"Washington Redskins",20,27,-13,FALSE,"12/7/2003",2003,"December","2000s",28,72,21
"8682","200312070buf","Buffalo Bills",17,"New York Jets",6,23,11,TRUE,"12/7/2003",2003,"December","2000s",23,66,9
"8683","200312070det","Detroit Lions",7,"San Diego Chargers",14,21,-7,FALSE,"12/7/2003",2003,"December","2000s",72,NA,NA
"8684","200312070sfo","San Francisco 49ers",50,"Arizona Cardinals",14,64,36,TRUE,"12/7/2003",2003,"December","2000s",57,83,12
"8685","200312070pit","Pittsburgh Steelers",27,"Oakland Raiders",7,34,20,TRUE,"12/7/2003",2003,"December","2000s",28,88,11
"8686","200312070den","Denver Broncos",45,"Kansas City Chiefs",27,72,18,TRUE,"12/7/2003",2003,"December","2000s",45,39,11
"8687","200312070gnb","Green Bay Packers",34,"Chicago Bears",21,55,13,TRUE,"12/7/2003",2003,"December","2000s",28,80,10
"8688","200312070nwe","New England Patriots",12,"Miami Dolphins",0,12,12,TRUE,"12/7/2003",2003,"December","2000s",27,85,24
"8689","200312070rav","Baltimore Ravens",31,"Cincinnati Bengals",13,44,18,TRUE,"12/7/2003",2003,"December","2000s",28,57,16
"8690","200312080cle","Cleveland Browns",20,"St. Louis Rams",26,46,-6,FALSE,"12/8/2003",2003,"December","2000s",27,76,8
"8691","200312140rai","Oakland Raiders",20,"Baltimore Ravens",12,32,8,TRUE,"12/14/2003",2003,"December","2000s",54,73,20
"8692","200312140was","Washington Redskins",0,"Dallas Cowboys",27,27,-27,FALSE,"12/14/2003",2003,"December","2000s",34,76,13
"8693","200312140nwe","New England Patriots",27,"Jacksonville Jaguars",13,40,14,TRUE,"12/14/2003",2003,"December","2000s",23,50,14
"8694","200312140ram","St. Louis Rams",27,"Seattle Seahawks",22,49,5,TRUE,"12/14/2003",2003,"December","2000s",72,NA,NA
"8695","200312140clt","Indianapolis Colts",38,"Atlanta Falcons",7,45,31,TRUE,"12/14/2003",2003,"December","2000s",72,NA,NA
"8696","200312140sdg","San Diego Chargers",21,"Green Bay Packers",38,59,-17,FALSE,"12/14/2003",2003,"December","2000s",55,74,4
"8697","200312140chi","Chicago Bears",13,"Minnesota Vikings",10,23,3,TRUE,"12/14/2003",2003,"December","2000s",28,83,9
"8698","200312140nor","New Orleans Saints",45,"New York Giants",7,52,38,TRUE,"12/14/2003",2003,"December","2000s",72,NA,NA
"8699","200312140cin","Cincinnati Bengals",41,"San Francisco 49ers",38,79,3,TRUE,"12/14/2003",2003,"December","2000s",29,92,10
"8700","200312140nyj","New York Jets",6,"Pittsburgh Steelers",0,6,6,TRUE,"12/14/2003",2003,"December","2000s",31,65,17
"8701","200312140kan","Kansas City Chiefs",45,"Detroit Lions",17,62,28,TRUE,"12/14/2003",2003,"December","2000s",28,91,11
"8702","200312140den","Denver Broncos",23,"Cleveland Browns",20,43,3,TRUE,"12/14/2003",2003,"December","2000s",39,48,12
"8703","200312140oti","Tennessee Titans",28,"Buffalo Bills",26,54,2,TRUE,"12/14/2003",2003,"December","2000s",36,92,8
"8704","200312140tam","Tampa Bay Buccaneers",16,"Houston Texans",3,19,13,TRUE,"12/14/2003",2003,"December","2000s",67,84,10
"8705","200312140crd","Arizona Cardinals",17,"Carolina Panthers",20,37,-3,FALSE,"12/14/2003",2003,"December","2000s",52,60,4
"8706","200312150mia","Miami Dolphins",27,"Philadelphia Eagles",34,61,-7,FALSE,"12/15/2003",2003,"December","2000s",66,82,10
"8707","200312200tam","Tampa Bay Buccaneers",28,"Atlanta Falcons",30,58,-2,FALSE,"12/20/2003",2003,"December","2000s",50,48,10
"8708","200312200nyj","New York Jets",16,"New England Patriots",21,37,-5,FALSE,"12/20/2003",2003,"December","2000s",35,59,14
"8709","200312200min","Minnesota Vikings",45,"Kansas City Chiefs",20,65,25,TRUE,"12/20/2003",2003,"December","2000s",72,NA,NA
"8710","200312210car","Carolina Panthers",20,"Detroit Lions",14,34,6,TRUE,"12/21/2003",2003,"December","2000s",30,52,7
"8711","200312210dal","Dallas Cowboys",19,"New York Giants",3,22,16,TRUE,"12/21/2003",2003,"December","2000s",55,56,18
"8712","200312210phi","Philadelphia Eagles",28,"San Francisco 49ers",31,59,-3,FALSE,"12/21/2003",2003,"December","2000s",32,52,14
"8713","200312210buf","Buffalo Bills",3,"Miami Dolphins",20,23,-17,FALSE,"12/21/2003",2003,"December","2000s",31,63,20
"8714","200312210cle","Cleveland Browns",0,"Baltimore Ravens",35,35,-35,FALSE,"12/21/2003",2003,"December","2000s",29,65,16
"8715","200312210ram","St. Louis Rams",27,"Cincinnati Bengals",10,37,17,TRUE,"12/21/2003",2003,"December","2000s",72,NA,NA
"8716","200312210jax","Jacksonville Jaguars",20,"New Orleans Saints",19,39,1,TRUE,"12/21/2003",2003,"December","2000s",46,49,10
"8717","200312210pit","Pittsburgh Steelers",40,"San Diego Chargers",24,64,16,TRUE,"12/21/2003",2003,"December","2000s",24,73,10
"8718","200312210chi","Chicago Bears",27,"Washington Redskins",24,51,3,TRUE,"12/21/2003",2003,"December","2000s",34,56,17
"8719","200312210sea","Seattle Seahawks",28,"Arizona Cardinals",10,38,18,TRUE,"12/21/2003",2003,"December","2000s",46,94,6
"8720","200312210clt","Indianapolis Colts",17,"Denver Broncos",31,48,-14,FALSE,"12/21/2003",2003,"December","2000s",72,NA,NA
"8721","200312210htx","Houston Texans",24,"Tennessee Titans",27,51,-3,FALSE,"12/21/2003",2003,"December","2000s",72,NA,NA
"8722","200312220rai","Oakland Raiders",7,"Green Bay Packers",41,48,-34,FALSE,"12/22/2003",2003,"December","2000s",51,87,8
"8723","200312270was","Washington Redskins",7,"Philadelphia Eagles",31,38,-24,FALSE,"12/27/2003",2003,"December","2000s",43,40,11
"8724","200312270sfo","San Francisco 49ers",17,"Seattle Seahawks",24,41,-7,FALSE,"12/27/2003",2003,"December","2000s",44,79,6
"8725","200312270nwe","New England Patriots",31,"Buffalo Bills",0,31,31,TRUE,"12/27/2003",2003,"December","2000s",40,46,14
"8726","200312280rav","Baltimore Ravens",13,"Pittsburgh Steelers",10,23,3,TRUE,"12/28/2003",2003,"December","2000s",36,65,4
"8727","200312280sdg","San Diego Chargers",21,"Oakland Raiders",14,35,7,TRUE,"12/28/2003",2003,"December","2000s",50,50,5
"8728","200312280atl","Atlanta Falcons",21,"Jacksonville Jaguars",14,35,7,TRUE,"12/28/2003",2003,"December","2000s",72,NA,NA
"8729","200312280nyg","New York Giants",24,"Carolina Panthers",37,61,-13,FALSE,"12/28/2003",2003,"December","2000s",42,47,7
"8730","200312280htx","Houston Texans",17,"Indianapolis Colts",20,37,-3,FALSE,"12/28/2003",2003,"December","2000s",72,NA,NA
"8731","200312280oti","Tennessee Titans",33,"Tampa Bay Buccaneers",13,46,20,TRUE,"12/28/2003",2003,"December","2000s",46,47,10
"8732","200312280crd","Arizona Cardinals",18,"Minnesota Vikings",17,35,1,TRUE,"12/28/2003",2003,"December","2000s",43,24,9
"8733","200312280mia","Miami Dolphins",23,"New York Jets",21,44,2,TRUE,"12/28/2003",2003,"December","2000s",68,68,10
"8734","200312280kan","Kansas City Chiefs",31,"Chicago Bears",3,34,28,TRUE,"12/28/2003",2003,"December","2000s",44,70,12
"8735","200312280gnb","Green Bay Packers",31,"Denver Broncos",3,34,28,TRUE,"12/28/2003",2003,"December","2000s",42,87,15
"8736","200312280cin","Cincinnati Bengals",14,"Cleveland Browns",22,36,-8,FALSE,"12/28/2003",2003,"December","2000s",45,43,12
"8737","200312280nor","New Orleans Saints",13,"Dallas Cowboys",7,20,6,TRUE,"12/28/2003",2003,"December","2000s",72,NA,NA
"8738","200312280det","Detroit Lions",30,"St. Louis Rams",20,50,10,TRUE,"12/28/2003",2003,"December","2000s",72,NA,NA
"8739","200401030car","Carolina Panthers",29,"Dallas Cowboys",10,39,19,TRUE,"1/3/2004",2004,"January","2000s",57,82,8
"8740","200401030rav","Baltimore Ravens",17,"Tennessee Titans",20,37,-3,FALSE,"1/3/2004",2004,"January","2000s",47,92,3
"8741","200401040gnb","Green Bay Packers",33,"Seattle Seahawks",27,60,6,TRUE,"1/4/2004",2004,"January","2000s",20,72,14
"8742","200401040clt","Indianapolis Colts",41,"Denver Broncos",10,51,31,TRUE,"1/4/2004",2004,"January","2000s",72,NA,NA
"8743","200401100nwe","New England Patriots",17,"Tennessee Titans",14,31,3,TRUE,"1/10/2004",2004,"January","2000s",4,40,15
"8744","200401100ram","St. Louis Rams",23,"Carolina Panthers",29,52,-6,FALSE,"1/10/2004",2004,"January","2000s",72,NA,NA
"8745","200401110phi","Philadelphia Eagles",20,"Green Bay Packers",17,37,3,TRUE,"1/11/2004",2004,"January","2000s",16,42,11
"8746","200401110kan","Kansas City Chiefs",31,"Indianapolis Colts",38,69,-7,FALSE,"1/11/2004",2004,"January","2000s",40,64,16
"8747","200401180nwe","New England Patriots",24,"Indianapolis Colts",14,38,10,TRUE,"1/18/2004",2004,"January","2000s",31,59,8
"8748","200401180phi","Philadelphia Eagles",3,"Carolina Panthers",14,17,-11,FALSE,"1/18/2004",2004,"January","2000s",32,90,10
"8749","200402010car","Carolina Panthers",29,"New England Patriots",32,61,-3,FALSE,"2/1/2004",2004,"Feburary","2000s",72,NA,NA
"8750","200409090nwe","New England Patriots",27,"Indianapolis Colts",24,51,3,TRUE,"9/9/2004",2004,"September","2000s",71,90,14
"8751","200409110mia","Miami Dolphins",7,"Tennessee Titans",17,24,-10,FALSE,"9/11/2004",2004,"September","2000s",84,73,14
"8752","200409120den","Denver Broncos",34,"Kansas City Chiefs",24,58,10,TRUE,"9/12/2004",2004,"September","2000s",72,29,14
"8753","200409120phi","Philadelphia Eagles",31,"New York Giants",17,48,14,TRUE,"9/12/2004",2004,"September","2000s",68,66,6
"8754","200409120buf","Buffalo Bills",10,"Jacksonville Jaguars",13,23,-3,FALSE,"9/12/2004",2004,"September","2000s",66,80,9
"8755","200409120was","Washington Redskins",16,"Tampa Bay Buccaneers",10,26,6,TRUE,"9/12/2004",2004,"September","2000s",72,72,6
"8756","200409120nor","New Orleans Saints",7,"Seattle Seahawks",21,28,-14,FALSE,"9/12/2004",2004,"September","2000s",72,NA,NA
"8757","200409120cle","Cleveland Browns",20,"Baltimore Ravens",3,23,17,TRUE,"9/12/2004",2004,"September","2000s",66,69,5
"8758","200409120nyj","New York Jets",31,"Cincinnati Bengals",24,55,7,TRUE,"9/12/2004",2004,"September","2000s",70,62,6
"8759","200409120ram","St. Louis Rams",17,"Arizona Cardinals",10,27,7,TRUE,"9/12/2004",2004,"September","2000s",72,NA,NA
"8760","200409120min","Minnesota Vikings",35,"Dallas Cowboys",17,52,18,TRUE,"9/12/2004",2004,"September","2000s",72,NA,NA
"8761","200409120pit","Pittsburgh Steelers",24,"Oakland Raiders",21,45,3,TRUE,"9/12/2004",2004,"September","2000s",66,72,3
"8762","200409120htx","Houston Texans",20,"San Diego Chargers",27,47,-7,FALSE,"9/12/2004",2004,"September","2000s",72,NA,NA
"8763","200409120sfo","San Francisco 49ers",19,"Atlanta Falcons",21,40,-2,FALSE,"9/12/2004",2004,"September","2000s",65,81,21
"8764","200409120chi","Chicago Bears",16,"Detroit Lions",20,36,-4,FALSE,"9/12/2004",2004,"September","2000s",71,63,6
"8765","200409130car","Carolina Panthers",14,"Green Bay Packers",24,38,-10,FALSE,"9/13/2004",2004,"September","2000s",71,72,7
"8766","200409190rav","Baltimore Ravens",30,"Pittsburgh Steelers",13,43,17,TRUE,"9/19/2004",2004,"September","2000s",60,54,11
"8767","200409190crd","Arizona Cardinals",12,"New England Patriots",23,35,-11,FALSE,"9/19/2004",2004,"September","2000s",78,70,14
"8768","200409190gnb","Green Bay Packers",10,"Chicago Bears",21,31,-11,FALSE,"9/19/2004",2004,"September","2000s",65,62,11
"8769","200409190tam","Tampa Bay Buccaneers",6,"Seattle Seahawks",10,16,-4,FALSE,"9/19/2004",2004,"September","2000s",80,70,6
"8770","200409190sdg","San Diego Chargers",28,"New York Jets",34,62,-6,FALSE,"9/19/2004",2004,"September","2000s",69,63,10
"8771","200409190det","Detroit Lions",28,"Houston Texans",16,44,12,TRUE,"9/19/2004",2004,"September","2000s",72,NA,NA
"8772","200409190kan","Kansas City Chiefs",17,"Carolina Panthers",28,45,-11,FALSE,"9/19/2004",2004,"September","2000s",74,73,13
"8773","200409190cin","Cincinnati Bengals",16,"Miami Dolphins",13,29,3,TRUE,"9/19/2004",2004,"September","2000s",64,49,11
"8774","200409190jax","Jacksonville Jaguars",7,"Denver Broncos",6,13,1,TRUE,"9/19/2004",2004,"September","2000s",79,69,14
"8775","200409190atl","Atlanta Falcons",34,"St. Louis Rams",17,51,17,TRUE,"9/19/2004",2004,"September","2000s",72,NA,NA
"8776","200409190rai","Oakland Raiders",13,"Buffalo Bills",10,23,3,TRUE,"9/19/2004",2004,"September","2000s",60,72,19
"8777","200409190nyg","New York Giants",20,"Washington Redskins",14,34,6,TRUE,"9/19/2004",2004,"September","2000s",58,61,19
"8778","200409190dal","Dallas Cowboys",19,"Cleveland Browns",12,31,7,TRUE,"9/19/2004",2004,"September","2000s",83,47,10
"8779","200409190nor","New Orleans Saints",30,"San Francisco 49ers",27,57,3,TRUE,"9/19/2004",2004,"September","2000s",72,NA,NA
"8780","200409190oti","Tennessee Titans",17,"Indianapolis Colts",31,48,-14,FALSE,"9/19/2004",2004,"September","2000s",67,55,10
"8781","200409200phi","Philadelphia Eagles",27,"Minnesota Vikings",16,43,11,TRUE,"9/20/2004",2004,"September","2000s",61,52,12
"8782","200409260den","Denver Broncos",23,"San Diego Chargers",13,36,10,TRUE,"9/26/2004",2004,"September","2000s",58,59,10
"8783","200409260det","Detroit Lions",13,"Philadelphia Eagles",30,43,-17,FALSE,"9/26/2004",2004,"September","2000s",72,NA,NA
"8784","200409260kan","Kansas City Chiefs",21,"Houston Texans",24,45,-3,FALSE,"9/26/2004",2004,"September","2000s",66,70,6
"8785","200409260atl","Atlanta Falcons",6,"Arizona Cardinals",3,9,3,TRUE,"9/26/2004",2004,"September","2000s",72,NA,NA
"8786","200409260nyg","New York Giants",27,"Cleveland Browns",10,37,17,TRUE,"9/26/2004",2004,"September","2000s",72,62,7
"8787","200409260min","Minnesota Vikings",27,"Chicago Bears",22,49,5,TRUE,"9/26/2004",2004,"September","2000s",72,NA,NA
"8788","200409260clt","Indianapolis Colts",45,"Green Bay Packers",31,76,14,TRUE,"9/26/2004",2004,"September","2000s",72,NA,NA
"8789","200409260rai","Oakland Raiders",30,"Tampa Bay Buccaneers",20,50,10,TRUE,"9/26/2004",2004,"September","2000s",62,76,8
"8790","200409260mia","Miami Dolphins",3,"Pittsburgh Steelers",13,16,-10,FALSE,"9/26/2004",2004,"September","2000s",80,84,21
"8791","200409260oti","Tennessee Titans",12,"Jacksonville Jaguars",15,27,-3,FALSE,"9/26/2004",2004,"September","2000s",72,49,11
"8792","200409260sea","Seattle Seahawks",34,"San Francisco 49ers",0,34,34,TRUE,"9/26/2004",2004,"September","2000s",55,91,3
"8793","200409260cin","Cincinnati Bengals",9,"Baltimore Ravens",23,32,-14,FALSE,"9/26/2004",2004,"September","2000s",64,62,8
"8794","200409260ram","St. Louis Rams",25,"New Orleans Saints",28,53,-3,FALSE,"9/26/2004",2004,"September","2000s",72,NA,NA
"8795","200409270was","Washington Redskins",18,"Dallas Cowboys",21,39,-3,FALSE,"9/27/2004",2004,"September","2000s",70,76,6
"8796","200410030buf","Buffalo Bills",17,"New England Patriots",31,48,-14,FALSE,"10/3/2004",2004,"October","2000s",50,72,10
"8797","200410030sdg","San Diego Chargers",38,"Tennessee Titans",17,55,21,TRUE,"10/3/2004",2004,"October","2000s",67,72,9
"8798","200410030pit","Pittsburgh Steelers",28,"Cincinnati Bengals",17,45,11,TRUE,"10/3/2004",2004,"October","2000s",50,75,5
"8799","200410030cle","Cleveland Browns",17,"Washington Redskins",13,30,4,TRUE,"10/3/2004",2004,"October","2000s",50,64,9
"8800","200410030gnb","Green Bay Packers",7,"New York Giants",14,21,-7,FALSE,"10/3/2004",2004,"October","2000s",52,47,15
"8801","200410030crd","Arizona Cardinals",34,"New Orleans Saints",10,44,24,TRUE,"10/3/2004",2004,"October","2000s",83,24,6
"8802","200410030tam","Tampa Bay Buccaneers",13,"Denver Broncos",16,29,-3,FALSE,"10/3/2004",2004,"October","2000s",80,70,5
"8803","200410030car","Carolina Panthers",10,"Atlanta Falcons",27,37,-17,FALSE,"10/3/2004",2004,"October","2000s",67,88,5
"8804","200410030jax","Jacksonville Jaguars",17,"Indianapolis Colts",24,41,-7,FALSE,"10/3/2004",2004,"October","2000s",82,71,8
"8805","200410030mia","Miami Dolphins",9,"New York Jets",17,26,-8,FALSE,"10/3/2004",2004,"October","2000s",82,74,12
"8806","200410030htx","Houston Texans",30,"Oakland Raiders",17,47,13,TRUE,"10/3/2004",2004,"October","2000s",72,NA,NA
"8807","200410030chi","Chicago Bears",9,"Philadelphia Eagles",19,28,-10,FALSE,"10/3/2004",2004,"October","2000s",51,46,10
"8808","200410030sfo","San Francisco 49ers",14,"St. Louis Rams",24,38,-10,FALSE,"10/3/2004",2004,"October","2000s",56,87,14
"8809","200410040rav","Baltimore Ravens",24,"Kansas City Chiefs",27,51,-3,FALSE,"10/4/2004",2004,"October","2000s",62,70,4
"8810","200410100dal","Dallas Cowboys",10,"New York Giants",26,36,-16,FALSE,"10/10/2004",2004,"October","2000s",66,91,11
"8811","200410100nyj","New York Jets",16,"Buffalo Bills",14,30,2,TRUE,"10/10/2004",2004,"October","2000s",64,66,13
"8812","200410100den","Denver Broncos",20,"Carolina Panthers",17,37,3,TRUE,"10/10/2004",2004,"October","2000s",55,38,12
"8813","200410100nor","New Orleans Saints",17,"Tampa Bay Buccaneers",20,37,-3,FALSE,"10/10/2004",2004,"October","2000s",72,NA,NA
"8814","200410100pit","Pittsburgh Steelers",34,"Cleveland Browns",23,57,11,TRUE,"10/10/2004",2004,"October","2000s",53,81,9
"8815","200410100clt","Indianapolis Colts",35,"Oakland Raiders",14,49,21,TRUE,"10/10/2004",2004,"October","2000s",72,NA,NA
"8816","200410100atl","Atlanta Falcons",10,"Detroit Lions",17,27,-7,FALSE,"10/10/2004",2004,"October","2000s",72,NA,NA
"8817","200410100was","Washington Redskins",10,"Baltimore Ravens",17,27,-7,FALSE,"10/10/2004",2004,"October","2000s",65,64,11
"8818","200410100sdg","San Diego Chargers",34,"Jacksonville Jaguars",21,55,13,TRUE,"10/10/2004",2004,"October","2000s",66,67,10
"8819","200410100htx","Houston Texans",28,"Minnesota Vikings",34,62,-6,FALSE,"10/10/2004",2004,"October","2000s",72,NA,NA
"8820","200410100sea","Seattle Seahawks",27,"St. Louis Rams",33,60,-6,FALSE,"10/10/2004",2004,"October","2000s",54,86,9
"8821","200410100nwe","New England Patriots",24,"Miami Dolphins",10,34,14,TRUE,"10/10/2004",2004,"October","2000s",62,68,11
"8822","200410100sfo","San Francisco 49ers",31,"Arizona Cardinals",28,59,3,TRUE,"10/10/2004",2004,"October","2000s",62,59,14
"8823","200410110gnb","Green Bay Packers",27,"Tennessee Titans",48,75,-21,FALSE,"10/11/2004",2004,"October","2000s",52,75,5
"8824","200410170nwe","New England Patriots",30,"Seattle Seahawks",20,50,10,TRUE,"10/17/2004",2004,"October","2000s",52,63,14
"8825","200410170dal","Dallas Cowboys",20,"Pittsburgh Steelers",24,44,-4,FALSE,"10/17/2004",2004,"October","2000s",69,68,12
"8826","200410170nor","New Orleans Saints",31,"Minnesota Vikings",38,69,-7,FALSE,"10/17/2004",2004,"October","2000s",72,NA,NA
"8827","200410170buf","Buffalo Bills",20,"Miami Dolphins",13,33,7,TRUE,"10/17/2004",2004,"October","2000s",42,77,19
"8828","200410170cle","Cleveland Browns",34,"Cincinnati Bengals",17,51,17,TRUE,"10/17/2004",2004,"October","2000s",43,64,18
"8829","200410170phi","Philadelphia Eagles",30,"Carolina Panthers",8,38,22,TRUE,"10/17/2004",2004,"October","2000s",51,55,18
"8830","200410170det","Detroit Lions",10,"Green Bay Packers",38,48,-28,FALSE,"10/17/2004",2004,"October","2000s",72,NA,NA
"8831","200410170nyj","New York Jets",22,"San Francisco 49ers",14,36,8,TRUE,"10/17/2004",2004,"October","2000s",51,55,17
"8832","200410170chi","Chicago Bears",10,"Washington Redskins",13,23,-3,FALSE,"10/17/2004",2004,"October","2000s",41,57,15
"8833","200410170oti","Tennessee Titans",10,"Houston Texans",20,30,-10,FALSE,"10/17/2004",2004,"October","2000s",53,56,5
"8834","200410170atl","Atlanta Falcons",21,"San Diego Chargers",20,41,1,TRUE,"10/17/2004",2004,"October","2000s",72,NA,NA
"8835","200410170jax","Jacksonville Jaguars",22,"Kansas City Chiefs",16,38,6,TRUE,"10/17/2004",2004,"October","2000s",71,67,8
"8836","200410170rai","Oakland Raiders",3,"Denver Broncos",31,34,-28,FALSE,"10/17/2004",2004,"October","2000s",62,82,11
"8837","200410180ram","St. Louis Rams",28,"Tampa Bay Buccaneers",21,49,7,TRUE,"10/18/2004",2004,"October","2000s",72,NA,NA
"8838","200410240nyg","New York Giants",13,"Detroit Lions",28,41,-15,FALSE,"10/24/2004",2004,"October","2000s",50,64,13
"8839","200410240gnb","Green Bay Packers",41,"Dallas Cowboys",20,61,21,TRUE,"10/24/2004",2004,"October","2000s",53,76,12
"8840","200410240nwe","New England Patriots",13,"New York Jets",7,20,6,TRUE,"10/24/2004",2004,"October","2000s",48,75,18
"8841","200410240min","Minnesota Vikings",20,"Tennessee Titans",3,23,17,TRUE,"10/24/2004",2004,"October","2000s",72,NA,NA
"8842","200410240rav","Baltimore Ravens",20,"Buffalo Bills",6,26,14,TRUE,"10/24/2004",2004,"October","2000s",46,86,3
"8843","200410240car","Carolina Panthers",6,"San Diego Chargers",17,23,-11,FALSE,"10/24/2004",2004,"October","2000s",57,89,5
"8844","200410240crd","Arizona Cardinals",25,"Seattle Seahawks",17,42,8,TRUE,"10/24/2004",2004,"October","2000s",67,42,6
"8845","200410240clt","Indianapolis Colts",24,"Jacksonville Jaguars",27,51,-3,FALSE,"10/24/2004",2004,"October","2000s",72,NA,NA
"8846","200410240tam","Tampa Bay Buccaneers",19,"Chicago Bears",7,26,12,TRUE,"10/24/2004",2004,"October","2000s",72,70,8
"8847","200410240mia","Miami Dolphins",31,"St. Louis Rams",14,45,17,TRUE,"10/24/2004",2004,"October","2000s",77,71,7
"8848","200410240rai","Oakland Raiders",26,"New Orleans Saints",31,57,-5,FALSE,"10/24/2004",2004,"October","2000s",59,86,8
"8849","200410240cle","Cleveland Browns",31,"Philadelphia Eagles",34,65,-3,FALSE,"10/24/2004",2004,"October","2000s",58,82,12
"8850","200410240kan","Kansas City Chiefs",56,"Atlanta Falcons",10,66,46,TRUE,"10/24/2004",2004,"October","2000s",59,51,11
"8851","200410250cin","Cincinnati Bengals",23,"Denver Broncos",10,33,13,TRUE,"10/25/2004",2004,"October","2000s",56,67,4
"8852","200410310chi","Chicago Bears",23,"San Francisco 49ers",13,36,10,TRUE,"10/31/2004",2004,"October","2000s",50,71,14
"8853","200410310dal","Dallas Cowboys",31,"Detroit Lions",21,52,10,TRUE,"10/31/2004",2004,"October","2000s",71,69,12
"8854","200410310buf","Buffalo Bills",38,"Arizona Cardinals",14,52,24,TRUE,"10/31/2004",2004,"October","2000s",57,67,24
"8855","200410310kan","Kansas City Chiefs",45,"Indianapolis Colts",35,80,10,TRUE,"10/31/2004",2004,"October","2000s",53,63,10
"8856","200410310htx","Houston Texans",20,"Jacksonville Jaguars",6,26,14,TRUE,"10/31/2004",2004,"October","2000s",72,NA,NA
"8857","200410310oti","Tennessee Titans",27,"Cincinnati Bengals",20,47,7,TRUE,"10/31/2004",2004,"October","2000s",67,50,4
"8858","200410310sea","Seattle Seahawks",23,"Carolina Panthers",17,40,6,TRUE,"10/31/2004",2004,"October","2000s",45,74,9
"8859","200410310min","Minnesota Vikings",13,"New York Giants",34,47,-21,FALSE,"10/31/2004",2004,"October","2000s",72,NA,NA
"8860","200410310phi","Philadelphia Eagles",15,"Baltimore Ravens",10,25,5,TRUE,"10/31/2004",2004,"October","2000s",64,71,13
"8861","200410310pit","Pittsburgh Steelers",34,"New England Patriots",20,54,14,TRUE,"10/31/2004",2004,"October","2000s",61,56,14
"8862","200410310was","Washington Redskins",14,"Green Bay Packers",28,42,-14,FALSE,"10/31/2004",2004,"October","2000s",68,66,12
"8863","200410310sdg","San Diego Chargers",42,"Oakland Raiders",14,56,28,TRUE,"10/31/2004",2004,"October","2000s",62,66,6
"8864","200410310den","Denver Broncos",28,"Atlanta Falcons",41,69,-13,FALSE,"10/31/2004",2004,"October","2000s",41,39,10
"8865","200411010nyj","New York Jets",41,"Miami Dolphins",14,55,27,TRUE,"11/1/2004",2004,"November","2000s",59,49,17
"8866","200411070pit","Pittsburgh Steelers",27,"Philadelphia Eagles",3,30,24,TRUE,"11/7/2004",2004,"November","2000s",56,55,12
"8867","200411070tam","Tampa Bay Buccaneers",34,"Kansas City Chiefs",31,65,3,TRUE,"11/7/2004",2004,"November","2000s",65,66,7
"8868","200411070sfo","San Francisco 49ers",27,"Seattle Seahawks",42,69,-15,FALSE,"11/7/2004",2004,"November","2000s",54,85,9
"8869","200411070det","Detroit Lions",10,"Washington Redskins",17,27,-7,FALSE,"11/7/2004",2004,"November","2000s",72,NA,NA
"8870","200411070cin","Cincinnati Bengals",26,"Dallas Cowboys",3,29,23,TRUE,"11/7/2004",2004,"November","2000s",56,64,13
"8871","200411070sdg","San Diego Chargers",43,"New Orleans Saints",17,60,26,TRUE,"11/7/2004",2004,"November","2000s",60,63,6
"8872","200411070ram","St. Louis Rams",22,"New England Patriots",40,62,-18,FALSE,"11/7/2004",2004,"November","2000s",72,NA,NA
"8873","200411070rav","Baltimore Ravens",27,"Cleveland Browns",13,40,14,TRUE,"11/7/2004",2004,"November","2000s",54,53,5
"8874","200411070nyg","New York Giants",21,"Chicago Bears",28,49,-7,FALSE,"11/7/2004",2004,"November","2000s",59,45,12
"8875","200411070car","Carolina Panthers",24,"Oakland Raiders",27,51,-3,FALSE,"11/7/2004",2004,"November","2000s",54,59,4
"8876","200411070buf","Buffalo Bills",22,"New York Jets",17,39,5,TRUE,"11/7/2004",2004,"November","2000s",51,74,18
"8877","200411070mia","Miami Dolphins",23,"Arizona Cardinals",24,47,-1,FALSE,"11/7/2004",2004,"November","2000s",74,70,8
"8878","200411070den","Denver Broncos",31,"Houston Texans",13,44,18,TRUE,"11/7/2004",2004,"November","2000s",50,29,10
"8879","200411080clt","Indianapolis Colts",31,"Minnesota Vikings",28,59,3,TRUE,"11/8/2004",2004,"November","2000s",72,NA,NA
"8880","200411140jax","Jacksonville Jaguars",23,"Detroit Lions",17,40,6,TRUE,"11/14/2004",2004,"November","2000s",65,82,22
"8881","200411140clt","Indianapolis Colts",49,"Houston Texans",14,63,35,TRUE,"11/14/2004",2004,"November","2000s",72,NA,NA
"8882","200411140atl","Atlanta Falcons",24,"Tampa Bay Buccaneers",14,38,10,TRUE,"11/14/2004",2004,"November","2000s",72,NA,NA
"8883","200411140was","Washington Redskins",10,"Cincinnati Bengals",17,27,-7,FALSE,"11/14/2004",2004,"November","2000s",41,44,13
"8884","200411140gnb","Green Bay Packers",34,"Minnesota Vikings",31,65,3,TRUE,"11/14/2004",2004,"November","2000s",36,75,7
"8885","200411140cle","Cleveland Browns",10,"Pittsburgh Steelers",24,34,-14,FALSE,"11/14/2004",2004,"November","2000s",36,59,5
"8886","200411140crd","Arizona Cardinals",17,"New York Giants",14,31,3,TRUE,"11/14/2004",2004,"November","2000s",62,46,12
"8887","200411140ram","St. Louis Rams",23,"Seattle Seahawks",12,35,11,TRUE,"11/14/2004",2004,"November","2000s",72,NA,NA
"8888","200411140nor","New Orleans Saints",27,"Kansas City Chiefs",20,47,7,TRUE,"11/14/2004",2004,"November","2000s",72,NA,NA
"8889","200411140nwe","New England Patriots",29,"Buffalo Bills",6,35,23,TRUE,"11/14/2004",2004,"November","2000s",34,48,13
"8890","200411140oti","Tennessee Titans",17,"Chicago Bears",19,36,-2,FALSE,"11/14/2004",2004,"November","2000s",49,61,9
"8891","200411140nyj","New York Jets",17,"Baltimore Ravens",20,37,-3,FALSE,"11/14/2004",2004,"November","2000s",38,48,14
"8892","200411140sfo","San Francisco 49ers",27,"Carolina Panthers",37,64,-10,FALSE,"11/14/2004",2004,"November","2000s",56,86,6
"8893","200411150dal","Dallas Cowboys",21,"Philadelphia Eagles",49,70,-28,FALSE,"11/15/2004",2004,"November","2000s",56,88,8
"8894","200411210min","Minnesota Vikings",22,"Detroit Lions",19,41,3,TRUE,"11/21/2004",2004,"November","2000s",72,NA,NA
"8895","200411210chi","Chicago Bears",10,"Indianapolis Colts",41,51,-31,FALSE,"11/21/2004",2004,"November","2000s",42,64,8
"8896","200411210jax","Jacksonville Jaguars",15,"Tennessee Titans",18,33,-3,FALSE,"11/21/2004",2004,"November","2000s",71,78,5
"8897","200411210buf","Buffalo Bills",37,"St. Louis Rams",17,54,20,TRUE,"11/21/2004",2004,"November","2000s",50,86,11
"8898","200411210nyg","New York Giants",10,"Atlanta Falcons",14,24,-4,FALSE,"11/21/2004",2004,"November","2000s",49,94,8
"8899","200411210htx","Houston Texans",13,"Green Bay Packers",16,29,-3,FALSE,"11/21/2004",2004,"November","2000s",72,NA,NA
"8900","200411210tam","Tampa Bay Buccaneers",35,"San Francisco 49ers",3,38,32,TRUE,"11/21/2004",2004,"November","2000s",71,73,5
"8901","200411210car","Carolina Panthers",35,"Arizona Cardinals",10,45,25,TRUE,"11/21/2004",2004,"November","2000s",61,78,4
"8902","200411210sea","Seattle Seahawks",24,"Miami Dolphins",17,41,7,TRUE,"11/21/2004",2004,"November","2000s",41,81,3
"8903","200411210rav","Baltimore Ravens",30,"Dallas Cowboys",10,40,20,TRUE,"11/21/2004",2004,"November","2000s",55,90,3
"8904","200411210cin","Cincinnati Bengals",14,"Pittsburgh Steelers",19,33,-5,FALSE,"11/21/2004",2004,"November","2000s",50,85,8
"8905","200411210phi","Philadelphia Eagles",28,"Washington Redskins",6,34,22,TRUE,"11/21/2004",2004,"November","2000s",51,89,7
"8906","200411210cle","Cleveland Browns",7,"New York Jets",10,17,-3,FALSE,"11/21/2004",2004,"November","2000s",49,78,10
"8907","200411210nor","New Orleans Saints",13,"Denver Broncos",34,47,-21,FALSE,"11/21/2004",2004,"November","2000s",72,NA,NA
"8908","200411210rai","Oakland Raiders",17,"San Diego Chargers",23,40,-6,FALSE,"11/21/2004",2004,"November","2000s",55,27,23
"8909","200411220kan","Kansas City Chiefs",19,"New England Patriots",27,46,-8,FALSE,"11/22/2004",2004,"November","2000s",43,85,5
"8910","200411250dal","Dallas Cowboys",21,"Chicago Bears",7,28,14,TRUE,"11/25/2004",2004,"November","2000s",47,57,12
"8911","200411250det","Detroit Lions",9,"Indianapolis Colts",41,50,-32,FALSE,"11/25/2004",2004,"November","2000s",72,NA,NA
"8912","200411280min","Minnesota Vikings",27,"Jacksonville Jaguars",16,43,11,TRUE,"11/28/2004",2004,"November","2000s",72,NA,NA
"8913","200411280nwe","New England Patriots",24,"Baltimore Ravens",3,27,21,TRUE,"11/28/2004",2004,"November","2000s",47,81,20
"8914","200411280kan","Kansas City Chiefs",31,"San Diego Chargers",34,65,-3,FALSE,"11/28/2004",2004,"November","2000s",34,78,11
"8915","200411280cin","Cincinnati Bengals",58,"Cleveland Browns",48,106,10,TRUE,"11/28/2004",2004,"November","2000s",40,77,14
"8916","200411280htx","Houston Texans",31,"Tennessee Titans",21,52,10,TRUE,"11/28/2004",2004,"November","2000s",72,NA,NA
"8917","200411280sfo","San Francisco 49ers",17,"Miami Dolphins",24,41,-7,FALSE,"11/28/2004",2004,"November","2000s",54,48,18
"8918","200411280sea","Seattle Seahawks",9,"Buffalo Bills",38,47,-29,FALSE,"11/28/2004",2004,"November","2000s",40,82,5
"8919","200411280car","Carolina Panthers",21,"Tampa Bay Buccaneers",14,35,7,TRUE,"11/28/2004",2004,"November","2000s",48,75,7
"8920","200411280crd","Arizona Cardinals",3,"New York Jets",13,16,-10,FALSE,"11/28/2004",2004,"November","2000s",59,47,12
"8921","200411280nyg","New York Giants",6,"Philadelphia Eagles",27,33,-21,FALSE,"11/28/2004",2004,"November","2000s",55,81,21
"8922","200411280pit","Pittsburgh Steelers",16,"Washington Redskins",7,23,9,TRUE,"11/28/2004",2004,"November","2000s",43,74,14
"8923","200411280den","Denver Broncos",24,"Oakland Raiders",25,49,-1,FALSE,"11/28/2004",2004,"November","2000s",24,88,15
"8924","200411280atl","Atlanta Falcons",24,"New Orleans Saints",21,45,3,TRUE,"11/28/2004",2004,"November","2000s",72,NA,NA
"8925","200411290gnb","Green Bay Packers",45,"St. Louis Rams",17,62,28,TRUE,"11/29/2004",2004,"November","2000s",31,80,6
"8926","200412050tam","Tampa Bay Buccaneers",27,"Atlanta Falcons",0,27,27,TRUE,"12/5/2004",2004,"December","2000s",61,65,5
"8927","200412050rai","Oakland Raiders",27,"Kansas City Chiefs",34,61,-7,FALSE,"12/5/2004",2004,"December","2000s",46,71,8
"8928","200412050mia","Miami Dolphins",32,"Buffalo Bills",42,74,-10,FALSE,"12/5/2004",2004,"December","2000s",72,76,8
"8929","200412050was","Washington Redskins",31,"New York Giants",7,38,24,TRUE,"12/5/2004",2004,"December","2000s",45,60,8
"8930","200412050cle","Cleveland Browns",15,"New England Patriots",42,57,-27,FALSE,"12/5/2004",2004,"December","2000s",40,74,10
"8931","200412050rav","Baltimore Ravens",26,"Cincinnati Bengals",27,53,-1,FALSE,"12/5/2004",2004,"December","2000s",43,58,6
"8932","200412050clt","Indianapolis Colts",51,"Tennessee Titans",24,75,27,TRUE,"12/5/2004",2004,"December","2000s",72,NA,NA
"8933","200412050det","Detroit Lions",26,"Arizona Cardinals",12,38,14,TRUE,"12/5/2004",2004,"December","2000s",72,NA,NA
"8934","200412050ram","St. Louis Rams",16,"San Francisco 49ers",6,22,10,TRUE,"12/5/2004",2004,"December","2000s",72,NA,NA
"8935","200412050nyj","New York Jets",29,"Houston Texans",7,36,22,TRUE,"12/5/2004",2004,"December","2000s",47,49,14
"8936","200412050chi","Chicago Bears",24,"Minnesota Vikings",14,38,10,TRUE,"12/5/2004",2004,"December","2000s",37,86,9
"8937","200412050jax","Jacksonville Jaguars",16,"Pittsburgh Steelers",17,33,-1,FALSE,"12/5/2004",2004,"December","2000s",53,86,4
"8938","200412050phi","Philadelphia Eagles",47,"Green Bay Packers",17,64,30,TRUE,"12/5/2004",2004,"December","2000s",45,59,12
"8939","200412050nor","New Orleans Saints",21,"Carolina Panthers",32,53,-11,FALSE,"12/5/2004",2004,"December","2000s",72,NA,NA
"8940","200412050sdg","San Diego Chargers",20,"Denver Broncos",17,37,3,TRUE,"12/5/2004",2004,"December","2000s",54,72,11
"8941","200412060sea","Seattle Seahawks",39,"Dallas Cowboys",43,82,-4,FALSE,"12/6/2004",2004,"December","2000s",40,86,10
"8942","200412120jax","Jacksonville Jaguars",22,"Chicago Bears",3,25,19,TRUE,"12/12/2004",2004,"December","2000s",49,62,9
"8943","200412120htx","Houston Texans",14,"Indianapolis Colts",23,37,-9,FALSE,"12/12/2004",2004,"December","2000s",72,NA,NA
"8944","200412120min","Minnesota Vikings",23,"Seattle Seahawks",27,50,-4,FALSE,"12/12/2004",2004,"December","2000s",72,NA,NA
"8945","200412120gnb","Green Bay Packers",16,"Detroit Lions",13,29,3,TRUE,"12/12/2004",2004,"December","2000s",33,79,17
"8946","200412120car","Carolina Panthers",20,"St. Louis Rams",7,27,13,TRUE,"12/12/2004",2004,"December","2000s",43,60,7
"8947","200412120den","Denver Broncos",20,"Miami Dolphins",17,37,3,TRUE,"12/12/2004",2004,"December","2000s",45,39,14
"8948","200412120rav","Baltimore Ravens",37,"New York Giants",14,51,23,TRUE,"12/12/2004",2004,"December","2000s",42,60,12
"8949","200412120atl","Atlanta Falcons",35,"Oakland Raiders",10,45,25,TRUE,"12/12/2004",2004,"December","2000s",72,NA,NA
"8950","200412120sdg","San Diego Chargers",31,"Tampa Bay Buccaneers",24,55,7,TRUE,"12/12/2004",2004,"December","2000s",56,88,5
"8951","200412120was","Washington Redskins",14,"Philadelphia Eagles",17,31,-3,FALSE,"12/12/2004",2004,"December","2000s",44,55,12
"8952","200412120crd","Arizona Cardinals",28,"San Francisco 49ers",31,59,-3,FALSE,"12/12/2004",2004,"December","2000s",62,48,6
"8953","200412120dal","Dallas Cowboys",13,"New Orleans Saints",27,40,-14,FALSE,"12/12/2004",2004,"December","2000s",56,52,10
"8954","200412120nwe","New England Patriots",35,"Cincinnati Bengals",28,63,7,TRUE,"12/12/2004",2004,"December","2000s",42,70,13
"8955","200412120pit","Pittsburgh Steelers",17,"New York Jets",6,23,11,TRUE,"12/12/2004",2004,"December","2000s",33,88,11
"8956","200412120buf","Buffalo Bills",37,"Cleveland Browns",7,44,30,TRUE,"12/12/2004",2004,"December","2000s",32,87,14
"8957","200412130oti","Tennessee Titans",38,"Kansas City Chiefs",49,87,-11,FALSE,"12/13/2004",2004,"December","2000s",43,58,10
"8958","200412180nyg","New York Giants",30,"Pittsburgh Steelers",33,63,-3,FALSE,"12/18/2004",2004,"December","2000s",34,65,11
"8959","200412180atl","Atlanta Falcons",34,"Carolina Panthers",31,65,3,TRUE,"12/18/2004",2004,"December","2000s",72,NA,NA
"8960","200412180sfo","San Francisco 49ers",16,"Washington Redskins",26,42,-10,FALSE,"12/18/2004",2004,"December","2000s",51,86,3
"8961","200412190chi","Chicago Bears",5,"Houston Texans",24,29,-19,FALSE,"12/19/2004",2004,"December","2000s",14,56,20
"8962","200412190crd","Arizona Cardinals",31,"St. Louis Rams",7,38,24,TRUE,"12/19/2004",2004,"December","2000s",61,28,8
"8963","200412190det","Detroit Lions",27,"Minnesota Vikings",28,55,-1,FALSE,"12/19/2004",2004,"December","2000s",72,NA,NA
"8964","200412190phi","Philadelphia Eagles",12,"Dallas Cowboys",7,19,5,TRUE,"12/19/2004",2004,"December","2000s",36,87,5
"8965","200412190clt","Indianapolis Colts",20,"Baltimore Ravens",10,30,10,TRUE,"12/19/2004",2004,"December","2000s",72,NA,NA
"8966","200412190rai","Oakland Raiders",40,"Tennessee Titans",35,75,5,TRUE,"12/19/2004",2004,"December","2000s",48,81,7
"8967","200412190gnb","Green Bay Packers",25,"Jacksonville Jaguars",28,53,-3,FALSE,"12/19/2004",2004,"December","2000s",7,48,19
"8968","200412190tam","Tampa Bay Buccaneers",17,"New Orleans Saints",21,38,-4,FALSE,"12/19/2004",2004,"December","2000s",58,66,9
"8969","200412190kan","Kansas City Chiefs",45,"Denver Broncos",17,62,28,TRUE,"12/19/2004",2004,"December","2000s",20,53,16
"8970","200412190cle","Cleveland Browns",0,"San Diego Chargers",21,21,-21,FALSE,"12/19/2004",2004,"December","2000s",24,81,18
"8971","200412190nyj","New York Jets",37,"Seattle Seahawks",14,51,23,TRUE,"12/19/2004",2004,"December","2000s",40,82,8
"8972","200412190cin","Cincinnati Bengals",17,"Buffalo Bills",33,50,-16,FALSE,"12/19/2004",2004,"December","2000s",29,58,21
"8973","200412200mia","Miami Dolphins",29,"New England Patriots",28,57,1,TRUE,"12/20/2004",2004,"December","2000s",58,59,9
"8974","200412240min","Minnesota Vikings",31,"Green Bay Packers",34,65,-3,FALSE,"12/24/2004",2004,"December","2000s",72,NA,NA
"8975","200412250kan","Kansas City Chiefs",31,"Oakland Raiders",30,61,1,TRUE,"12/25/2004",2004,"December","2000s",27,55,17
"8976","200412250oti","Tennessee Titans",16,"Denver Broncos",37,53,-21,FALSE,"12/25/2004",2004,"December","2000s",21,77,3
"8977","200412260pit","Pittsburgh Steelers",20,"Baltimore Ravens",7,27,13,TRUE,"12/26/2004",2004,"December","2000s",22,75,6
"8978","200412260clt","Indianapolis Colts",34,"San Diego Chargers",31,65,3,TRUE,"12/26/2004",2004,"December","2000s",72,NA,NA
"8979","200412260dal","Dallas Cowboys",13,"Washington Redskins",10,23,3,TRUE,"12/26/2004",2004,"December","2000s",41,50,7
"8980","200412260jax","Jacksonville Jaguars",0,"Houston Texans",21,21,-21,FALSE,"12/26/2004",2004,"December","2000s",43,90,21
"8981","200412260mia","Miami Dolphins",10,"Cleveland Browns",7,17,3,TRUE,"12/26/2004",2004,"December","2000s",69,79,16
"8982","200412260nor","New Orleans Saints",26,"Atlanta Falcons",13,39,13,TRUE,"12/26/2004",2004,"December","2000s",72,NA,NA
"8983","200412260cin","Cincinnati Bengals",23,"New York Giants",22,45,1,TRUE,"12/26/2004",2004,"December","2000s",24,76,8
"8984","200412260sea","Seattle Seahawks",24,"Arizona Cardinals",21,45,3,TRUE,"12/26/2004",2004,"December","2000s",44,85,6
"8985","200412260nyj","New York Jets",7,"New England Patriots",23,30,-16,FALSE,"12/26/2004",2004,"December","2000s",28,60,14
"8986","200412260sfo","San Francisco 49ers",7,"Buffalo Bills",41,48,-34,FALSE,"12/26/2004",2004,"December","2000s",52,85,12
"8987","200412260tam","Tampa Bay Buccaneers",20,"Carolina Panthers",37,57,-17,FALSE,"12/26/2004",2004,"December","2000s",52,86,21
"8988","200412260det","Detroit Lions",19,"Chicago Bears",13,32,6,TRUE,"12/26/2004",2004,"December","2000s",72,NA,NA
"8989","200412270ram","St. Louis Rams",20,"Philadelphia Eagles",7,27,13,TRUE,"12/27/2004",2004,"December","2000s",72,NA,NA
"8990","200501020htx","Houston Texans",14,"Cleveland Browns",22,36,-8,FALSE,"1/2/2005",2005,"January","2000s",72,NA,NA
"8991","200501020car","Carolina Panthers",18,"New Orleans Saints",21,39,-3,FALSE,"1/2/2005",2005,"January","2000s",55,76,3
"8992","200501020sea","Seattle Seahawks",28,"Atlanta Falcons",26,54,2,TRUE,"1/2/2005",2005,"January","2000s",37,72,14
"8993","200501020den","Denver Broncos",33,"Indianapolis Colts",14,47,19,TRUE,"1/2/2005",2005,"January","2000s",28,70,8
"8994","200501020chi","Chicago Bears",14,"Green Bay Packers",31,45,-17,FALSE,"1/2/2005",2005,"January","2000s",43,90,12
"8995","200501020phi","Philadelphia Eagles",10,"Cincinnati Bengals",38,48,-28,FALSE,"1/2/2005",2005,"January","2000s",42,65,8
"8996","200501020crd","Arizona Cardinals",12,"Tampa Bay Buccaneers",7,19,5,TRUE,"1/2/2005",2005,"January","2000s",56,70,6
"8997","200501020sdg","San Diego Chargers",24,"Kansas City Chiefs",17,41,7,TRUE,"1/2/2005",2005,"January","2000s",53,65,4
"8998","200501020nwe","New England Patriots",21,"San Francisco 49ers",7,28,14,TRUE,"1/2/2005",2005,"January","2000s",34,58,13
"8999","200501020was","Washington Redskins",21,"Minnesota Vikings",18,39,3,TRUE,"1/2/2005",2005,"January","2000s",44,71,7
"9000","200501020rav","Baltimore Ravens",30,"Miami Dolphins",23,53,7,TRUE,"1/2/2005",2005,"January","2000s",43,68,7
"9001","200501020buf","Buffalo Bills",24,"Pittsburgh Steelers",29,53,-5,FALSE,"1/2/2005",2005,"January","2000s",40,78,13
"9002","200501020rai","Oakland Raiders",6,"Jacksonville Jaguars",13,19,-7,FALSE,"1/2/2005",2005,"January","2000s",48,93,11
"9003","200501020ram","St. Louis Rams",32,"New York Jets",29,61,3,TRUE,"1/2/2005",2005,"January","2000s",72,NA,NA
"9004","200501020nyg","New York Giants",28,"Dallas Cowboys",24,52,4,TRUE,"1/2/2005",2005,"January","2000s",40,64,11
"9005","200501020oti","Tennessee Titans",24,"Detroit Lions",19,43,5,TRUE,"1/2/2005",2005,"January","2000s",59,81,8
"9006","200501080sea","Seattle Seahawks",20,"St. Louis Rams",27,47,-7,FALSE,"1/8/2005",2005,"January","2000s",38,62,11
"9007","200501080sdg","San Diego Chargers",17,"New York Jets",20,37,-3,FALSE,"1/8/2005",2005,"January","2000s",58,87,18
"9008","200501090clt","Indianapolis Colts",49,"Denver Broncos",24,73,25,TRUE,"1/9/2005",2005,"January","2000s",72,NA,NA
"9009","200501090gnb","Green Bay Packers",17,"Minnesota Vikings",31,48,-14,FALSE,"1/9/2005",2005,"January","2000s",23,84,8
"9010","200501150atl","Atlanta Falcons",47,"St. Louis Rams",17,64,30,TRUE,"1/15/2005",2005,"January","2000s",72,NA,NA
"9011","200501150pit","Pittsburgh Steelers",20,"New York Jets",17,37,3,TRUE,"1/15/2005",2005,"January","2000s",23,62,5
"9012","200501160phi","Philadelphia Eagles",27,"Minnesota Vikings",14,41,13,TRUE,"1/16/2005",2005,"January","2000s",29,52,11
"9013","200501160nwe","New England Patriots",20,"Indianapolis Colts",3,23,17,TRUE,"1/16/2005",2005,"January","2000s",27,56,14
"9014","200501230phi","Philadelphia Eagles",27,"Atlanta Falcons",10,37,17,TRUE,"1/23/2005",2005,"January","2000s",19,71,22
"9015","200501230pit","Pittsburgh Steelers",27,"New England Patriots",41,68,-14,FALSE,"1/23/2005",2005,"January","2000s",9,70,20
"9016","200502060nwe","New England Patriots",24,"Philadelphia Eagles",21,45,3,TRUE,"2/6/2005",2005,"Feburary","2000s",55,73,12
"9017","200509080nwe","New England Patriots",30,"Oakland Raiders",20,50,10,TRUE,"9/8/2005",2005,"September","2000s",71,64,9
"9018","200509110rav","Baltimore Ravens",7,"Indianapolis Colts",24,31,-17,FALSE,"9/11/2005",2005,"September","2000s",69,63,4
"9019","200509110car","Carolina Panthers",20,"New Orleans Saints",23,43,-3,FALSE,"9/11/2005",2005,"September","2000s",74,49,12
"9020","200509110was","Washington Redskins",9,"Chicago Bears",7,16,2,TRUE,"9/11/2005",2005,"September","2000s",73,55,6
"9021","200509110nyg","New York Giants",42,"Arizona Cardinals",19,61,23,TRUE,"9/11/2005",2005,"September","2000s",70,53,10
"9022","200509110mia","Miami Dolphins",34,"Denver Broncos",10,44,24,TRUE,"9/11/2005",2005,"September","2000s",81,80,8
"9023","200509110det","Detroit Lions",17,"Green Bay Packers",3,20,14,TRUE,"9/11/2005",2005,"September","2000s",72,NA,NA
"9024","200509110kan","Kansas City Chiefs",27,"New York Jets",7,34,20,TRUE,"9/11/2005",2005,"September","2000s",78,60,13
"9025","200509110pit","Pittsburgh Steelers",34,"Tennessee Titans",7,41,27,TRUE,"9/11/2005",2005,"September","2000s",68,60,4
"9026","200509110sfo","San Francisco 49ers",28,"St. Louis Rams",25,53,3,TRUE,"9/11/2005",2005,"September","2000s",61,74,20
"9027","200509110jax","Jacksonville Jaguars",26,"Seattle Seahawks",14,40,12,TRUE,"9/11/2005",2005,"September","2000s",79,63,9
"9028","200509110buf","Buffalo Bills",22,"Houston Texans",7,29,15,TRUE,"9/11/2005",2005,"September","2000s",64,58,8
"9029","200509110cle","Cleveland Browns",13,"Cincinnati Bengals",27,40,-14,FALSE,"9/11/2005",2005,"September","2000s",69,63,6
"9030","200509110sdg","San Diego Chargers",24,"Dallas Cowboys",28,52,-4,FALSE,"9/11/2005",2005,"September","2000s",68,64,9
"9031","200509110min","Minnesota Vikings",13,"Tampa Bay Buccaneers",24,37,-11,FALSE,"9/11/2005",2005,"September","2000s",72,NA,NA
"9032","200509120atl","Atlanta Falcons",14,"Philadelphia Eagles",10,24,4,TRUE,"9/12/2005",2005,"September","2000s",72,NA,NA
"9033","200509180crd","Arizona Cardinals",12,"St. Louis Rams",17,29,-5,FALSE,"9/18/2005",2005,"September","2000s",85,15,6
"9034","200509180phi","Philadelphia Eagles",42,"San Francisco 49ers",3,45,39,TRUE,"9/18/2005",2005,"September","2000s",75,57,11
"9035","200509180htx","Houston Texans",7,"Pittsburgh Steelers",27,34,-20,FALSE,"9/18/2005",2005,"September","2000s",72,NA,NA
"9036","200509180clt","Indianapolis Colts",10,"Jacksonville Jaguars",3,13,7,TRUE,"9/18/2005",2005,"September","2000s",72,NA,NA
"9037","200509180nyj","New York Jets",17,"Miami Dolphins",7,24,10,TRUE,"9/18/2005",2005,"September","2000s",75,57,11
"9038","200509180rai","Oakland Raiders",17,"Kansas City Chiefs",23,40,-6,FALSE,"9/18/2005",2005,"September","2000s",60,76,10
"9039","200509180car","Carolina Panthers",27,"New England Patriots",17,44,10,TRUE,"9/18/2005",2005,"September","2000s",77,62,5
"9040","200509180tam","Tampa Bay Buccaneers",19,"Buffalo Bills",3,22,16,TRUE,"9/18/2005",2005,"September","2000s",84,61,7
"9041","200509180sea","Seattle Seahawks",21,"Atlanta Falcons",18,39,3,TRUE,"9/18/2005",2005,"September","2000s",57,77,5
"9042","200509180cin","Cincinnati Bengals",37,"Minnesota Vikings",8,45,29,TRUE,"9/18/2005",2005,"September","2000s",66,74,4
"9043","200509180gnb","Green Bay Packers",24,"Cleveland Browns",26,50,-2,FALSE,"9/18/2005",2005,"September","2000s",66,70,6
"9044","200509180chi","Chicago Bears",38,"Detroit Lions",6,44,32,TRUE,"9/18/2005",2005,"September","2000s",67,67,8
"9045","200509180oti","Tennessee Titans",25,"Baltimore Ravens",10,35,15,TRUE,"9/18/2005",2005,"September","2000s",68,74,3
"9046","200509180den","Denver Broncos",20,"San Diego Chargers",17,37,3,TRUE,"9/18/2005",2005,"September","2000s",65,26,11
"9047","200509190nor","New Orleans Saints",10,"New York Giants",27,37,-17,FALSE,"9/19/2005",2005,"September","2000s",77,53,8
"9048","200509190dal","Dallas Cowboys",13,"Washington Redskins",14,27,-1,FALSE,"9/19/2005",2005,"September","2000s",86,51,11
"9049","200509250gnb","Green Bay Packers",16,"Tampa Bay Buccaneers",17,33,-1,FALSE,"9/25/2005",2005,"September","2000s",64,92,7
"9050","200509250sdg","San Diego Chargers",45,"New York Giants",23,68,22,TRUE,"9/25/2005",2005,"September","2000s",65,70,7
"9051","200509250buf","Buffalo Bills",16,"Atlanta Falcons",24,40,-8,FALSE,"9/25/2005",2005,"September","2000s",68,75,10
"9052","200509250chi","Chicago Bears",7,"Cincinnati Bengals",24,31,-17,FALSE,"9/25/2005",2005,"September","2000s",70,90,8
"9053","200509250clt","Indianapolis Colts",13,"Cleveland Browns",6,19,7,TRUE,"9/25/2005",2005,"September","2000s",72,NA,NA
"9054","200509250phi","Philadelphia Eagles",23,"Oakland Raiders",20,43,3,TRUE,"9/25/2005",2005,"September","2000s",69,60,10
"9055","200509250ram","St. Louis Rams",31,"Tennessee Titans",27,58,4,TRUE,"9/25/2005",2005,"September","2000s",72,NA,NA
"9056","200509250pit","Pittsburgh Steelers",20,"New England Patriots",23,43,-3,FALSE,"9/25/2005",2005,"September","2000s",71,72,7
"9057","200509250min","Minnesota Vikings",33,"New Orleans Saints",16,49,17,TRUE,"9/25/2005",2005,"September","2000s",72,NA,NA
"9058","200509250nyj","New York Jets",20,"Jacksonville Jaguars",26,46,-6,FALSE,"9/25/2005",2005,"September","2000s",67,60,10
"9059","200509250mia","Miami Dolphins",27,"Carolina Panthers",24,51,3,TRUE,"9/25/2005",2005,"September","2000s",82,76,10
"9060","200509250sfo","San Francisco 49ers",31,"Dallas Cowboys",34,65,-3,FALSE,"9/25/2005",2005,"September","2000s",61,57,8
"9061","200509250sea","Seattle Seahawks",37,"Arizona Cardinals",12,49,25,TRUE,"9/25/2005",2005,"September","2000s",56,65,6
"9062","200509260den","Denver Broncos",30,"Kansas City Chiefs",10,40,20,TRUE,"9/26/2005",2005,"September","2000s",58,49,11
"9063","200510020tam","Tampa Bay Buccaneers",17,"Detroit Lions",13,30,4,TRUE,"10/2/2005",2005,"October","2000s",81,74,11
"9064","200510020rav","Baltimore Ravens",13,"New York Jets",3,16,10,TRUE,"10/2/2005",2005,"October","2000s",64,65,4
"9065","200510020atl","Atlanta Falcons",30,"Minnesota Vikings",10,40,20,TRUE,"10/2/2005",2005,"October","2000s",72,NA,NA
"9066","200510020crd","Arizona Cardinals",31,"San Francisco 49ers",14,45,17,TRUE,"10/2/2005",2005,"October","2000s",66,58,7
"9067","200510020nor","New Orleans Saints",19,"Buffalo Bills",7,26,12,TRUE,"10/2/2005",2005,"October","2000s",72,NA,NA
"9068","200510020oti","Tennessee Titans",10,"Indianapolis Colts",31,41,-21,FALSE,"10/2/2005",2005,"October","2000s",75,70,6
"9069","200510020rai","Oakland Raiders",19,"Dallas Cowboys",13,32,6,TRUE,"10/2/2005",2005,"October","2000s",60,74,14
"9070","200510020jax","Jacksonville Jaguars",7,"Denver Broncos",20,27,-13,FALSE,"10/2/2005",2005,"October","2000s",83,73,15
"9071","200510020nyg","New York Giants",44,"St. Louis Rams",24,68,20,TRUE,"10/2/2005",2005,"October","2000s",68,55,6
"9072","200510020nwe","New England Patriots",17,"San Diego Chargers",41,58,-24,FALSE,"10/2/2005",2005,"October","2000s",60,73,9
"9073","200510020was","Washington Redskins",20,"Seattle Seahawks",17,37,3,TRUE,"10/2/2005",2005,"October","2000s",68,60,5
"9074","200510020cin","Cincinnati Bengals",16,"Houston Texans",10,26,6,TRUE,"10/2/2005",2005,"October","2000s",71,75,5
"9075","200510020kan","Kansas City Chiefs",31,"Philadelphia Eagles",37,68,-6,FALSE,"10/2/2005",2005,"October","2000s",75,74,19
"9076","200510030car","Carolina Panthers",32,"Green Bay Packers",29,61,3,TRUE,"10/3/2005",2005,"October","2000s",71,61,7
"9077","200510090det","Detroit Lions",35,"Baltimore Ravens",17,52,18,TRUE,"10/9/2005",2005,"October","2000s",72,NA,NA
"9078","200510090cle","Cleveland Browns",20,"Chicago Bears",10,30,10,TRUE,"10/9/2005",2005,"October","2000s",53,81,11
"9079","200510090htx","Houston Texans",20,"Tennessee Titans",34,54,-14,FALSE,"10/9/2005",2005,"October","2000s",72,NA,NA
"9080","200510090buf","Buffalo Bills",20,"Miami Dolphins",14,34,6,TRUE,"10/9/2005",2005,"October","2000s",48,76,11
"9081","200510090atl","Atlanta Falcons",28,"New England Patriots",31,59,-3,FALSE,"10/9/2005",2005,"October","2000s",72,NA,NA
"9082","200510090dal","Dallas Cowboys",33,"Philadelphia Eagles",10,43,23,TRUE,"10/9/2005",2005,"October","2000s",64,47,9
"9083","200510090den","Denver Broncos",21,"Washington Redskins",19,40,2,TRUE,"10/9/2005",2005,"October","2000s",56,51,16
"9084","200510090jax","Jacksonville Jaguars",23,"Cincinnati Bengals",20,43,3,TRUE,"10/9/2005",2005,"October","2000s",79,86,7
"9085","200510090sfo","San Francisco 49ers",3,"Indianapolis Colts",28,31,-25,FALSE,"10/9/2005",2005,"October","2000s",58,70,15
"9086","200510090crd","Arizona Cardinals",20,"Carolina Panthers",24,44,-4,FALSE,"10/9/2005",2005,"October","2000s",81,22,14
"9087","200510090gnb","Green Bay Packers",52,"New Orleans Saints",3,55,49,TRUE,"10/9/2005",2005,"October","2000s",44,79,7
"9088","200510090ram","St. Louis Rams",31,"Seattle Seahawks",37,68,-6,FALSE,"10/9/2005",2005,"October","2000s",72,NA,NA
"9089","200510090nyj","New York Jets",14,"Tampa Bay Buccaneers",12,26,2,TRUE,"10/9/2005",2005,"October","2000s",60,86,13
"9090","200510100sdg","San Diego Chargers",22,"Pittsburgh Steelers",24,46,-2,FALSE,"10/10/2005",2005,"October","2000s",65,69,5
"9091","200510160rai","Oakland Raiders",14,"San Diego Chargers",27,41,-13,FALSE,"10/16/2005",2005,"October","2000s",60,64,10
"9092","200510160chi","Chicago Bears",28,"Minnesota Vikings",3,31,25,TRUE,"10/16/2005",2005,"October","2000s",53,53,9
"9093","200510160kan","Kansas City Chiefs",28,"Washington Redskins",21,49,7,TRUE,"10/16/2005",2005,"October","2000s",64,46,10
"9094","200510160rav","Baltimore Ravens",16,"Cleveland Browns",3,19,13,TRUE,"10/16/2005",2005,"October","2000s",57,54,14
"9095","200510160sea","Seattle Seahawks",42,"Houston Texans",10,52,32,TRUE,"10/16/2005",2005,"October","2000s",55,84,11
"9096","200510160tam","Tampa Bay Buccaneers",27,"Miami Dolphins",13,40,14,TRUE,"10/16/2005",2005,"October","2000s",75,61,8
"9097","200510160oti","Tennessee Titans",23,"Cincinnati Bengals",31,54,-8,FALSE,"10/16/2005",2005,"October","2000s",63,35,6
"9098","200510160buf","Buffalo Bills",27,"New York Jets",17,44,10,TRUE,"10/16/2005",2005,"October","2000s",52,71,16
"9099","200510160det","Detroit Lions",20,"Carolina Panthers",21,41,-1,FALSE,"10/16/2005",2005,"October","2000s",72,NA,NA
"9100","200510160nor","New Orleans Saints",31,"Atlanta Falcons",34,65,-3,FALSE,"10/16/2005",2005,"October","2000s",72,NA,NA
"9101","200510160dal","Dallas Cowboys",16,"New York Giants",13,29,3,TRUE,"10/16/2005",2005,"October","2000s",73,40,6
"9102","200510160den","Denver Broncos",28,"New England Patriots",20,48,8,TRUE,"10/16/2005",2005,"October","2000s",57,48,12
"9103","200510160pit","Pittsburgh Steelers",17,"Jacksonville Jaguars",23,40,-6,FALSE,"10/16/2005",2005,"October","2000s",50,68,14
"9104","200510170clt","Indianapolis Colts",45,"St. Louis Rams",28,73,17,TRUE,"10/17/2005",2005,"October","2000s",72,NA,NA
"9105","200510210mia","Miami Dolphins",20,"Kansas City Chiefs",30,50,-10,FALSE,"10/21/2005",2005,"October","2000s",81,83,9
"9106","200510230chi","Chicago Bears",10,"Baltimore Ravens",6,16,4,TRUE,"10/23/2005",2005,"October","2000s",41,82,8
"9107","200510230phi","Philadelphia Eagles",20,"San Diego Chargers",17,37,3,TRUE,"10/23/2005",2005,"October","2000s",53,61,14
"9108","200510230crd","Arizona Cardinals",20,"Tennessee Titans",10,30,10,TRUE,"10/23/2005",2005,"October","2000s",75,36,6
"9109","200510230min","Minnesota Vikings",23,"Green Bay Packers",20,43,3,TRUE,"10/23/2005",2005,"October","2000s",72,NA,NA
"9110","200510230cle","Cleveland Browns",10,"Detroit Lions",13,23,-3,FALSE,"10/23/2005",2005,"October","2000s",46,78,7
"9111","200510230was","Washington Redskins",52,"San Francisco 49ers",17,69,35,TRUE,"10/23/2005",2005,"October","2000s",55,58,11
"9112","200510230nyg","New York Giants",24,"Denver Broncos",23,47,1,TRUE,"10/23/2005",2005,"October","2000s",52,72,19
"9113","200510230rai","Oakland Raiders",38,"Buffalo Bills",17,55,21,TRUE,"10/23/2005",2005,"October","2000s",58,86,9
"9114","200510230cin","Cincinnati Bengals",13,"Pittsburgh Steelers",27,40,-14,FALSE,"10/23/2005",2005,"October","2000s",47,87,6
"9115","200510230ram","St. Louis Rams",28,"New Orleans Saints",17,45,11,TRUE,"10/23/2005",2005,"October","2000s",72,NA,NA
"9116","200510230htx","Houston Texans",20,"Indianapolis Colts",38,58,-18,FALSE,"10/23/2005",2005,"October","2000s",72,NA,NA
"9117","200510230sea","Seattle Seahawks",13,"Dallas Cowboys",10,23,3,TRUE,"10/23/2005",2005,"October","2000s",55,90,5
"9118","200510240atl","Atlanta Falcons",27,"New York Jets",14,41,13,TRUE,"10/24/2005",2005,"October","2000s",72,NA,NA
"9119","200510300htx","Houston Texans",19,"Cleveland Browns",16,35,3,TRUE,"10/30/2005",2005,"October","2000s",72,NA,NA
"9120","200510300dal","Dallas Cowboys",34,"Arizona Cardinals",13,47,21,TRUE,"10/30/2005",2005,"October","2000s",65,48,13
"9121","200510300ram","St. Louis Rams",24,"Jacksonville Jaguars",21,45,3,TRUE,"10/30/2005",2005,"October","2000s",72,NA,NA
"9122","200510300car","Carolina Panthers",38,"Minnesota Vikings",13,51,25,TRUE,"10/30/2005",2005,"October","2000s",48,60,3
"9123","200510300sdg","San Diego Chargers",28,"Kansas City Chiefs",20,48,8,TRUE,"10/30/2005",2005,"October","2000s",62,77,7
"9124","200510300det","Detroit Lions",13,"Chicago Bears",19,32,-6,FALSE,"10/30/2005",2005,"October","2000s",72,NA,NA
"9125","200510300nor","New Orleans Saints",6,"Miami Dolphins",21,27,-15,FALSE,"10/30/2005",2005,"October","2000s",57,60,6
"9126","200510300sfo","San Francisco 49ers",15,"Tampa Bay Buccaneers",10,25,5,TRUE,"10/30/2005",2005,"October","2000s",56,75,9
"9127","200510300nyg","New York Giants",36,"Washington Redskins",0,36,36,TRUE,"10/30/2005",2005,"October","2000s",55,50,15
"9128","200510300oti","Tennessee Titans",25,"Oakland Raiders",34,59,-9,FALSE,"10/30/2005",2005,"October","2000s",50,49,5
"9129","200510300nwe","New England Patriots",21,"Buffalo Bills",16,37,5,TRUE,"10/30/2005",2005,"October","2000s",50,54,15
"9130","200510300cin","Cincinnati Bengals",21,"Green Bay Packers",14,35,7,TRUE,"10/30/2005",2005,"October","2000s",45,60,7
"9131","200510300den","Denver Broncos",49,"Philadelphia Eagles",21,70,28,TRUE,"10/30/2005",2005,"October","2000s",44,74,10
"9132","200510310pit","Pittsburgh Steelers",20,"Baltimore Ravens",19,39,1,TRUE,"10/31/2005",2005,"October","2000s",47,59,6
"9133","200511060crd","Arizona Cardinals",19,"Seattle Seahawks",33,52,-14,FALSE,"11/6/2005",2005,"November","2000s",68,27,6
"9134","200511060cle","Cleveland Browns",20,"Tennessee Titans",14,34,6,TRUE,"11/6/2005",2005,"November","2000s",61,71,21
"9135","200511060mia","Miami Dolphins",10,"Atlanta Falcons",17,27,-7,FALSE,"11/6/2005",2005,"November","2000s",78,75,6
"9136","200511060nyj","New York Jets",26,"San Diego Chargers",31,57,-5,FALSE,"11/6/2005",2005,"November","2000s",59,86,9
"9137","200511060nor","New Orleans Saints",17,"Chicago Bears",20,37,-3,FALSE,"11/6/2005",2005,"November","2000s",74,74,5
"9138","200511060min","Minnesota Vikings",27,"Detroit Lions",14,41,13,TRUE,"11/6/2005",2005,"November","2000s",72,NA,NA
"9139","200511060tam","Tampa Bay Buccaneers",14,"Carolina Panthers",34,48,-20,FALSE,"11/6/2005",2005,"November","2000s",74,69,7
"9140","200511060jax","Jacksonville Jaguars",21,"Houston Texans",14,35,7,TRUE,"11/6/2005",2005,"November","2000s",72,68,5
"9141","200511060sfo","San Francisco 49ers",6,"New York Giants",24,30,-18,FALSE,"11/6/2005",2005,"November","2000s",57,80,7
"9142","200511060was","Washington Redskins",17,"Philadelphia Eagles",10,27,7,TRUE,"11/6/2005",2005,"November","2000s",62,73,10
"9143","200511060gnb","Green Bay Packers",10,"Pittsburgh Steelers",20,30,-10,FALSE,"11/6/2005",2005,"November","2000s",43,89,19
"9144","200511060kan","Kansas City Chiefs",27,"Oakland Raiders",23,50,4,TRUE,"11/6/2005",2005,"November","2000s",50,64,10
"9145","200511060rav","Baltimore Ravens",9,"Cincinnati Bengals",21,30,-12,FALSE,"11/6/2005",2005,"November","2000s",59,73,8
"9146","200511070nwe","New England Patriots",21,"Indianapolis Colts",40,61,-19,FALSE,"11/7/2005",2005,"November","2000s",56,60,17
"9147","200511130det","Detroit Lions",29,"Arizona Cardinals",21,50,8,TRUE,"11/13/2005",2005,"November","2000s",72,NA,NA
"9148","200511130buf","Buffalo Bills",14,"Kansas City Chiefs",3,17,11,TRUE,"11/13/2005",2005,"November","2000s",56,45,17
"9149","200511130chi","Chicago Bears",17,"San Francisco 49ers",9,26,8,TRUE,"11/13/2005",2005,"November","2000s",53,59,25
"9150","200511130pit","Pittsburgh Steelers",34,"Cleveland Browns",21,55,13,TRUE,"11/13/2005",2005,"November","2000s",52,51,11
"9151","200511130rai","Oakland Raiders",17,"Denver Broncos",31,48,-14,FALSE,"11/13/2005",2005,"November","2000s",53,80,6
"9152","200511130nyg","New York Giants",21,"Minnesota Vikings",24,45,-3,FALSE,"11/13/2005",2005,"November","2000s",55,61,12
"9153","200511130mia","Miami Dolphins",16,"New England Patriots",23,39,-7,FALSE,"11/13/2005",2005,"November","2000s",77,63,15
"9154","200511130sea","Seattle Seahawks",31,"St. Louis Rams",16,47,15,TRUE,"11/13/2005",2005,"November","2000s",45,93,9
"9155","200511130jax","Jacksonville Jaguars",30,"Baltimore Ravens",3,33,27,TRUE,"11/13/2005",2005,"November","2000s",70,66,6
"9156","200511130tam","Tampa Bay Buccaneers",36,"Washington Redskins",35,71,1,TRUE,"11/13/2005",2005,"November","2000s",72,65,7
"9157","200511130clt","Indianapolis Colts",31,"Houston Texans",17,48,14,TRUE,"11/13/2005",2005,"November","2000s",72,NA,NA
"9158","200511130atl","Atlanta Falcons",25,"Green Bay Packers",33,58,-8,FALSE,"11/13/2005",2005,"November","2000s",72,NA,NA
"9159","200511130car","Carolina Panthers",30,"New York Jets",3,33,27,TRUE,"11/13/2005",2005,"November","2000s",54,60,4
"9160","200511140phi","Philadelphia Eagles",20,"Dallas Cowboys",21,41,-1,FALSE,"11/14/2005",2005,"November","2000s",60,52,10
"9161","200511200atl","Atlanta Falcons",27,"Tampa Bay Buccaneers",30,57,-3,FALSE,"11/20/2005",2005,"November","2000s",72,NA,NA
"9162","200511200sfo","San Francisco 49ers",25,"Seattle Seahawks",27,52,-2,FALSE,"11/20/2005",2005,"November","2000s",57,62,2
"9163","200511200was","Washington Redskins",13,"Oakland Raiders",16,29,-3,FALSE,"11/20/2005",2005,"November","2000s",45,52,6
"9164","200511200rav","Baltimore Ravens",16,"Pittsburgh Steelers",13,29,3,TRUE,"11/20/2005",2005,"November","2000s",42,54,4
"9165","200511200nyg","New York Giants",27,"Philadelphia Eagles",17,44,10,TRUE,"11/20/2005",2005,"November","2000s",48,43,11
"9166","200511200nwe","New England Patriots",24,"New Orleans Saints",17,41,7,TRUE,"11/20/2005",2005,"November","2000s",43,51,12
"9167","200511200oti","Tennessee Titans",28,"Jacksonville Jaguars",31,59,-3,FALSE,"11/20/2005",2005,"November","2000s",46,46,4
"9168","200511200cle","Cleveland Browns",22,"Miami Dolphins",0,22,22,TRUE,"11/20/2005",2005,"November","2000s",45,44,12
"9169","200511200ram","St. Louis Rams",28,"Arizona Cardinals",38,66,-10,FALSE,"11/20/2005",2005,"November","2000s",72,NA,NA
"9170","200511200den","Denver Broncos",27,"New York Jets",0,27,27,TRUE,"11/20/2005",2005,"November","2000s",39,35,10
"9171","200511200sdg","San Diego Chargers",48,"Buffalo Bills",10,58,38,TRUE,"11/20/2005",2005,"November","2000s",67,24,6
"9172","200511200dal","Dallas Cowboys",20,"Detroit Lions",7,27,13,TRUE,"11/20/2005",2005,"November","2000s",53,51,11
"9173","200511200cin","Cincinnati Bengals",37,"Indianapolis Colts",45,82,-8,FALSE,"11/20/2005",2005,"November","2000s",44,48,8
"9174","200511200chi","Chicago Bears",13,"Carolina Panthers",3,16,10,TRUE,"11/20/2005",2005,"November","2000s",40,74,7
"9175","200511200htx","Houston Texans",17,"Kansas City Chiefs",45,62,-28,FALSE,"11/20/2005",2005,"November","2000s",72,NA,NA
"9176","200511210gnb","Green Bay Packers",17,"Minnesota Vikings",20,37,-3,FALSE,"11/21/2005",2005,"November","2000s",38,80,15
"9177","200511240dal","Dallas Cowboys",21,"Denver Broncos",24,45,-3,FALSE,"11/24/2005",2005,"November","2000s",57,43,5
"9178","200511240det","Detroit Lions",7,"Atlanta Falcons",27,34,-20,FALSE,"11/24/2005",2005,"November","2000s",72,NA,NA
"9179","200511270nyj","New York Jets",19,"New Orleans Saints",21,40,-2,FALSE,"11/27/2005",2005,"November","2000s",45,50,6
"9180","200511270cin","Cincinnati Bengals",42,"Baltimore Ravens",29,71,13,TRUE,"11/27/2005",2005,"November","2000s",51,52,10
"9181","200511270tam","Tampa Bay Buccaneers",10,"Chicago Bears",13,23,-3,FALSE,"11/27/2005",2005,"November","2000s",70,69,9
"9182","200511270min","Minnesota Vikings",24,"Cleveland Browns",12,36,12,TRUE,"11/27/2005",2005,"November","2000s",72,NA,NA
"9183","200511270phi","Philadelphia Eagles",19,"Green Bay Packers",14,33,5,TRUE,"11/27/2005",2005,"November","2000s",41,60,5
"9184","200511270oti","Tennessee Titans",33,"San Francisco 49ers",22,55,11,TRUE,"11/27/2005",2005,"November","2000s",57,58,16
"9185","200511270rai","Oakland Raiders",21,"Miami Dolphins",33,54,-12,FALSE,"11/27/2005",2005,"November","2000s",46,65,5
"9186","200511270kan","Kansas City Chiefs",26,"New England Patriots",16,42,10,TRUE,"11/27/2005",2005,"November","2000s",59,78,17
"9187","200511270sea","Seattle Seahawks",24,"New York Giants",21,45,3,TRUE,"11/27/2005",2005,"November","2000s",39,81,7
"9188","200511270htx","Houston Texans",27,"St. Louis Rams",33,60,-6,FALSE,"11/27/2005",2005,"November","2000s",72,NA,NA
"9189","200511270was","Washington Redskins",17,"San Diego Chargers",23,40,-6,FALSE,"11/27/2005",2005,"November","2000s",43,54,5
"9190","200511270crd","Arizona Cardinals",17,"Jacksonville Jaguars",24,41,-7,FALSE,"11/27/2005",2005,"November","2000s",58,18,19
"9191","200511270buf","Buffalo Bills",9,"Carolina Panthers",13,22,-4,FALSE,"11/27/2005",2005,"November","2000s",33,72,7
"9192","200511280clt","Indianapolis Colts",26,"Pittsburgh Steelers",7,33,19,TRUE,"11/28/2005",2005,"November","2000s",72,NA,NA
"9193","200512040nor","New Orleans Saints",3,"Tampa Bay Buccaneers",10,13,-7,FALSE,"12/4/2005",2005,"December","2000s",72,77,14
"9194","200512040clt","Indianapolis Colts",35,"Tennessee Titans",3,38,32,TRUE,"12/4/2005",2005,"December","2000s",72,NA,NA
"9195","200512040kan","Kansas City Chiefs",31,"Denver Broncos",27,58,4,TRUE,"12/4/2005",2005,"December","2000s",22,70,11
"9196","200512040pit","Pittsburgh Steelers",31,"Cincinnati Bengals",38,69,-7,FALSE,"12/4/2005",2005,"December","2000s",27,81,8
"9197","200512040sfo","San Francisco 49ers",10,"Arizona Cardinals",17,27,-7,FALSE,"12/4/2005",2005,"December","2000s",49,59,8
"9198","200512040nyg","New York Giants",17,"Dallas Cowboys",10,27,7,TRUE,"12/4/2005",2005,"December","2000s",33,67,11
"9199","200512040rav","Baltimore Ravens",16,"Houston Texans",15,31,1,TRUE,"12/4/2005",2005,"December","2000s",37,73,10
"9200","200512040ram","St. Louis Rams",9,"Washington Redskins",24,33,-15,FALSE,"12/4/2005",2005,"December","2000s",72,NA,NA
"9201","200512040mia","Miami Dolphins",24,"Buffalo Bills",23,47,1,TRUE,"12/4/2005",2005,"December","2000s",69,67,7
"9202","200512040det","Detroit Lions",16,"Minnesota Vikings",21,37,-5,FALSE,"12/4/2005",2005,"December","2000s",72,NA,NA
"9203","200512040nwe","New England Patriots",16,"New York Jets",3,19,13,TRUE,"12/4/2005",2005,"December","2000s",29,66,11
"9204","200512040sdg","San Diego Chargers",34,"Oakland Raiders",10,44,24,TRUE,"12/4/2005",2005,"December","2000s",57,52,6
"9205","200512040cle","Cleveland Browns",14,"Jacksonville Jaguars",20,34,-6,FALSE,"12/4/2005",2005,"December","2000s",27,78,10
"9206","200512040chi","Chicago Bears",19,"Green Bay Packers",7,26,12,TRUE,"12/4/2005",2005,"December","2000s",26,81,11
"9207","200512040car","Carolina Panthers",24,"Atlanta Falcons",6,30,18,TRUE,"12/4/2005",2005,"December","2000s",49,82,6
"9208","200512050phi","Philadelphia Eagles",0,"Seattle Seahawks",42,42,-42,FALSE,"12/5/2005",2005,"December","2000s",34,58,7
"9209","200512110car","Carolina Panthers",10,"Tampa Bay Buccaneers",20,30,-10,FALSE,"12/11/2005",2005,"December","2000s",40,58,8
"9210","200512110dal","Dallas Cowboys",31,"Kansas City Chiefs",28,59,3,TRUE,"12/11/2005",2005,"December","2000s",49,36,10
"9211","200512110cin","Cincinnati Bengals",23,"Cleveland Browns",20,43,3,TRUE,"12/11/2005",2005,"December","2000s",33,73,17
"9212","200512110crd","Arizona Cardinals",13,"Washington Redskins",17,30,-4,FALSE,"12/11/2005",2005,"December","2000s",56,22,4
"9213","200512110pit","Pittsburgh Steelers",21,"Chicago Bears",9,30,12,TRUE,"12/11/2005",2005,"December","2000s",30,74,10
"9214","200512110jax","Jacksonville Jaguars",18,"Indianapolis Colts",26,44,-8,FALSE,"12/11/2005",2005,"December","2000s",57,55,10
"9215","200512110den","Denver Broncos",12,"Baltimore Ravens",10,22,2,TRUE,"12/11/2005",2005,"December","2000s",28,56,10
"9216","200512110gnb","Green Bay Packers",16,"Detroit Lions",13,29,3,TRUE,"12/11/2005",2005,"December","2000s",23,69,13
"9217","200512110oti","Tennessee Titans",13,"Houston Texans",10,23,3,TRUE,"12/11/2005",2005,"December","2000s",40,55,11
"9218","200512110sdg","San Diego Chargers",21,"Miami Dolphins",23,44,-2,FALSE,"12/11/2005",2005,"December","2000s",61,36,4
"9219","200512110phi","Philadelphia Eagles",23,"New York Giants",26,49,-3,FALSE,"12/11/2005",2005,"December","2000s",32,75,7
"9220","200512110nyj","New York Jets",26,"Oakland Raiders",10,36,16,TRUE,"12/11/2005",2005,"December","2000s",36,64,11
"9221","200512110min","Minnesota Vikings",27,"St. Louis Rams",13,40,14,TRUE,"12/11/2005",2005,"December","2000s",72,NA,NA
"9222","200512110sea","Seattle Seahawks",41,"San Francisco 49ers",3,44,38,TRUE,"12/11/2005",2005,"December","2000s",35,92,4
"9223","200512110buf","Buffalo Bills",7,"New England Patriots",35,42,-28,FALSE,"12/11/2005",2005,"December","2000s",29,74,16
"9224","200512120atl","Atlanta Falcons",36,"New Orleans Saints",17,53,19,TRUE,"12/12/2005",2005,"December","2000s",72,NA,NA
"9225","200512170buf","Buffalo Bills",17,"Denver Broncos",28,45,-11,FALSE,"12/17/2005",2005,"December","2000s",27,79,17
"9226","200512170nyg","New York Giants",27,"Kansas City Chiefs",17,44,10,TRUE,"12/17/2005",2005,"December","2000s",39,50,13
"9227","200512170nwe","New England Patriots",28,"Tampa Bay Buccaneers",0,28,28,TRUE,"12/17/2005",2005,"December","2000s",36,61,16
"9228","200512180det","Detroit Lions",17,"Cincinnati Bengals",41,58,-24,FALSE,"12/18/2005",2005,"December","2000s",72,NA,NA
"9229","200512180jax","Jacksonville Jaguars",10,"San Francisco 49ers",9,19,1,TRUE,"12/18/2005",2005,"December","2000s",54,92,17
"9230","200512180oti","Tennessee Titans",24,"Seattle Seahawks",28,52,-4,FALSE,"12/18/2005",2005,"December","2000s",40,52,6
"9231","200512180min","Minnesota Vikings",3,"Pittsburgh Steelers",18,21,-15,FALSE,"12/18/2005",2005,"December","2000s",72,NA,NA
"9232","200512180ram","St. Louis Rams",16,"Philadelphia Eagles",17,33,-1,FALSE,"12/18/2005",2005,"December","2000s",72,NA,NA
"9233","200512180mia","Miami Dolphins",24,"New York Jets",20,44,4,TRUE,"12/18/2005",2005,"December","2000s",76,83,7
"9234","200512180chi","Chicago Bears",16,"Atlanta Falcons",3,19,13,TRUE,"12/18/2005",2005,"December","2000s",12,68,10
"9235","200512180was","Washington Redskins",35,"Dallas Cowboys",7,42,28,TRUE,"12/18/2005",2005,"December","2000s",38,64,5
"9236","200512180htx","Houston Texans",30,"Arizona Cardinals",19,49,11,TRUE,"12/18/2005",2005,"December","2000s",72,NA,NA
"9237","200512180rai","Oakland Raiders",7,"Cleveland Browns",9,16,-2,FALSE,"12/18/2005",2005,"December","2000s",52,92,19
"9238","200512180nor","New Orleans Saints",10,"Carolina Panthers",27,37,-17,FALSE,"12/18/2005",2005,"December","2000s",46,61,6
"9239","200512180clt","Indianapolis Colts",17,"San Diego Chargers",26,43,-9,FALSE,"12/18/2005",2005,"December","2000s",72,NA,NA
"9240","200512190rav","Baltimore Ravens",48,"Green Bay Packers",3,51,45,TRUE,"12/19/2005",2005,"December","2000s",33,61,11
"9241","200512240crd","Arizona Cardinals",27,"Philadelphia Eagles",21,48,6,TRUE,"12/24/2005",2005,"December","2000s",61,32,4
"9242","200512240cle","Cleveland Browns",0,"Pittsburgh Steelers",41,41,-41,FALSE,"12/24/2005",2005,"December","2000s",41,63,10
"9243","200512240den","Denver Broncos",22,"Oakland Raiders",3,25,19,TRUE,"12/24/2005",2005,"December","2000s",38,39,14
"9244","200512240tam","Tampa Bay Buccaneers",27,"Atlanta Falcons",24,51,3,TRUE,"12/24/2005",2005,"December","2000s",55,69,6
"9245","200512240sea","Seattle Seahawks",28,"Indianapolis Colts",13,41,15,TRUE,"12/24/2005",2005,"December","2000s",55,88,8
"9246","200512240nor","New Orleans Saints",12,"Detroit Lions",13,25,-1,FALSE,"12/24/2005",2005,"December","2000s",72,NA,NA
"9247","200512240htx","Houston Texans",20,"Jacksonville Jaguars",38,58,-18,FALSE,"12/24/2005",2005,"December","2000s",72,NA,NA
"9248","200512240was","Washington Redskins",35,"New York Giants",20,55,15,TRUE,"12/24/2005",2005,"December","2000s",43,49,7
"9249","200512240mia","Miami Dolphins",24,"Tennessee Titans",10,34,14,TRUE,"12/24/2005",2005,"December","2000s",68,71,8
"9250","200512240kan","Kansas City Chiefs",20,"San Diego Chargers",7,27,13,TRUE,"12/24/2005",2005,"December","2000s",43,85,16
"9251","200512240ram","St. Louis Rams",20,"San Francisco 49ers",24,44,-4,FALSE,"12/24/2005",2005,"December","2000s",72,NA,NA
"9252","200512240car","Carolina Panthers",20,"Dallas Cowboys",24,44,-4,FALSE,"12/24/2005",2005,"December","2000s",42,43,7
"9253","200512240cin","Cincinnati Bengals",27,"Buffalo Bills",37,64,-10,FALSE,"12/24/2005",2005,"December","2000s",44,60,12
"9254","200512250gnb","Green Bay Packers",17,"Chicago Bears",24,41,-7,FALSE,"12/25/2005",2005,"December","2000s",34,85,10
"9255","200512250rav","Baltimore Ravens",30,"Minnesota Vikings",23,53,7,TRUE,"12/25/2005",2005,"December","2000s",34,83,5
"9256","200512260nyj","New York Jets",21,"New England Patriots",31,52,-10,FALSE,"12/26/2005",2005,"December","2000s",49,87,13
"9257","200512310rai","Oakland Raiders",21,"New York Giants",30,51,-9,FALSE,"12/31/2005",2005,"December","2000s",58,90,26
"9258","200512310sdg","San Diego Chargers",7,"Denver Broncos",23,30,-16,FALSE,"12/31/2005",2005,"December","2000s",57,81,5
"9259","200601010nyj","New York Jets",30,"Buffalo Bills",26,56,4,TRUE,"1/1/2006",2006,"January","2000s",36,79,7
"9260","200601010min","Minnesota Vikings",34,"Chicago Bears",10,44,24,TRUE,"1/1/2006",2006,"January","2000s",72,NA,NA
"9261","200601010cle","Cleveland Browns",20,"Baltimore Ravens",16,36,4,TRUE,"1/1/2006",2006,"January","2000s",36,78,10
"9262","200601010kan","Kansas City Chiefs",37,"Cincinnati Bengals",3,40,34,TRUE,"1/1/2006",2006,"January","2000s",47,58,14
"9263","200601010pit","Pittsburgh Steelers",35,"Detroit Lions",21,56,14,TRUE,"1/1/2006",2006,"January","2000s",35,78,8
"9264","200601010sfo","San Francisco 49ers",20,"Houston Texans",17,37,3,TRUE,"1/1/2006",2006,"January","2000s",54,78,18
"9265","200601010nwe","New England Patriots",26,"Miami Dolphins",28,54,-2,FALSE,"1/1/2006",2006,"January","2000s",28,83,11
"9266","200601010tam","Tampa Bay Buccaneers",27,"New Orleans Saints",13,40,14,TRUE,"1/1/2006",2006,"January","2000s",66,91,6
"9267","200601010jax","Jacksonville Jaguars",40,"Tennessee Titans",13,53,27,TRUE,"1/1/2006",2006,"January","2000s",0,0,NA
"9268","200601010gnb","Green Bay Packers",23,"Seattle Seahawks",17,40,6,TRUE,"1/1/2006",2006,"January","2000s",32,85,7
"9269","200601010dal","Dallas Cowboys",10,"St. Louis Rams",20,30,-10,FALSE,"1/1/2006",2006,"January","2000s",67,40,19
"9270","200601010clt","Indianapolis Colts",17,"Arizona Cardinals",13,30,4,TRUE,"1/1/2006",2006,"January","2000s",72,NA,NA
"9271","200601010phi","Philadelphia Eagles",20,"Washington Redskins",31,51,-11,FALSE,"1/1/2006",2006,"January","2000s",39,72,8
"9272","200601010atl","Atlanta Falcons",11,"Carolina Panthers",44,55,-33,FALSE,"1/1/2006",2006,"January","2000s",72,NA,NA
"9273","200601070tam","Tampa Bay Buccaneers",10,"Washington Redskins",17,27,-7,FALSE,"1/7/2006",2006,"January","2000s",48,59,9
"9274","200601070nwe","New England Patriots",28,"Jacksonville Jaguars",3,31,25,TRUE,"1/7/2006",2006,"January","2000s",29,55,14
"9275","200601080nyg","New York Giants",0,"Carolina Panthers",23,23,-23,FALSE,"1/8/2006",2006,"January","2000s",39,51,9
"9276","200601080cin","Cincinnati Bengals",17,"Pittsburgh Steelers",31,48,-14,FALSE,"1/8/2006",2006,"January","2000s",42,58,15
"9277","200601140den","Denver Broncos",27,"New England Patriots",13,40,14,TRUE,"1/14/2006",2006,"January","2000s",45,28,10
"9278","200601140sea","Seattle Seahawks",20,"Washington Redskins",10,30,10,TRUE,"1/14/2006",2006,"January","2000s",46,88,9
"9279","200601150clt","Indianapolis Colts",18,"Pittsburgh Steelers",21,39,-3,FALSE,"1/15/2006",2006,"January","2000s",72,NA,NA
"9280","200601150chi","Chicago Bears",21,"Carolina Panthers",29,50,-8,FALSE,"1/15/2006",2006,"January","2000s",33,68,12
"9281","200601220den","Denver Broncos",17,"Pittsburgh Steelers",34,51,-17,FALSE,"1/22/2006",2006,"January","2000s",27,54,11
"9282","200601220sea","Seattle Seahawks",34,"Carolina Panthers",14,48,20,TRUE,"1/22/2006",2006,"January","2000s",46,79,9
"9283","200602050pit","Pittsburgh Steelers",21,"Seattle Seahawks",10,31,11,TRUE,"2/5/2006",2006,"Feburary","2000s",72,NA,NA
"9284","200609070pit","Pittsburgh Steelers",28,"Miami Dolphins",17,45,11,TRUE,"9/7/2006",2006,"September","2000s",62,75,3
"9285","200609100car","Carolina Panthers",6,"Atlanta Falcons",20,26,-14,FALSE,"9/10/2006",2006,"September","2000s",73,76,6
"9286","200609100crd","Arizona Cardinals",34,"San Francisco 49ers",27,61,7,TRUE,"9/10/2006",2006,"September","2000s",72,NA,NA
"9287","200609100det","Detroit Lions",6,"Seattle Seahawks",9,15,-3,FALSE,"9/10/2006",2006,"September","2000s",72,NA,NA
"9288","200609100tam","Tampa Bay Buccaneers",0,"Baltimore Ravens",27,27,-27,FALSE,"9/10/2006",2006,"September","2000s",81,73,6
"9289","200609100htx","Houston Texans",10,"Philadelphia Eagles",24,34,-14,FALSE,"9/10/2006",2006,"September","2000s",72,NA,NA
"9290","200609100oti","Tennessee Titans",16,"New York Jets",23,39,-7,FALSE,"9/10/2006",2006,"September","2000s",78,62,6
"9291","200609100cle","Cleveland Browns",14,"New Orleans Saints",19,33,-5,FALSE,"9/10/2006",2006,"September","2000s",65,74,13
"9292","200609100nwe","New England Patriots",19,"Buffalo Bills",17,36,2,TRUE,"9/10/2006",2006,"September","2000s",64,62,13
"9293","200609100ram","St. Louis Rams",18,"Denver Broncos",10,28,8,TRUE,"9/10/2006",2006,"September","2000s",72,NA,NA
"9294","200609100jax","Jacksonville Jaguars",24,"Dallas Cowboys",17,41,7,TRUE,"9/10/2006",2006,"September","2000s",80,75,10
"9295","200609100nyg","New York Giants",21,"Indianapolis Colts",26,47,-5,FALSE,"9/10/2006",2006,"September","2000s",72,59,10
"9296","200609100kan","Kansas City Chiefs",10,"Cincinnati Bengals",23,33,-13,FALSE,"9/10/2006",2006,"September","2000s",69,83,11
"9297","200609100gnb","Green Bay Packers",0,"Chicago Bears",26,26,-26,FALSE,"9/10/2006",2006,"September","2000s",56,62,11
"9298","200609110was","Washington Redskins",16,"Minnesota Vikings",19,35,-3,FALSE,"9/11/2006",2006,"September","2000s",67,77,9
"9299","200609110rai","Oakland Raiders",0,"San Diego Chargers",27,27,-27,FALSE,"9/11/2006",2006,"September","2000s",62,79,8
"9300","200609170dal","Dallas Cowboys",27,"Washington Redskins",10,37,17,TRUE,"9/17/2006",2006,"September","2000s",83,66,16
"9301","200609170atl","Atlanta Falcons",14,"Tampa Bay Buccaneers",3,17,11,TRUE,"9/17/2006",2006,"September","2000s",72,NA,NA
"9302","200609170sfo","San Francisco 49ers",20,"St. Louis Rams",13,33,7,TRUE,"9/17/2006",2006,"September","2000s",62,57,10
"9303","200609170rav","Baltimore Ravens",28,"Oakland Raiders",6,34,22,TRUE,"9/17/2006",2006,"September","2000s",70,75,5
"9304","200609170sdg","San Diego Chargers",40,"Tennessee Titans",7,47,33,TRUE,"9/17/2006",2006,"September","2000s",68,65,7
"9305","200609170phi","Philadelphia Eagles",24,"New York Giants",30,54,-6,FALSE,"9/17/2006",2006,"September","2000s",71,70,6
"9306","200609170nyj","New York Jets",17,"New England Patriots",24,41,-7,FALSE,"9/17/2006",2006,"September","2000s",73,65,6
"9307","200609170gnb","Green Bay Packers",27,"New Orleans Saints",34,61,-7,FALSE,"9/17/2006",2006,"September","2000s",73,66,12
"9308","200609170den","Denver Broncos",9,"Kansas City Chiefs",6,15,3,TRUE,"9/17/2006",2006,"September","2000s",52,25,22
"9309","200609170mia","Miami Dolphins",6,"Buffalo Bills",16,22,-10,FALSE,"9/17/2006",2006,"September","2000s",82,73,10
"9310","200609170min","Minnesota Vikings",16,"Carolina Panthers",13,29,3,TRUE,"9/17/2006",2006,"September","2000s",72,NA,NA
"9311","200609170cin","Cincinnati Bengals",34,"Cleveland Browns",17,51,17,TRUE,"9/17/2006",2006,"September","2000s",70,67,9
"9312","200609170sea","Seattle Seahawks",21,"Arizona Cardinals",10,31,11,TRUE,"9/17/2006",2006,"September","2000s",58,66,9
"9313","200609170chi","Chicago Bears",34,"Detroit Lions",7,41,27,TRUE,"9/17/2006",2006,"September","2000s",71,69,12
"9314","200609170clt","Indianapolis Colts",43,"Houston Texans",24,67,19,TRUE,"9/17/2006",2006,"September","2000s",72,NA,NA
"9315","200609180jax","Jacksonville Jaguars",9,"Pittsburgh Steelers",0,9,9,TRUE,"9/18/2006",2006,"September","2000s",82,63,10
"9316","200609240buf","Buffalo Bills",20,"New York Jets",28,48,-8,FALSE,"9/24/2006",2006,"September","2000s",66,76,21
"9317","200609240mia","Miami Dolphins",13,"Tennessee Titans",10,23,3,TRUE,"9/24/2006",2006,"September","2000s",84,68,11
"9318","200609240sfo","San Francisco 49ers",24,"Philadelphia Eagles",38,62,-14,FALSE,"9/24/2006",2006,"September","2000s",60,77,12
"9319","200609240crd","Arizona Cardinals",14,"St. Louis Rams",16,30,-2,FALSE,"9/24/2006",2006,"September","2000s",72,NA,NA
"9320","200609240cle","Cleveland Browns",14,"Baltimore Ravens",15,29,-1,FALSE,"9/24/2006",2006,"September","2000s",66,69,17
"9321","200609240htx","Houston Texans",15,"Washington Redskins",31,46,-16,FALSE,"9/24/2006",2006,"September","2000s",72,NA,NA
"9322","200609240sea","Seattle Seahawks",42,"New York Giants",30,72,12,TRUE,"9/24/2006",2006,"September","2000s",61,72,8
"9323","200609240clt","Indianapolis Colts",21,"Jacksonville Jaguars",14,35,7,TRUE,"9/24/2006",2006,"September","2000s",72,NA,NA
"9324","200609240det","Detroit Lions",24,"Green Bay Packers",31,55,-7,FALSE,"9/24/2006",2006,"September","2000s",72,NA,NA
"9325","200609240nwe","New England Patriots",7,"Denver Broncos",17,24,-10,FALSE,"9/24/2006",2006,"September","2000s",72,75,16
"9326","200609240pit","Pittsburgh Steelers",20,"Cincinnati Bengals",28,48,-8,FALSE,"9/24/2006",2006,"September","2000s",67,74,16
"9327","200609240min","Minnesota Vikings",16,"Chicago Bears",19,35,-3,FALSE,"9/24/2006",2006,"September","2000s",72,NA,NA
"9328","200609240tam","Tampa Bay Buccaneers",24,"Carolina Panthers",26,50,-2,FALSE,"9/24/2006",2006,"September","2000s",82,62,5
"9329","200609250nor","New Orleans Saints",23,"Atlanta Falcons",3,26,20,TRUE,"9/25/2006",2006,"September","2000s",72,NA,NA
"9330","200610010kan","Kansas City Chiefs",41,"San Francisco 49ers",0,41,41,TRUE,"10/1/2006",2006,"October","2000s",72,50,14
"9331","200610010oti","Tennessee Titans",14,"Dallas Cowboys",45,59,-31,FALSE,"10/1/2006",2006,"October","2000s",72,51,5
"9332","200610010chi","Chicago Bears",37,"Seattle Seahawks",6,43,31,TRUE,"10/1/2006",2006,"October","2000s",58,69,6
"9333","200610010rav","Baltimore Ravens",16,"San Diego Chargers",13,29,3,TRUE,"10/1/2006",2006,"October","2000s",61,72,8
"9334","200610010cin","Cincinnati Bengals",13,"New England Patriots",38,51,-25,FALSE,"10/1/2006",2006,"October","2000s",60,70,7
"9335","200610010car","Carolina Panthers",21,"New Orleans Saints",18,39,3,TRUE,"10/1/2006",2006,"October","2000s",64,66,4
"9336","200610010buf","Buffalo Bills",17,"Minnesota Vikings",12,29,5,TRUE,"10/1/2006",2006,"October","2000s",55,79,12
"9337","200610010htx","Houston Texans",17,"Miami Dolphins",15,32,2,TRUE,"10/1/2006",2006,"October","2000s",72,NA,NA
"9338","200610010was","Washington Redskins",36,"Jacksonville Jaguars",30,66,6,TRUE,"10/1/2006",2006,"October","2000s",64,70,9
"9339","200610010nyj","New York Jets",28,"Indianapolis Colts",31,59,-3,FALSE,"10/1/2006",2006,"October","2000s",66,63,13
"9340","200610010ram","St. Louis Rams",41,"Detroit Lions",34,75,7,TRUE,"10/1/2006",2006,"October","2000s",72,NA,NA
"9341","200610010rai","Oakland Raiders",21,"Cleveland Browns",24,45,-3,FALSE,"10/1/2006",2006,"October","2000s",61,63,10
"9342","200610010atl","Atlanta Falcons",32,"Arizona Cardinals",10,42,22,TRUE,"10/1/2006",2006,"October","2000s",72,NA,NA
"9343","200610020phi","Philadelphia Eagles",31,"Green Bay Packers",9,40,22,TRUE,"10/2/2006",2006,"October","2000s",62,54,12
"9344","200610080sfo","San Francisco 49ers",34,"Oakland Raiders",20,54,14,TRUE,"10/8/2006",2006,"October","2000s",60,73,11
"9345","200610080sdg","San Diego Chargers",23,"Pittsburgh Steelers",13,36,10,TRUE,"10/8/2006",2006,"October","2000s",64,70,6
"9346","200610080phi","Philadelphia Eagles",38,"Dallas Cowboys",24,62,14,TRUE,"10/8/2006",2006,"October","2000s",61,62,7
"9347","200610080nyg","New York Giants",19,"Washington Redskins",3,22,16,TRUE,"10/8/2006",2006,"October","2000s",61,59,6
"9348","200610080nwe","New England Patriots",20,"Miami Dolphins",10,30,10,TRUE,"10/8/2006",2006,"October","2000s",54,69,6
"9349","200610080jax","Jacksonville Jaguars",41,"New York Jets",0,41,41,TRUE,"10/8/2006",2006,"October","2000s",69,57,12
"9350","200610080clt","Indianapolis Colts",14,"Tennessee Titans",13,27,1,TRUE,"10/8/2006",2006,"October","2000s",72,NA,NA
"9351","200610080gnb","Green Bay Packers",20,"St. Louis Rams",23,43,-3,FALSE,"10/8/2006",2006,"October","2000s",60,56,11
"9352","200610080nor","New Orleans Saints",24,"Tampa Bay Buccaneers",21,45,3,TRUE,"10/8/2006",2006,"October","2000s",72,NA,NA
"9353","200610080crd","Arizona Cardinals",20,"Kansas City Chiefs",23,43,-3,FALSE,"10/8/2006",2006,"October","2000s",72,NA,NA
"9354","200610080min","Minnesota Vikings",26,"Detroit Lions",17,43,9,TRUE,"10/8/2006",2006,"October","2000s",72,NA,NA
"9355","200610080car","Carolina Panthers",20,"Cleveland Browns",12,32,8,TRUE,"10/8/2006",2006,"October","2000s",58,89,13
"9356","200610080chi","Chicago Bears",40,"Buffalo Bills",7,47,33,TRUE,"10/8/2006",2006,"October","2000s",57,60,9
"9357","200610090den","Denver Broncos",13,"Baltimore Ravens",3,16,10,TRUE,"10/9/2006",2006,"October","2000s",39,94,14
"9358","200610150dal","Dallas Cowboys",34,"Houston Texans",6,40,28,TRUE,"10/15/2006",2006,"October","2000s",66,72,10
"9359","200610150sfo","San Francisco 49ers",19,"San Diego Chargers",48,67,-29,FALSE,"10/15/2006",2006,"October","2000s",56,75,12
"9360","200610150den","Denver Broncos",13,"Oakland Raiders",3,16,10,TRUE,"10/15/2006",2006,"October","2000s",55,50,7
"9361","200610150tam","Tampa Bay Buccaneers",14,"Cincinnati Bengals",13,27,1,TRUE,"10/15/2006",2006,"October","2000s",72,49,7
"9362","200610150atl","Atlanta Falcons",14,"New York Giants",27,41,-13,FALSE,"10/15/2006",2006,"October","2000s",72,NA,NA
"9363","200610150pit","Pittsburgh Steelers",45,"Kansas City Chiefs",7,52,38,TRUE,"10/15/2006",2006,"October","2000s",42,54,6
"9364","200610150nor","New Orleans Saints",27,"Philadelphia Eagles",24,51,3,TRUE,"10/15/2006",2006,"October","2000s",72,NA,NA
"9365","200610150nyj","New York Jets",20,"Miami Dolphins",17,37,3,TRUE,"10/15/2006",2006,"October","2000s",52,39,14
"9366","200610150ram","St. Louis Rams",28,"Seattle Seahawks",30,58,-2,FALSE,"10/15/2006",2006,"October","2000s",72,NA,NA
"9367","200610150rav","Baltimore Ravens",21,"Carolina Panthers",23,44,-2,FALSE,"10/15/2006",2006,"October","2000s",46,55,7
"9368","200610150det","Detroit Lions",20,"Buffalo Bills",17,37,3,TRUE,"10/15/2006",2006,"October","2000s",72,NA,NA
"9369","200610150was","Washington Redskins",22,"Tennessee Titans",25,47,-3,FALSE,"10/15/2006",2006,"October","2000s",50,46,7
"9370","200610160crd","Arizona Cardinals",23,"Chicago Bears",24,47,-1,FALSE,"10/16/2006",2006,"October","2000s",72,NA,NA
"9371","200610220clt","Indianapolis Colts",36,"Washington Redskins",22,58,14,TRUE,"10/22/2006",2006,"October","2000s",72,NA,NA
"9372","200610220kan","Kansas City Chiefs",30,"San Diego Chargers",27,57,3,TRUE,"10/22/2006",2006,"October","2000s",39,66,11
"9373","200610220atl","Atlanta Falcons",41,"Pittsburgh Steelers",38,79,3,TRUE,"10/22/2006",2006,"October","2000s",72,NA,NA
"9374","200610220sea","Seattle Seahawks",13,"Minnesota Vikings",31,44,-18,FALSE,"10/22/2006",2006,"October","2000s",53,74,10
"9375","200610220htx","Houston Texans",27,"Jacksonville Jaguars",7,34,20,TRUE,"10/22/2006",2006,"October","2000s",72,NA,NA
"9376","200610220mia","Miami Dolphins",24,"Green Bay Packers",34,58,-10,FALSE,"10/22/2006",2006,"October","2000s",82,66,9
"9377","200610220cle","Cleveland Browns",7,"Denver Broncos",17,24,-10,FALSE,"10/22/2006",2006,"October","2000s",48,71,15
"9378","200610220tam","Tampa Bay Buccaneers",23,"Philadelphia Eagles",21,44,2,TRUE,"10/22/2006",2006,"October","2000s",82,72,8
"9379","200610220buf","Buffalo Bills",6,"New England Patriots",28,34,-22,FALSE,"10/22/2006",2006,"October","2000s",48,82,14
"9380","200610220nyj","New York Jets",31,"Detroit Lions",24,55,7,TRUE,"10/22/2006",2006,"October","2000s",55,57,10
"9381","200610220rai","Oakland Raiders",22,"Arizona Cardinals",9,31,13,TRUE,"10/22/2006",2006,"October","2000s",63,60,5
"9382","200610220cin","Cincinnati Bengals",17,"Carolina Panthers",14,31,3,TRUE,"10/22/2006",2006,"October","2000s",49,67,14
"9383","200610230dal","Dallas Cowboys",22,"New York Giants",36,58,-14,FALSE,"10/23/2006",2006,"October","2000s",55,45,7
"9384","200610290nyg","New York Giants",17,"Tampa Bay Buccaneers",3,20,14,TRUE,"10/29/2006",2006,"October","2000s",50,37,24
"9385","200610290chi","Chicago Bears",41,"San Francisco 49ers",10,51,31,TRUE,"10/29/2006",2006,"October","2000s",43,47,11
"9386","200610290kan","Kansas City Chiefs",35,"Seattle Seahawks",28,63,7,TRUE,"10/29/2006",2006,"October","2000s",58,50,11
"9387","200610290nor","New Orleans Saints",22,"Baltimore Ravens",35,57,-13,FALSE,"10/29/2006",2006,"October","2000s",72,NA,NA
"9388","200610290sdg","San Diego Chargers",38,"St. Louis Rams",24,62,14,TRUE,"10/29/2006",2006,"October","2000s",64,73,5
"9389","200610290rai","Oakland Raiders",20,"Pittsburgh Steelers",13,33,7,TRUE,"10/29/2006",2006,"October","2000s",57,70,8
"9390","200610290den","Denver Broncos",31,"Indianapolis Colts",34,65,-3,FALSE,"10/29/2006",2006,"October","2000s",55,26,14
"9391","200610290cle","Cleveland Browns",20,"New York Jets",13,33,7,TRUE,"10/29/2006",2006,"October","2000s",42,54,19
"9392","200610290cin","Cincinnati Bengals",27,"Atlanta Falcons",29,56,-2,FALSE,"10/29/2006",2006,"October","2000s",50,46,11
"9393","200610290phi","Philadelphia Eagles",6,"Jacksonville Jaguars",13,19,-7,FALSE,"10/29/2006",2006,"October","2000s",49,38,26
"9394","200610290oti","Tennessee Titans",28,"Houston Texans",22,50,6,TRUE,"10/29/2006",2006,"October","2000s",59,41,8
"9395","200610290car","Carolina Panthers",14,"Dallas Cowboys",35,49,-21,FALSE,"10/29/2006",2006,"October","2000s",52,54,7
"9396","200610290gnb","Green Bay Packers",31,"Arizona Cardinals",14,45,17,TRUE,"10/29/2006",2006,"October","2000s",39,48,13
"9397","200610300min","Minnesota Vikings",7,"New England Patriots",31,38,-24,FALSE,"10/30/2006",2006,"October","2000s",72,NA,NA
"9398","200611050rav","Baltimore Ravens",26,"Cincinnati Bengals",20,46,6,TRUE,"11/5/2006",2006,"November","2000s",39,59,3
"9399","200611050jax","Jacksonville Jaguars",37,"Tennessee Titans",7,44,30,TRUE,"11/5/2006",2006,"November","2000s",65,77,17
"9400","200611050tam","Tampa Bay Buccaneers",14,"New Orleans Saints",31,45,-17,FALSE,"11/5/2006",2006,"November","2000s",72,52,10
"9401","200611050sfo","San Francisco 49ers",9,"Minnesota Vikings",3,12,6,TRUE,"11/5/2006",2006,"November","2000s",59,82,8
"9402","200611050chi","Chicago Bears",13,"Miami Dolphins",31,44,-18,FALSE,"11/5/2006",2006,"November","2000s",44,60,9
"9403","200611050ram","St. Louis Rams",17,"Kansas City Chiefs",31,48,-14,FALSE,"11/5/2006",2006,"November","2000s",72,NA,NA
"9404","200611050nyg","New York Giants",14,"Houston Texans",10,24,4,TRUE,"11/5/2006",2006,"November","2000s",45,41,6
"9405","200611050buf","Buffalo Bills",24,"Green Bay Packers",10,34,14,TRUE,"11/5/2006",2006,"November","2000s",42,60,9
"9406","200611050sdg","San Diego Chargers",32,"Cleveland Browns",25,57,7,TRUE,"11/5/2006",2006,"November","2000s",66,57,5
"9407","200611050nwe","New England Patriots",20,"Indianapolis Colts",27,47,-7,FALSE,"11/5/2006",2006,"November","2000s",40,53,7
"9408","200611050det","Detroit Lions",30,"Atlanta Falcons",14,44,16,TRUE,"11/5/2006",2006,"November","2000s",72,NA,NA
"9409","200611050was","Washington Redskins",22,"Dallas Cowboys",19,41,3,TRUE,"11/5/2006",2006,"November","2000s",42,53,4
"9410","200611050pit","Pittsburgh Steelers",20,"Denver Broncos",31,51,-11,FALSE,"11/5/2006",2006,"November","2000s",41,43,5
"9411","200611060sea","Seattle Seahawks",16,"Oakland Raiders",0,16,16,TRUE,"11/6/2006",2006,"November","2000s",57,95,14
"9412","200611120nwe","New England Patriots",14,"New York Jets",17,31,-3,FALSE,"11/12/2006",2006,"November","2000s",55,92,11
"9413","200611120sea","Seattle Seahawks",24,"St. Louis Rams",22,46,2,TRUE,"11/12/2006",2006,"November","2000s",45,88,16
"9414","200611120oti","Tennessee Titans",26,"Baltimore Ravens",27,53,-1,FALSE,"11/12/2006",2006,"November","2000s",45,63,9
"9415","200611120cin","Cincinnati Bengals",41,"San Diego Chargers",49,90,-8,FALSE,"11/12/2006",2006,"November","2000s",39,74,11
"9416","200611120det","Detroit Lions",13,"San Francisco 49ers",19,32,-6,FALSE,"11/12/2006",2006,"November","2000s",72,NA,NA
"9417","200611120phi","Philadelphia Eagles",27,"Washington Redskins",3,30,24,TRUE,"11/12/2006",2006,"November","2000s",59,88,13
"9418","200611120pit","Pittsburgh Steelers",38,"New Orleans Saints",31,69,7,TRUE,"11/12/2006",2006,"November","2000s",41,85,14
"9419","200611120mia","Miami Dolphins",13,"Kansas City Chiefs",10,23,3,TRUE,"11/12/2006",2006,"November","2000s",75,63,5
"9420","200611120jax","Jacksonville Jaguars",10,"Houston Texans",13,23,-3,FALSE,"11/12/2006",2006,"November","2000s",63,59,12
"9421","200611120clt","Indianapolis Colts",17,"Buffalo Bills",16,33,1,TRUE,"11/12/2006",2006,"November","2000s",72,NA,NA
"9422","200611120nyg","New York Giants",20,"Chicago Bears",38,58,-18,FALSE,"11/12/2006",2006,"November","2000s",60,86,12
"9423","200611120atl","Atlanta Falcons",13,"Cleveland Browns",17,30,-4,FALSE,"11/12/2006",2006,"November","2000s",72,NA,NA
"9424","200611120crd","Arizona Cardinals",10,"Dallas Cowboys",27,37,-17,FALSE,"11/12/2006",2006,"November","2000s",72,NA,NA
"9425","200611120rai","Oakland Raiders",13,"Denver Broncos",17,30,-4,FALSE,"11/12/2006",2006,"November","2000s",50,67,6
"9426","200611120min","Minnesota Vikings",17,"Green Bay Packers",23,40,-6,FALSE,"11/12/2006",2006,"November","2000s",72,NA,NA
"9427","200611130car","Carolina Panthers",24,"Tampa Bay Buccaneers",10,34,14,TRUE,"11/13/2006",2006,"November","2000s",52,58,6
"9428","200611190tam","Tampa Bay Buccaneers",20,"Washington Redskins",17,37,3,TRUE,"11/19/2006",2006,"November","2000s",58,60,8
"9429","200611190phi","Philadelphia Eagles",13,"Tennessee Titans",31,44,-18,FALSE,"11/19/2006",2006,"November","2000s",45,58,9
"9430","200611190cle","Cleveland Browns",20,"Pittsburgh Steelers",24,44,-4,FALSE,"11/19/2006",2006,"November","2000s",40,76,9
"9431","200611190kan","Kansas City Chiefs",17,"Oakland Raiders",13,30,4,TRUE,"11/19/2006",2006,"November","2000s",34,68,6
"9432","200611190car","Carolina Panthers",15,"St. Louis Rams",0,15,15,TRUE,"11/19/2006",2006,"November","2000s",44,64,5
"9433","200611190den","Denver Broncos",27,"San Diego Chargers",35,62,-8,FALSE,"11/19/2006",2006,"November","2000s",40,50,8
"9434","200611190gnb","Green Bay Packers",0,"New England Patriots",35,35,-35,FALSE,"11/19/2006",2006,"November","2000s",37,59,10
"9435","200611190mia","Miami Dolphins",24,"Minnesota Vikings",20,44,4,TRUE,"11/19/2006",2006,"November","2000s",64,49,8
"9436","200611190crd","Arizona Cardinals",17,"Detroit Lions",10,27,7,TRUE,"11/19/2006",2006,"November","2000s",72,NA,NA
"9437","200611190dal","Dallas Cowboys",21,"Indianapolis Colts",14,35,7,TRUE,"11/19/2006",2006,"November","2000s",51,42,8
"9438","200611190nor","New Orleans Saints",16,"Cincinnati Bengals",31,47,-15,FALSE,"11/19/2006",2006,"November","2000s",72,NA,NA
"9439","200611190nyj","New York Jets",0,"Chicago Bears",10,10,-10,FALSE,"11/19/2006",2006,"November","2000s",47,58,12
"9440","200611190htx","Houston Texans",21,"Buffalo Bills",24,45,-3,FALSE,"11/19/2006",2006,"November","2000s",72,NA,NA
"9441","200611190rav","Baltimore Ravens",24,"Atlanta Falcons",10,34,14,TRUE,"11/19/2006",2006,"November","2000s",44,66,6
"9442","200611190sfo","San Francisco 49ers",20,"Seattle Seahawks",14,34,6,TRUE,"11/19/2006",2006,"November","2000s",57,83,6
"9443","200611200jax","Jacksonville Jaguars",26,"New York Giants",10,36,16,TRUE,"11/20/2006",2006,"November","2000s",52,49,10
"9444","200611230kan","Kansas City Chiefs",19,"Denver Broncos",10,29,9,TRUE,"11/23/2006",2006,"November","2000s",51,60,11
"9445","200611230dal","Dallas Cowboys",38,"Tampa Bay Buccaneers",10,48,28,TRUE,"11/23/2006",2006,"November","2000s",59,60,11
"9446","200611230det","Detroit Lions",10,"Miami Dolphins",27,37,-17,FALSE,"11/23/2006",2006,"November","2000s",72,NA,NA
"9447","200611260ram","St. Louis Rams",20,"San Francisco 49ers",17,37,3,TRUE,"11/26/2006",2006,"November","2000s",72,NA,NA
"9448","200611260sdg","San Diego Chargers",21,"Oakland Raiders",14,35,7,TRUE,"11/26/2006",2006,"November","2000s",58,63,6
"9449","200611260rav","Baltimore Ravens",27,"Pittsburgh Steelers",0,27,27,TRUE,"11/26/2006",2006,"November","2000s",43,82,2
"9450","200611260clt","Indianapolis Colts",45,"Philadelphia Eagles",21,66,24,TRUE,"11/26/2006",2006,"November","2000s",72,NA,NA
"9451","200611260oti","Tennessee Titans",24,"New York Giants",21,45,3,TRUE,"11/26/2006",2006,"November","2000s",56,53,6
"9452","200611260atl","Atlanta Falcons",13,"New Orleans Saints",31,44,-18,FALSE,"11/26/2006",2006,"November","2000s",72,NA,NA
"9453","200611260was","Washington Redskins",17,"Carolina Panthers",13,30,4,TRUE,"11/26/2006",2006,"November","2000s",48,79,4
"9454","200611260nwe","New England Patriots",17,"Chicago Bears",13,30,4,TRUE,"11/26/2006",2006,"November","2000s",45,75,9
"9455","200611260cle","Cleveland Browns",0,"Cincinnati Bengals",30,30,-30,FALSE,"11/26/2006",2006,"November","2000s",56,48,11
"9456","200611260min","Minnesota Vikings",31,"Arizona Cardinals",26,57,5,TRUE,"11/26/2006",2006,"November","2000s",72,NA,NA
"9457","200611260nyj","New York Jets",26,"Houston Texans",11,37,15,TRUE,"11/26/2006",2006,"November","2000s",51,68,6
"9458","200611260buf","Buffalo Bills",27,"Jacksonville Jaguars",24,51,3,TRUE,"11/26/2006",2006,"November","2000s",53,52,11
"9459","200611270sea","Seattle Seahawks",34,"Green Bay Packers",24,58,10,TRUE,"11/27/2006",2006,"November","2000s",34,84,14
"9460","200611300cin","Cincinnati Bengals",13,"Baltimore Ravens",7,20,6,TRUE,"11/30/2006",2006,"November","2000s",64,75,14
"9461","200612030chi","Chicago Bears",23,"Minnesota Vikings",13,36,10,TRUE,"12/3/2006",2006,"December","2000s",14,70,12
"9462","200612030gnb","Green Bay Packers",10,"New York Jets",38,48,-28,FALSE,"12/3/2006",2006,"December","2000s",17,67,15
"9463","200612030buf","Buffalo Bills",21,"San Diego Chargers",24,45,-3,FALSE,"12/3/2006",2006,"December","2000s",32,73,13
"9464","200612030den","Denver Broncos",20,"Seattle Seahawks",23,43,-3,FALSE,"12/3/2006",2006,"December","2000s",14,68,10
"9465","200612030nor","New Orleans Saints",34,"San Francisco 49ers",10,44,24,TRUE,"12/3/2006",2006,"December","2000s",72,NA,NA
"9466","200612030pit","Pittsburgh Steelers",20,"Tampa Bay Buccaneers",3,23,17,TRUE,"12/3/2006",2006,"December","2000s",32,63,6
"9467","200612030cle","Cleveland Browns",31,"Kansas City Chiefs",28,59,3,TRUE,"12/3/2006",2006,"December","2000s",29,69,11
"9468","200612030mia","Miami Dolphins",10,"Jacksonville Jaguars",24,34,-14,FALSE,"12/3/2006",2006,"December","2000s",78,70,12
"9469","200612030rai","Oakland Raiders",14,"Houston Texans",23,37,-9,FALSE,"12/3/2006",2006,"December","2000s",51,53,8
"9470","200612030nwe","New England Patriots",28,"Detroit Lions",21,49,7,TRUE,"12/3/2006",2006,"December","2000s",40,47,13
"9471","200612030nyg","New York Giants",20,"Dallas Cowboys",23,43,-3,FALSE,"12/3/2006",2006,"December","2000s",42,45,12
"9472","200612030ram","St. Louis Rams",20,"Arizona Cardinals",34,54,-14,FALSE,"12/3/2006",2006,"December","2000s",72,NA,NA
"9473","200612030oti","Tennessee Titans",20,"Indianapolis Colts",17,37,3,TRUE,"12/3/2006",2006,"December","2000s",38,55,10
"9474","200612030was","Washington Redskins",14,"Atlanta Falcons",24,38,-10,FALSE,"12/3/2006",2006,"December","2000s",40,55,7
"9475","200612040phi","Philadelphia Eagles",27,"Carolina Panthers",24,51,3,TRUE,"12/4/2006",2006,"December","2000s",38,48,15
"9476","200612070pit","Pittsburgh Steelers",27,"Cleveland Browns",7,34,20,TRUE,"12/7/2006",2006,"December","2000s",34,64,17
"9477","200612100car","Carolina Panthers",13,"New York Giants",27,40,-14,FALSE,"12/10/2006",2006,"December","2000s",38,38,4
"9478","200612100htx","Houston Texans",20,"Tennessee Titans",26,46,-6,FALSE,"12/10/2006",2006,"December","2000s",72,NA,NA
"9479","200612100was","Washington Redskins",19,"Philadelphia Eagles",21,40,-2,FALSE,"12/10/2006",2006,"December","2000s",37,46,7
"9480","200612100cin","Cincinnati Bengals",27,"Oakland Raiders",10,37,17,TRUE,"12/10/2006",2006,"December","2000s",39,28,12
"9481","200612100kan","Kansas City Chiefs",10,"Baltimore Ravens",20,30,-10,FALSE,"12/10/2006",2006,"December","2000s",42,49,23
"9482","200612100crd","Arizona Cardinals",27,"Seattle Seahawks",21,48,6,TRUE,"12/10/2006",2006,"December","2000s",72,NA,NA
"9483","200612100mia","Miami Dolphins",21,"New England Patriots",0,21,21,TRUE,"12/10/2006",2006,"December","2000s",72,53,14
"9484","200612100dal","Dallas Cowboys",17,"New Orleans Saints",42,59,-25,FALSE,"12/10/2006",2006,"December","2000s",47,51,13
"9485","200612100det","Detroit Lions",20,"Minnesota Vikings",30,50,-10,FALSE,"12/10/2006",2006,"December","2000s",72,NA,NA
"9486","200612100tam","Tampa Bay Buccaneers",6,"Atlanta Falcons",17,23,-11,FALSE,"12/10/2006",2006,"December","2000s",63,61,10
"9487","200612100nyj","New York Jets",13,"Buffalo Bills",31,44,-18,FALSE,"12/10/2006",2006,"December","2000s",44,27,14
"9488","200612100jax","Jacksonville Jaguars",44,"Indianapolis Colts",17,61,27,TRUE,"12/10/2006",2006,"December","2000s",56,70,12
"9489","200612100sdg","San Diego Chargers",48,"Denver Broncos",20,68,28,TRUE,"12/10/2006",2006,"December","2000s",60,70,13
"9490","200612100sfo","San Francisco 49ers",19,"Green Bay Packers",30,49,-11,FALSE,"12/10/2006",2006,"December","2000s",53,83,17
"9491","200612110ram","St. Louis Rams",27,"Chicago Bears",42,69,-15,FALSE,"12/11/2006",2006,"December","2000s",72,NA,NA
"9492","200612140sea","Seattle Seahawks",14,"San Francisco 49ers",24,38,-10,FALSE,"12/14/2006",2006,"December","2000s",44,85,13
"9493","200612160atl","Atlanta Falcons",28,"Dallas Cowboys",38,66,-10,FALSE,"12/16/2006",2006,"December","2000s",72,NA,NA
"9494","200612170nyg","New York Giants",22,"Philadelphia Eagles",36,58,-14,FALSE,"12/17/2006",2006,"December","2000s",48,51,10
"9495","200612170car","Carolina Panthers",3,"Pittsburgh Steelers",37,40,-34,FALSE,"12/17/2006",2006,"December","2000s",52,65,5
"9496","200612170rai","Oakland Raiders",0,"St. Louis Rams",20,20,-20,FALSE,"12/17/2006",2006,"December","2000s",44,72,7
"9497","200612170chi","Chicago Bears",34,"Tampa Bay Buccaneers",31,65,3,TRUE,"12/17/2006",2006,"December","2000s",49,68,9
"9498","200612170nor","New Orleans Saints",10,"Washington Redskins",16,26,-6,FALSE,"12/17/2006",2006,"December","2000s",72,NA,NA
"9499","200612170min","Minnesota Vikings",13,"New York Jets",26,39,-13,FALSE,"12/17/2006",2006,"December","2000s",72,NA,NA
"9500","200612170buf","Buffalo Bills",21,"Miami Dolphins",0,21,21,TRUE,"12/17/2006",2006,"December","2000s",46,75,15
"9501","200612170sdg","San Diego Chargers",20,"Kansas City Chiefs",9,29,11,TRUE,"12/17/2006",2006,"December","2000s",54,66,9
"9502","200612170rav","Baltimore Ravens",27,"Cleveland Browns",17,44,10,TRUE,"12/17/2006",2006,"December","2000s",42,67,4
"9503","200612170crd","Arizona Cardinals",20,"Denver Broncos",37,57,-17,FALSE,"12/17/2006",2006,"December","2000s",72,NA,NA
"9504","200612170gnb","Green Bay Packers",17,"Detroit Lions",9,26,8,TRUE,"12/17/2006",2006,"December","2000s",39,72,9
"9505","200612170nwe","New England Patriots",40,"Houston Texans",7,47,33,TRUE,"12/17/2006",2006,"December","2000s",44,57,14
"9506","200612170oti","Tennessee Titans",24,"Jacksonville Jaguars",17,41,7,TRUE,"12/17/2006",2006,"December","2000s",58,56,8
"9507","200612180clt","Indianapolis Colts",34,"Cincinnati Bengals",16,50,18,TRUE,"12/18/2006",2006,"December","2000s",72,NA,NA
"9508","200612210gnb","Green Bay Packers",9,"Minnesota Vikings",7,16,2,TRUE,"12/21/2006",2006,"December","2000s",34,79,8
"9509","200612230rai","Oakland Raiders",9,"Kansas City Chiefs",20,29,-11,FALSE,"12/23/2006",2006,"December","2000s",45,78,6
"9510","200612240buf","Buffalo Bills",29,"Tennessee Titans",30,59,-1,FALSE,"12/24/2006",2006,"December","2000s",39,84,22
"9511","200612240pit","Pittsburgh Steelers",7,"Baltimore Ravens",31,38,-24,FALSE,"12/24/2006",2006,"December","2000s",40,70,11
"9512","200612240sea","Seattle Seahawks",17,"San Diego Chargers",20,37,-3,FALSE,"12/24/2006",2006,"December","2000s",42,73,13
"9513","200612240cle","Cleveland Browns",7,"Tampa Bay Buccaneers",22,29,-15,FALSE,"12/24/2006",2006,"December","2000s",39,78,14
"9514","200612240ram","St. Louis Rams",37,"Washington Redskins",31,68,6,TRUE,"12/24/2006",2006,"December","2000s",72,NA,NA
"9515","200612240jax","Jacksonville Jaguars",21,"New England Patriots",24,45,-3,FALSE,"12/24/2006",2006,"December","2000s",65,84,5
"9516","200612240nyg","New York Giants",7,"New Orleans Saints",30,37,-23,FALSE,"12/24/2006",2006,"December","2000s",51,48,20
"9517","200612240atl","Atlanta Falcons",3,"Carolina Panthers",10,13,-7,FALSE,"12/24/2006",2006,"December","2000s",72,NA,NA
"9518","200612240det","Detroit Lions",21,"Chicago Bears",26,47,-5,FALSE,"12/24/2006",2006,"December","2000s",72,NA,NA
"9519","200612240den","Denver Broncos",24,"Cincinnati Bengals",23,47,1,TRUE,"12/24/2006",2006,"December","2000s",28,64,15
"9520","200612240htx","Houston Texans",27,"Indianapolis Colts",24,51,3,TRUE,"12/24/2006",2006,"December","2000s",72,NA,NA
"9521","200612240sfo","San Francisco 49ers",20,"Arizona Cardinals",26,46,-6,FALSE,"12/24/2006",2006,"December","2000s",48,80,6
"9522","200612250dal","Dallas Cowboys",7,"Philadelphia Eagles",23,30,-16,FALSE,"12/25/2006",2006,"December","2000s",45,66,23
"9523","200612250mia","Miami Dolphins",10,"New York Jets",13,23,-3,FALSE,"12/25/2006",2006,"December","2000s",79,80,15
"9524","200612300was","Washington Redskins",28,"New York Giants",34,62,-6,FALSE,"12/30/2006",2006,"December","2000s",42,88,5
"9525","200612310oti","Tennessee Titans",23,"New England Patriots",40,63,-17,FALSE,"12/31/2006",2006,"December","2000s",61,76,14
"9526","200612310cin","Cincinnati Bengals",17,"Pittsburgh Steelers",23,40,-6,FALSE,"12/31/2006",2006,"December","2000s",52,73,14
"9527","200612310nyj","New York Jets",23,"Oakland Raiders",3,26,20,TRUE,"12/31/2006",2006,"December","2000s",41,53,12
"9528","200612310min","Minnesota Vikings",21,"St. Louis Rams",41,62,-20,FALSE,"12/31/2006",2006,"December","2000s",72,NA,NA
"9529","200612310tam","Tampa Bay Buccaneers",7,"Seattle Seahawks",23,30,-16,FALSE,"12/31/2006",2006,"December","2000s",76,74,10
"9530","200612310den","Denver Broncos",23,"San Francisco 49ers",26,49,-3,FALSE,"12/31/2006",2006,"December","2000s",21,54,7
"9531","200612310clt","Indianapolis Colts",27,"Miami Dolphins",22,49,5,TRUE,"12/31/2006",2006,"December","2000s",72,NA,NA
"9532","200612310kan","Kansas City Chiefs",35,"Jacksonville Jaguars",30,65,5,TRUE,"12/31/2006",2006,"December","2000s",46,93,15
"9533","200612310chi","Chicago Bears",7,"Green Bay Packers",26,33,-19,FALSE,"12/31/2006",2006,"December","2000s",47,84,16
"9534","200612310dal","Dallas Cowboys",31,"Detroit Lions",39,70,-8,FALSE,"12/31/2006",2006,"December","2000s",46,63,15
"9535","200612310sdg","San Diego Chargers",27,"Arizona Cardinals",20,47,7,TRUE,"12/31/2006",2006,"December","2000s",53,68,4
"9536","200612310htx","Houston Texans",14,"Cleveland Browns",6,20,8,TRUE,"12/31/2006",2006,"December","2000s",72,NA,NA
"9537","200612310nor","New Orleans Saints",21,"Carolina Panthers",31,52,-10,FALSE,"12/31/2006",2006,"December","2000s",72,NA,NA
"9538","200612310rav","Baltimore Ravens",19,"Buffalo Bills",7,26,12,TRUE,"12/31/2006",2006,"December","2000s",41,71,6
"9539","200612310phi","Philadelphia Eagles",24,"Atlanta Falcons",17,41,7,TRUE,"12/31/2006",2006,"December","2000s",41,60,10
"9540","200701060clt","Indianapolis Colts",23,"Kansas City Chiefs",8,31,15,TRUE,"1/6/2007",2007,"January","2000s",72,NA,NA
"9541","200701060sea","Seattle Seahawks",21,"Dallas Cowboys",20,41,1,TRUE,"1/6/2007",2007,"January","2000s",40,82,20
"9542","200701070phi","Philadelphia Eagles",23,"New York Giants",20,43,3,TRUE,"1/7/2007",2007,"January","2000s",52,49,11
"9543","200701070nwe","New England Patriots",37,"New York Jets",16,53,21,TRUE,"1/7/2007",2007,"January","2000s",49,46,15
"9544","200701130nor","New Orleans Saints",27,"Philadelphia Eagles",24,51,3,TRUE,"1/13/2007",2007,"January","2000s",72,NA,NA
"9545","200701130rav","Baltimore Ravens",6,"Indianapolis Colts",15,21,-9,FALSE,"1/13/2007",2007,"January","2000s",54,74,7
"9546","200701140chi","Chicago Bears",27,"Seattle Seahawks",24,51,3,TRUE,"1/14/2007",2007,"January","2000s",31,85,11
"9547","200701140sdg","San Diego Chargers",21,"New England Patriots",24,45,-3,FALSE,"1/14/2007",2007,"January","2000s",45,33,5
"9548","200701210chi","Chicago Bears",39,"New Orleans Saints",14,53,25,TRUE,"1/21/2007",2007,"January","2000s",27,78,10
"9549","200701210clt","Indianapolis Colts",38,"New England Patriots",34,72,4,TRUE,"1/21/2007",2007,"January","2000s",72,NA,NA
"9550","200702040chi","Chicago Bears",17,"Indianapolis Colts",29,46,-12,FALSE,"2/4/2007",2007,"Feburary","2000s",66,86,7
"9551","200709060clt","Indianapolis Colts",41,"New Orleans Saints",10,51,31,TRUE,"9/6/2007",2007,"September","2000s",72,NA,NA
"9552","200709090sea","Seattle Seahawks",20,"Tampa Bay Buccaneers",6,26,14,TRUE,"9/9/2007",2007,"September","2000s",64,57,14
"9553","200709090cle","Cleveland Browns",7,"Pittsburgh Steelers",34,41,-27,FALSE,"9/9/2007",2007,"September","2000s",71,83,8
"9554","200709090gnb","Green Bay Packers",16,"Philadelphia Eagles",13,29,3,TRUE,"9/9/2007",2007,"September","2000s",63,78,8
"9555","200709090jax","Jacksonville Jaguars",10,"Tennessee Titans",13,23,-3,FALSE,"9/9/2007",2007,"September","2000s",80,67,7
"9556","200709090dal","Dallas Cowboys",45,"New York Giants",35,80,10,TRUE,"9/9/2007",2007,"September","2000s",85,66,10
"9557","200709090nyj","New York Jets",14,"New England Patriots",38,52,-24,FALSE,"9/9/2007",2007,"September","2000s",79,60,11
"9558","200709090min","Minnesota Vikings",24,"Atlanta Falcons",3,27,21,TRUE,"9/9/2007",2007,"September","2000s",72,NA,NA
"9559","200709090was","Washington Redskins",16,"Miami Dolphins",13,29,3,TRUE,"9/9/2007",2007,"September","2000s",77,69,8
"9560","200709090ram","St. Louis Rams",13,"Carolina Panthers",27,40,-14,FALSE,"9/9/2007",2007,"September","2000s",72,NA,NA
"9561","200709090sdg","San Diego Chargers",14,"Chicago Bears",3,17,11,TRUE,"9/9/2007",2007,"September","2000s",69,68,9
"9562","200709090buf","Buffalo Bills",14,"Denver Broncos",15,29,-1,FALSE,"9/9/2007",2007,"September","2000s",67,80,9
"9563","200709090rai","Oakland Raiders",21,"Detroit Lions",36,57,-15,FALSE,"9/9/2007",2007,"September","2000s",62,76,12
"9564","200709090htx","Houston Texans",20,"Kansas City Chiefs",3,23,17,TRUE,"9/9/2007",2007,"September","2000s",72,NA,NA
"9565","200709100sfo","San Francisco 49ers",20,"Arizona Cardinals",17,37,3,TRUE,"9/10/2007",2007,"September","2000s",64,70,13
"9566","200709100cin","Cincinnati Bengals",27,"Baltimore Ravens",20,47,7,TRUE,"9/10/2007",2007,"September","2000s",76,71,8
"9567","200709160tam","Tampa Bay Buccaneers",31,"New Orleans Saints",14,45,17,TRUE,"9/16/2007",2007,"September","2000s",84,72,7
"9568","200709160rav","Baltimore Ravens",20,"New York Jets",13,33,7,TRUE,"9/16/2007",2007,"September","2000s",58,52,6
"9569","200709160den","Denver Broncos",23,"Oakland Raiders",20,43,3,TRUE,"9/16/2007",2007,"September","2000s",72,32,14
"9570","200709160nwe","New England Patriots",38,"San Diego Chargers",14,52,24,TRUE,"9/16/2007",2007,"September","2000s",56,60,10
"9571","200709160crd","Arizona Cardinals",23,"Seattle Seahawks",20,43,3,TRUE,"9/16/2007",2007,"September","2000s",72,NA,NA
"9572","200709160ram","St. Louis Rams",16,"San Francisco 49ers",17,33,-1,FALSE,"9/16/2007",2007,"September","2000s",72,NA,NA
"9573","200709160det","Detroit Lions",20,"Minnesota Vikings",17,37,3,TRUE,"9/16/2007",2007,"September","2000s",72,NA,NA
"9574","200709160chi","Chicago Bears",20,"Kansas City Chiefs",10,30,10,TRUE,"9/16/2007",2007,"September","2000s",56,54,9
"9575","200709160car","Carolina Panthers",21,"Houston Texans",34,55,-13,FALSE,"9/16/2007",2007,"September","2000s",66,46,8
"9576","200709160nyg","New York Giants",13,"Green Bay Packers",35,48,-22,FALSE,"9/16/2007",2007,"September","2000s",61,50,11
"9577","200709160mia","Miami Dolphins",20,"Dallas Cowboys",37,57,-17,FALSE,"9/16/2007",2007,"September","2000s",85,64,9
"9578","200709160oti","Tennessee Titans",20,"Indianapolis Colts",22,42,-2,FALSE,"9/16/2007",2007,"September","2000s",64,41,5
"9579","200709160cle","Cleveland Browns",51,"Cincinnati Bengals",45,96,6,TRUE,"9/16/2007",2007,"September","2000s",53,58,7
"9580","200709160pit","Pittsburgh Steelers",26,"Buffalo Bills",3,29,23,TRUE,"9/16/2007",2007,"September","2000s",51,64,4
"9581","200709160jax","Jacksonville Jaguars",13,"Atlanta Falcons",7,20,6,TRUE,"9/16/2007",2007,"September","2000s",83,69,12
"9582","200709170phi","Philadelphia Eagles",12,"Washington Redskins",20,32,-8,FALSE,"9/17/2007",2007,"September","2000s",61,54,8
"9583","200709230pit","Pittsburgh Steelers",37,"San Francisco 49ers",16,53,21,TRUE,"9/23/2007",2007,"September","2000s",67,59,7
"9584","200709230gnb","Green Bay Packers",31,"San Diego Chargers",24,55,7,TRUE,"9/23/2007",2007,"September","2000s",61,57,7
"9585","200709230tam","Tampa Bay Buccaneers",24,"St. Louis Rams",3,27,21,TRUE,"9/23/2007",2007,"September","2000s",79,82,8
"9586","200709230was","Washington Redskins",17,"New York Giants",24,41,-7,FALSE,"9/23/2007",2007,"September","2000s",76,54,8
"9587","200709230kan","Kansas City Chiefs",13,"Minnesota Vikings",10,23,3,TRUE,"9/23/2007",2007,"September","2000s",76,60,12
"9588","200709230nyj","New York Jets",31,"Miami Dolphins",28,59,3,TRUE,"9/23/2007",2007,"September","2000s",74,54,8
"9589","200709230den","Denver Broncos",14,"Jacksonville Jaguars",23,37,-9,FALSE,"9/23/2007",2007,"September","2000s",71,39,19
"9590","200709230phi","Philadelphia Eagles",56,"Detroit Lions",21,77,35,TRUE,"9/23/2007",2007,"September","2000s",74,54,11
"9591","200709230chi","Chicago Bears",10,"Dallas Cowboys",34,44,-24,FALSE,"9/23/2007",2007,"September","2000s",65,52,6
"9592","200709230nwe","New England Patriots",38,"Buffalo Bills",7,45,31,TRUE,"9/23/2007",2007,"September","2000s",72,51,12
"9593","200709230atl","Atlanta Falcons",20,"Carolina Panthers",27,47,-7,FALSE,"9/23/2007",2007,"September","2000s",72,NA,NA
"9594","200709230sea","Seattle Seahawks",24,"Cincinnati Bengals",21,45,3,TRUE,"9/23/2007",2007,"September","2000s",53,73,6
"9595","200709230rai","Oakland Raiders",26,"Cleveland Browns",24,50,2,TRUE,"9/23/2007",2007,"September","2000s",61,76,6
"9596","200709230htx","Houston Texans",24,"Indianapolis Colts",30,54,-6,FALSE,"9/23/2007",2007,"September","2000s",72,NA,NA
"9597","200709230rav","Baltimore Ravens",26,"Arizona Cardinals",23,49,3,TRUE,"9/23/2007",2007,"September","2000s",76,49,6
"9598","200709240nor","New Orleans Saints",14,"Tennessee Titans",31,45,-17,FALSE,"9/24/2007",2007,"September","2000s",72,NA,NA
"9599","200709300crd","Arizona Cardinals",21,"Pittsburgh Steelers",14,35,7,TRUE,"9/30/2007",2007,"September","2000s",72,NA,NA
"9600","200709300mia","Miami Dolphins",17,"Oakland Raiders",35,52,-18,FALSE,"9/30/2007",2007,"September","2000s",78,78,12
"9601","200709300dal","Dallas Cowboys",35,"St. Louis Rams",7,42,28,TRUE,"9/30/2007",2007,"September","2000s",81,59,14
"9602","200709300cle","Cleveland Browns",27,"Baltimore Ravens",13,40,14,TRUE,"9/30/2007",2007,"September","2000s",62,57,8
"9603","200709300sfo","San Francisco 49ers",3,"Seattle Seahawks",23,26,-20,FALSE,"9/30/2007",2007,"September","2000s",58,58,13
"9604","200709300car","Carolina Panthers",7,"Tampa Bay Buccaneers",20,27,-13,FALSE,"9/30/2007",2007,"September","2000s",67,39,9
"9605","200709300nyg","New York Giants",16,"Philadelphia Eagles",3,19,13,TRUE,"9/30/2007",2007,"September","2000s",67,50,7
"9606","200709300buf","Buffalo Bills",17,"New York Jets",14,31,3,TRUE,"9/30/2007",2007,"September","2000s",61,62,8
"9607","200709300clt","Indianapolis Colts",38,"Denver Broncos",20,58,18,TRUE,"9/30/2007",2007,"September","2000s",72,NA,NA
"9608","200709300sdg","San Diego Chargers",16,"Kansas City Chiefs",30,46,-14,FALSE,"9/30/2007",2007,"September","2000s",67,64,5
"9609","200709300det","Detroit Lions",37,"Chicago Bears",27,64,10,TRUE,"9/30/2007",2007,"September","2000s",72,NA,NA
"9610","200709300atl","Atlanta Falcons",26,"Houston Texans",16,42,10,TRUE,"9/30/2007",2007,"September","2000s",72,NA,NA
"9611","200709300min","Minnesota Vikings",16,"Green Bay Packers",23,39,-7,FALSE,"9/30/2007",2007,"September","2000s",72,NA,NA
"9612","200710010cin","Cincinnati Bengals",13,"New England Patriots",34,47,-21,FALSE,"10/1/2007",2007,"October","2000s",66,50,12
"9613","200710070kan","Kansas City Chiefs",7,"Jacksonville Jaguars",17,24,-10,FALSE,"10/7/2007",2007,"October","2000s",77,79,13
"9614","200710070htx","Houston Texans",22,"Miami Dolphins",19,41,3,TRUE,"10/7/2007",2007,"October","2000s",72,NA,NA
"9615","200710070nyg","New York Giants",35,"New York Jets",24,59,11,TRUE,"10/7/2007",2007,"October","2000s",77,61,10
"9616","200710070sfo","San Francisco 49ers",7,"Baltimore Ravens",9,16,-2,FALSE,"10/7/2007",2007,"October","2000s",58,54,10
"9617","200710070den","Denver Broncos",3,"San Diego Chargers",41,44,-38,FALSE,"10/7/2007",2007,"October","2000s",50,47,16
"9618","200710070pit","Pittsburgh Steelers",21,"Seattle Seahawks",0,21,21,TRUE,"10/7/2007",2007,"October","2000s",74,70,4
"9619","200710070clt","Indianapolis Colts",33,"Tampa Bay Buccaneers",14,47,19,TRUE,"10/7/2007",2007,"October","2000s",72,NA,NA
"9620","200710070was","Washington Redskins",34,"Detroit Lions",3,37,31,TRUE,"10/7/2007",2007,"October","2000s",77,66,7
"9621","200710070nor","New Orleans Saints",13,"Carolina Panthers",16,29,-3,FALSE,"10/7/2007",2007,"October","2000s",72,NA,NA
"9622","200710070oti","Tennessee Titans",20,"Atlanta Falcons",13,33,7,TRUE,"10/7/2007",2007,"October","2000s",78,58,4
"9623","200710070gnb","Green Bay Packers",20,"Chicago Bears",27,47,-7,FALSE,"10/7/2007",2007,"October","2000s",76,74,8
"9624","200710070nwe","New England Patriots",34,"Cleveland Browns",17,51,17,TRUE,"10/7/2007",2007,"October","2000s",62,78,10
"9625","200710070ram","St. Louis Rams",31,"Arizona Cardinals",34,65,-3,FALSE,"10/7/2007",2007,"October","2000s",72,NA,NA
"9626","200710080buf","Buffalo Bills",24,"Dallas Cowboys",25,49,-1,FALSE,"10/8/2007",2007,"October","2000s",72,82,12
"9627","200710140tam","Tampa Bay Buccaneers",13,"Tennessee Titans",10,23,3,TRUE,"10/14/2007",2007,"October","2000s",78,58,8
"9628","200710140sea","Seattle Seahawks",17,"New Orleans Saints",28,45,-11,FALSE,"10/14/2007",2007,"October","2000s",53,79,4
"9629","200710140kan","Kansas City Chiefs",27,"Cincinnati Bengals",20,47,7,TRUE,"10/14/2007",2007,"October","2000s",64,67,13
"9630","200710140sdg","San Diego Chargers",28,"Oakland Raiders",14,42,14,TRUE,"10/14/2007",2007,"October","2000s",63,74,8
"9631","200710140gnb","Green Bay Packers",17,"Washington Redskins",14,31,3,TRUE,"10/14/2007",2007,"October","2000s",42,86,4
"9632","200710140rav","Baltimore Ravens",22,"St. Louis Rams",3,25,19,TRUE,"10/14/2007",2007,"October","2000s",55,53,6
"9633","200710140nyj","New York Jets",9,"Philadelphia Eagles",16,25,-7,FALSE,"10/14/2007",2007,"October","2000s",58,46,16
"9634","200710140dal","Dallas Cowboys",27,"New England Patriots",48,75,-21,FALSE,"10/14/2007",2007,"October","2000s",76,55,16
"9635","200710140chi","Chicago Bears",31,"Minnesota Vikings",34,65,-3,FALSE,"10/14/2007",2007,"October","2000s",56,72,8
"9636","200710140cle","Cleveland Browns",41,"Miami Dolphins",31,72,10,TRUE,"10/14/2007",2007,"October","2000s",51,64,6
"9637","200710140crd","Arizona Cardinals",10,"Carolina Panthers",25,35,-15,FALSE,"10/14/2007",2007,"October","2000s",72,NA,NA
"9638","200710140jax","Jacksonville Jaguars",37,"Houston Texans",17,54,20,TRUE,"10/14/2007",2007,"October","2000s",72,70,11
"9639","200710150atl","Atlanta Falcons",10,"New York Giants",31,41,-21,FALSE,"10/15/2007",2007,"October","2000s",72,NA,NA
"9640","200710210det","Detroit Lions",23,"Tampa Bay Buccaneers",16,39,7,TRUE,"10/21/2007",2007,"October","2000s",72,NA,NA
"9641","200710210buf","Buffalo Bills",19,"Baltimore Ravens",14,33,5,TRUE,"10/21/2007",2007,"October","2000s",63,50,15
"9642","200710210den","Denver Broncos",31,"Pittsburgh Steelers",28,59,3,TRUE,"10/21/2007",2007,"October","2000s",42,63,21
"9643","200710210cin","Cincinnati Bengals",38,"New York Jets",31,69,7,TRUE,"10/21/2007",2007,"October","2000s",62,47,10
"9644","200710210nyg","New York Giants",33,"San Francisco 49ers",15,48,18,TRUE,"10/21/2007",2007,"October","2000s",67,40,12
"9645","200710210sea","Seattle Seahawks",33,"St. Louis Rams",6,39,27,TRUE,"10/21/2007",2007,"October","2000s",50,82,12
"9646","200710210htx","Houston Texans",36,"Tennessee Titans",38,74,-2,FALSE,"10/21/2007",2007,"October","2000s",72,NA,NA
"9647","200710210mia","Miami Dolphins",28,"New England Patriots",49,77,-21,FALSE,"10/21/2007",2007,"October","2000s",82,75,10
"9648","200710210dal","Dallas Cowboys",24,"Minnesota Vikings",14,38,10,TRUE,"10/21/2007",2007,"October","2000s",78,49,21
"9649","200710210rai","Oakland Raiders",10,"Kansas City Chiefs",12,22,-2,FALSE,"10/21/2007",2007,"October","2000s",59,50,10
"9650","200710210was","Washington Redskins",21,"Arizona Cardinals",19,40,2,TRUE,"10/21/2007",2007,"October","2000s",65,53,7
"9651","200710210nor","New Orleans Saints",22,"Atlanta Falcons",16,38,6,TRUE,"10/21/2007",2007,"October","2000s",72,NA,NA
"9652","200710210phi","Philadelphia Eagles",16,"Chicago Bears",19,35,-3,FALSE,"10/21/2007",2007,"October","2000s",63,52,8
"9653","200710220jax","Jacksonville Jaguars",7,"Indianapolis Colts",29,36,-22,FALSE,"10/22/2007",2007,"October","2000s",75,91,8
"9654","200710280cin","Cincinnati Bengals",13,"Pittsburgh Steelers",24,37,-11,FALSE,"10/28/2007",2007,"October","2000s",49,64,9
"9655","200710280oti","Tennessee Titans",13,"Oakland Raiders",9,22,4,TRUE,"10/28/2007",2007,"October","2000s",57,65,11
"9656","200710280min","Minnesota Vikings",16,"Philadelphia Eagles",23,39,-7,FALSE,"10/28/2007",2007,"October","2000s",72,NA,NA
"9657","200710280nyj","New York Jets",3,"Buffalo Bills",13,16,-10,FALSE,"10/28/2007",2007,"October","2000s",57,47,18
"9658","200710280sfo","San Francisco 49ers",10,"New Orleans Saints",31,41,-21,FALSE,"10/28/2007",2007,"October","2000s",59,74,9
"9659","200710280ram","St. Louis Rams",20,"Cleveland Browns",27,47,-7,FALSE,"10/28/2007",2007,"October","2000s",72,NA,NA
"9660","200710280car","Carolina Panthers",7,"Indianapolis Colts",31,38,-24,FALSE,"10/28/2007",2007,"October","2000s",57,63,9
"9661","200710280tam","Tampa Bay Buccaneers",23,"Jacksonville Jaguars",24,47,-1,FALSE,"10/28/2007",2007,"October","2000s",76,74,12
"9662","200710280sdg","San Diego Chargers",35,"Houston Texans",10,45,25,TRUE,"10/28/2007",2007,"October","2000s",67,61,6
"9663","200710280mia","Miami Dolphins",10,"New York Giants",13,23,-3,FALSE,"10/28/2007",2007,"October","2000s",57,91,15
"9664","200710280nwe","New England Patriots",52,"Washington Redskins",7,59,45,TRUE,"10/28/2007",2007,"October","2000s",57,52,16
"9665","200710280chi","Chicago Bears",7,"Detroit Lions",16,23,-9,FALSE,"10/28/2007",2007,"October","2000s",45,51,5
"9666","200710290den","Denver Broncos",13,"Green Bay Packers",19,32,-6,FALSE,"10/29/2007",2007,"October","2000s",55,32,10
"9667","200711040det","Detroit Lions",44,"Denver Broncos",7,51,37,TRUE,"11/4/2007",2007,"November","2000s",72,NA,NA
"9668","200711040oti","Tennessee Titans",20,"Carolina Panthers",7,27,13,TRUE,"11/4/2007",2007,"November","2000s",50,52,8
"9669","200711040atl","Atlanta Falcons",20,"San Francisco 49ers",16,36,4,TRUE,"11/4/2007",2007,"November","2000s",72,NA,NA
"9670","200711040cle","Cleveland Browns",33,"Seattle Seahawks",30,63,3,TRUE,"11/4/2007",2007,"November","2000s",41,62,7
"9671","200711040min","Minnesota Vikings",35,"San Diego Chargers",17,52,18,TRUE,"11/4/2007",2007,"November","2000s",72,NA,NA
"9672","200711040buf","Buffalo Bills",33,"Cincinnati Bengals",21,54,12,TRUE,"11/4/2007",2007,"November","2000s",45,65,10
"9673","200711040clt","Indianapolis Colts",20,"New England Patriots",24,44,-4,FALSE,"11/4/2007",2007,"November","2000s",72,NA,NA
"9674","200711040nor","New Orleans Saints",41,"Jacksonville Jaguars",24,65,17,TRUE,"11/4/2007",2007,"November","2000s",72,NA,NA
"9675","200711040tam","Tampa Bay Buccaneers",17,"Arizona Cardinals",10,27,7,TRUE,"11/4/2007",2007,"November","2000s",67,59,6
"9676","200711040kan","Kansas City Chiefs",22,"Green Bay Packers",33,55,-11,FALSE,"11/4/2007",2007,"November","2000s",50,45,10
"9677","200711040phi","Philadelphia Eagles",17,"Dallas Cowboys",38,55,-21,FALSE,"11/4/2007",2007,"November","2000s",49,47,10
"9678","200711040rai","Oakland Raiders",17,"Houston Texans",24,41,-7,FALSE,"11/4/2007",2007,"November","2000s",59,57,5
"9679","200711040nyj","New York Jets",20,"Washington Redskins",23,43,-3,FALSE,"11/4/2007",2007,"November","2000s",52,43,14
"9680","200711050pit","Pittsburgh Steelers",38,"Baltimore Ravens",7,45,31,TRUE,"11/5/2007",2007,"November","2000s",44,59,7
"9681","200711110nor","New Orleans Saints",29,"St. Louis Rams",37,66,-8,FALSE,"11/11/2007",2007,"November","2000s",72,NA,NA
"9682","200711110was","Washington Redskins",25,"Philadelphia Eagles",33,58,-8,FALSE,"11/11/2007",2007,"November","2000s",44,62,7
"9683","200711110gnb","Green Bay Packers",34,"Minnesota Vikings",0,34,34,TRUE,"11/11/2007",2007,"November","2000s",47,70,12
"9684","200711110oti","Tennessee Titans",13,"Jacksonville Jaguars",28,41,-15,FALSE,"11/11/2007",2007,"November","2000s",48,55,8
"9685","200711110crd","Arizona Cardinals",31,"Detroit Lions",21,52,10,TRUE,"11/11/2007",2007,"November","2000s",72,NA,NA
"9686","200711110kan","Kansas City Chiefs",11,"Denver Broncos",27,38,-16,FALSE,"11/11/2007",2007,"November","2000s",64,74,17
"9687","200711110nyg","New York Giants",20,"Dallas Cowboys",31,51,-11,FALSE,"11/11/2007",2007,"November","2000s",40,52,12
"9688","200711110car","Carolina Panthers",13,"Atlanta Falcons",20,33,-7,FALSE,"11/11/2007",2007,"November","2000s",44,56,5
"9689","200711110mia","Miami Dolphins",10,"Buffalo Bills",13,23,-3,FALSE,"11/11/2007",2007,"November","2000s",72,52,8
"9690","200711110rai","Oakland Raiders",6,"Chicago Bears",17,23,-11,FALSE,"11/11/2007",2007,"November","2000s",58,86,11
"9691","200711110rav","Baltimore Ravens",7,"Cincinnati Bengals",21,28,-14,FALSE,"11/11/2007",2007,"November","2000s",42,63,4
"9692","200711110pit","Pittsburgh Steelers",31,"Cleveland Browns",28,59,3,TRUE,"11/11/2007",2007,"November","2000s",36,84,5
"9693","200711110sdg","San Diego Chargers",23,"Indianapolis Colts",21,44,2,TRUE,"11/11/2007",2007,"November","2000s",59,74,5
"9694","200711120sea","Seattle Seahawks",24,"San Francisco 49ers",0,24,24,TRUE,"11/12/2007",2007,"November","2000s",48,71,20
"9695","200711180nyj","New York Jets",19,"Pittsburgh Steelers",16,35,3,TRUE,"11/18/2007",2007,"November","2000s",44,52,12
"9696","200711180min","Minnesota Vikings",29,"Oakland Raiders",22,51,7,TRUE,"11/18/2007",2007,"November","2000s",72,NA,NA
"9697","200711180sfo","San Francisco 49ers",9,"St. Louis Rams",13,22,-4,FALSE,"11/18/2007",2007,"November","2000s",54,93,9
"9698","200711180jax","Jacksonville Jaguars",24,"San Diego Chargers",17,41,7,TRUE,"11/18/2007",2007,"November","2000s",56,72,4
"9699","200711180atl","Atlanta Falcons",7,"Tampa Bay Buccaneers",31,38,-24,FALSE,"11/18/2007",2007,"November","2000s",72,NA,NA
"9700","200711180dal","Dallas Cowboys",28,"Washington Redskins",23,51,5,TRUE,"11/18/2007",2007,"November","2000s",69,70,8
"9701","200711180det","Detroit Lions",10,"New York Giants",16,26,-6,FALSE,"11/18/2007",2007,"November","2000s",72,NA,NA
"9702","200711180buf","Buffalo Bills",10,"New England Patriots",56,66,-46,FALSE,"11/18/2007",2007,"November","2000s",34,73,10
"9703","200711180htx","Houston Texans",23,"New Orleans Saints",10,33,13,TRUE,"11/18/2007",2007,"November","2000s",72,NA,NA
"9704","200711180phi","Philadelphia Eagles",17,"Miami Dolphins",7,24,10,TRUE,"11/18/2007",2007,"November","2000s",42,69,11
"9705","200711180clt","Indianapolis Colts",13,"Kansas City Chiefs",10,23,3,TRUE,"11/18/2007",2007,"November","2000s",72,NA,NA
"9706","200711180cin","Cincinnati Bengals",27,"Arizona Cardinals",35,62,-8,FALSE,"11/18/2007",2007,"November","2000s",42,75,7
"9707","200711180rav","Baltimore Ravens",30,"Cleveland Browns",33,63,-3,FALSE,"11/18/2007",2007,"November","2000s",45,71,9
"9708","200711180sea","Seattle Seahawks",30,"Chicago Bears",23,53,7,TRUE,"11/18/2007",2007,"November","2000s",45,81,12
"9709","200711180gnb","Green Bay Packers",31,"Carolina Panthers",17,48,14,TRUE,"11/18/2007",2007,"November","2000s",33,60,10
"9710","200711190den","Denver Broncos",34,"Tennessee Titans",20,54,14,TRUE,"11/19/2007",2007,"November","2000s",61,19,15
"9711","200711220det","Detroit Lions",26,"Green Bay Packers",37,63,-11,FALSE,"11/22/2007",2007,"November","2000s",72,NA,NA
"9712","200711220atl","Atlanta Falcons",13,"Indianapolis Colts",31,44,-18,FALSE,"11/22/2007",2007,"November","2000s",72,NA,NA
"9713","200711220dal","Dallas Cowboys",34,"New York Jets",3,37,31,TRUE,"11/22/2007",2007,"November","2000s",43,52,18
"9714","200711250crd","Arizona Cardinals",31,"San Francisco 49ers",37,68,-6,FALSE,"11/25/2007",2007,"November","2000s",72,NA,NA
"9715","200711250ram","St. Louis Rams",19,"Seattle Seahawks",24,43,-5,FALSE,"11/25/2007",2007,"November","2000s",72,NA,NA
"9716","200711250sdg","San Diego Chargers",32,"Baltimore Ravens",14,46,18,TRUE,"11/25/2007",2007,"November","2000s",57,42,4
"9717","200711250kan","Kansas City Chiefs",17,"Oakland Raiders",20,37,-3,FALSE,"11/25/2007",2007,"November","2000s",30,79,8
"9718","200711250nwe","New England Patriots",31,"Philadelphia Eagles",28,59,3,TRUE,"11/25/2007",2007,"November","2000s",36,38,10
"9719","200711250tam","Tampa Bay Buccaneers",19,"Washington Redskins",13,32,6,TRUE,"11/25/2007",2007,"November","2000s",74,72,6
"9720","200711250cin","Cincinnati Bengals",35,"Tennessee Titans",6,41,29,TRUE,"11/25/2007",2007,"November","2000s",33,82,4
"9721","200711250car","Carolina Panthers",6,"New Orleans Saints",31,37,-25,FALSE,"11/25/2007",2007,"November","2000s",44,46,6
"9722","200711250nyg","New York Giants",17,"Minnesota Vikings",41,58,-24,FALSE,"11/25/2007",2007,"November","2000s",41,39,10
"9723","200711250cle","Cleveland Browns",27,"Houston Texans",17,44,10,TRUE,"11/25/2007",2007,"November","2000s",32,64,8
"9724","200711250chi","Chicago Bears",37,"Denver Broncos",34,71,3,TRUE,"11/25/2007",2007,"November","2000s",32,75,11
"9725","200711250jax","Jacksonville Jaguars",36,"Buffalo Bills",14,50,22,TRUE,"11/25/2007",2007,"November","2000s",60,89,12
"9726","200711260pit","Pittsburgh Steelers",3,"Miami Dolphins",0,3,3,TRUE,"11/26/2007",2007,"November","2000s",46,88,7
"9727","200711290dal","Dallas Cowboys",37,"Green Bay Packers",27,64,10,TRUE,"11/29/2007",2007,"November","2000s",53,45,12
"9728","200712020chi","Chicago Bears",16,"New York Giants",21,37,-5,FALSE,"12/2/2007",2007,"December","2000s",37,86,16
"9729","200712020mia","Miami Dolphins",13,"New York Jets",40,53,-27,FALSE,"12/2/2007",2007,"December","2000s",77,68,8
"9730","200712020kan","Kansas City Chiefs",10,"San Diego Chargers",24,34,-14,FALSE,"12/2/2007",2007,"December","2000s",45,77,22
"9731","200712020phi","Philadelphia Eagles",24,"Seattle Seahawks",28,52,-4,FALSE,"12/2/2007",2007,"December","2000s",30,64,10
"9732","200712020car","Carolina Panthers",31,"San Francisco 49ers",14,45,17,TRUE,"12/2/2007",2007,"December","2000s",48,43,7
"9733","200712020nor","New Orleans Saints",23,"Tampa Bay Buccaneers",27,50,-4,FALSE,"12/2/2007",2007,"December","2000s",72,NA,NA
"9734","200712020clt","Indianapolis Colts",28,"Jacksonville Jaguars",25,53,3,TRUE,"12/2/2007",2007,"December","2000s",72,NA,NA
"9735","200712020oti","Tennessee Titans",28,"Houston Texans",20,48,8,TRUE,"12/2/2007",2007,"December","2000s",59,50,14
"9736","200712020ram","St. Louis Rams",28,"Atlanta Falcons",16,44,12,TRUE,"12/2/2007",2007,"December","2000s",72,NA,NA
"9737","200712020was","Washington Redskins",16,"Buffalo Bills",17,33,-1,FALSE,"12/2/2007",2007,"December","2000s",40,50,9
"9738","200712020pit","Pittsburgh Steelers",24,"Cincinnati Bengals",10,34,14,TRUE,"12/2/2007",2007,"December","2000s",37,66,9
"9739","200712020crd","Arizona Cardinals",27,"Cleveland Browns",21,48,6,TRUE,"12/2/2007",2007,"December","2000s",72,NA,NA
"9740","200712020rai","Oakland Raiders",34,"Denver Broncos",20,54,14,TRUE,"12/2/2007",2007,"December","2000s",50,65,14
"9741","200712020min","Minnesota Vikings",42,"Detroit Lions",10,52,32,TRUE,"12/2/2007",2007,"December","2000s",72,NA,NA
"9742","200712030rav","Baltimore Ravens",24,"New England Patriots",27,51,-3,FALSE,"12/3/2007",2007,"December","2000s",43,72,17
"9743","200712060was","Washington Redskins",24,"Chicago Bears",16,40,8,TRUE,"12/6/2007",2007,"December","2000s",29,63,12
"9744","200712090htx","Houston Texans",28,"Tampa Bay Buccaneers",14,42,14,TRUE,"12/9/2007",2007,"December","2000s",72,NA,NA
"9745","200712090phi","Philadelphia Eagles",13,"New York Giants",16,29,-3,FALSE,"12/9/2007",2007,"December","2000s",37,73,6
"9746","200712090nwe","New England Patriots",34,"Pittsburgh Steelers",13,47,21,TRUE,"12/9/2007",2007,"December","2000s",33,56,7
"9747","200712090gnb","Green Bay Packers",38,"Oakland Raiders",7,45,31,TRUE,"12/9/2007",2007,"December","2000s",17,62,5
"9748","200712090cin","Cincinnati Bengals",19,"St. Louis Rams",10,29,9,TRUE,"12/9/2007",2007,"December","2000s",37,99,8
"9749","200712090sfo","San Francisco 49ers",7,"Minnesota Vikings",27,34,-20,FALSE,"12/9/2007",2007,"December","2000s",51,48,12
"9750","200712090buf","Buffalo Bills",38,"Miami Dolphins",17,55,21,TRUE,"12/9/2007",2007,"December","2000s",28,73,7
"9751","200712090den","Denver Broncos",41,"Kansas City Chiefs",7,48,34,TRUE,"12/9/2007",2007,"December","2000s",11,89,6
"9752","200712090det","Detroit Lions",27,"Dallas Cowboys",28,55,-1,FALSE,"12/9/2007",2007,"December","2000s",72,NA,NA
"9753","200712090sea","Seattle Seahawks",42,"Arizona Cardinals",21,63,21,TRUE,"12/9/2007",2007,"December","2000s",33,72,4
"9754","200712090rav","Baltimore Ravens",20,"Indianapolis Colts",44,64,-24,FALSE,"12/9/2007",2007,"December","2000s",39,88,5
"9755","200712090nyj","New York Jets",18,"Cleveland Browns",24,42,-6,FALSE,"12/9/2007",2007,"December","2000s",39,53,8
"9756","200712090jax","Jacksonville Jaguars",37,"Carolina Panthers",6,43,31,TRUE,"12/9/2007",2007,"December","2000s",64,86,7
"9757","200712090oti","Tennessee Titans",17,"San Diego Chargers",23,40,-6,FALSE,"12/9/2007",2007,"December","2000s",65,89,6
"9758","200712100atl","Atlanta Falcons",14,"New Orleans Saints",34,48,-20,FALSE,"12/10/2007",2007,"December","2000s",72,NA,NA
"9759","200712130htx","Houston Texans",31,"Denver Broncos",13,44,18,TRUE,"12/13/2007",2007,"December","2000s",72,NA,NA
"9760","200712150sfo","San Francisco 49ers",20,"Cincinnati Bengals",13,33,7,TRUE,"12/15/2007",2007,"December","2000s",49,79,8
"9761","200712160nwe","New England Patriots",20,"New York Jets",10,30,10,TRUE,"12/16/2007",2007,"December","2000s",30,79,24
"9762","200712160kan","Kansas City Chiefs",17,"Tennessee Titans",26,43,-9,FALSE,"12/16/2007",2007,"December","2000s",17,80,9
"9763","200712160dal","Dallas Cowboys",6,"Philadelphia Eagles",10,16,-4,FALSE,"12/16/2007",2007,"December","2000s",38,54,13
"9764","200712160mia","Miami Dolphins",22,"Baltimore Ravens",16,38,6,TRUE,"12/16/2007",2007,"December","2000s",78,74,12
"9765","200712160car","Carolina Panthers",13,"Seattle Seahawks",10,23,3,TRUE,"12/16/2007",2007,"December","2000s",40,76,11
"9766","200712160nyg","New York Giants",10,"Washington Redskins",22,32,-12,FALSE,"12/16/2007",2007,"December","2000s",34,77,23
"9767","200712160pit","Pittsburgh Steelers",22,"Jacksonville Jaguars",29,51,-7,FALSE,"12/16/2007",2007,"December","2000s",33,84,16
"9768","200712160ram","St. Louis Rams",14,"Green Bay Packers",33,47,-19,FALSE,"12/16/2007",2007,"December","2000s",72,NA,NA
"9769","200712160tam","Tampa Bay Buccaneers",37,"Atlanta Falcons",3,40,34,TRUE,"12/16/2007",2007,"December","2000s",71,74,17
"9770","200712160cle","Cleveland Browns",8,"Buffalo Bills",0,8,8,TRUE,"12/16/2007",2007,"December","2000s",31,82,19
"9771","200712160rai","Oakland Raiders",14,"Indianapolis Colts",21,35,-7,FALSE,"12/16/2007",2007,"December","2000s",48,82,6
"9772","200712160nor","New Orleans Saints",31,"Arizona Cardinals",24,55,7,TRUE,"12/16/2007",2007,"December","2000s",72,NA,NA
"9773","200712160sdg","San Diego Chargers",51,"Detroit Lions",14,65,37,TRUE,"12/16/2007",2007,"December","2000s",54,56,5
"9774","200712170min","Minnesota Vikings",20,"Chicago Bears",13,33,7,TRUE,"12/17/2007",2007,"December","2000s",72,NA,NA
"9775","200712200ram","St. Louis Rams",24,"Pittsburgh Steelers",41,65,-17,FALSE,"12/20/2007",2007,"December","2000s",72,NA,NA
"9776","200712220car","Carolina Panthers",13,"Dallas Cowboys",20,33,-7,FALSE,"12/22/2007",2007,"December","2000s",45,70,12
"9777","200712230nor","New Orleans Saints",23,"Philadelphia Eagles",38,61,-15,FALSE,"12/23/2007",2007,"December","2000s",72,NA,NA
"9778","200712230jax","Jacksonville Jaguars",49,"Oakland Raiders",11,60,38,TRUE,"12/23/2007",2007,"December","2000s",59,89,9
"9779","200712230sea","Seattle Seahawks",27,"Baltimore Ravens",6,33,21,TRUE,"12/23/2007",2007,"December","2000s",42,88,12
"9780","200712230sfo","San Francisco 49ers",21,"Tampa Bay Buccaneers",19,40,2,TRUE,"12/23/2007",2007,"December","2000s",47,66,4
"9781","200712230min","Minnesota Vikings",21,"Washington Redskins",32,53,-11,FALSE,"12/23/2007",2007,"December","2000s",72,NA,NA
"9782","200712230oti","Tennessee Titans",10,"New York Jets",6,16,4,TRUE,"12/23/2007",2007,"December","2000s",46,64,18
"9783","200712230buf","Buffalo Bills",21,"New York Giants",38,59,-17,FALSE,"12/23/2007",2007,"December","2000s",44,78,22
"9784","200712230nwe","New England Patriots",28,"Miami Dolphins",7,35,21,TRUE,"12/23/2007",2007,"December","2000s",39,82,6
"9785","200712230crd","Arizona Cardinals",30,"Atlanta Falcons",27,57,3,TRUE,"12/23/2007",2007,"December","2000s",72,NA,NA
"9786","200712230cin","Cincinnati Bengals",19,"Cleveland Browns",14,33,5,TRUE,"12/23/2007",2007,"December","2000s",45,72,20
"9787","200712230chi","Chicago Bears",35,"Green Bay Packers",7,42,28,TRUE,"12/23/2007",2007,"December","2000s",31,80,26
"9788","200712230clt","Indianapolis Colts",38,"Houston Texans",15,53,23,TRUE,"12/23/2007",2007,"December","2000s",72,NA,NA
"9789","200712230det","Detroit Lions",25,"Kansas City Chiefs",20,45,5,TRUE,"12/23/2007",2007,"December","2000s",72,NA,NA
"9790","200712240sdg","San Diego Chargers",23,"Denver Broncos",3,26,20,TRUE,"12/24/2007",2007,"December","2000s",57,47,4
"9791","200712290nyg","New York Giants",35,"New England Patriots",38,73,-3,FALSE,"12/29/2007",2007,"December","2000s",49,67,12
"9792","200712300clt","Indianapolis Colts",10,"Tennessee Titans",16,26,-6,FALSE,"12/30/2007",2007,"December","2000s",72,NA,NA
"9793","200712300rav","Baltimore Ravens",27,"Pittsburgh Steelers",21,48,6,TRUE,"12/30/2007",2007,"December","2000s",37,83,5
"9794","200712300crd","Arizona Cardinals",48,"St. Louis Rams",19,67,29,TRUE,"12/30/2007",2007,"December","2000s",72,NA,NA
"9795","200712300rai","Oakland Raiders",17,"San Diego Chargers",30,47,-13,FALSE,"12/30/2007",2007,"December","2000s",49,85,7
"9796","200712300atl","Atlanta Falcons",44,"Seattle Seahawks",41,85,3,TRUE,"12/30/2007",2007,"December","2000s",72,NA,NA
"9797","200712300cle","Cleveland Browns",20,"San Francisco 49ers",7,27,13,TRUE,"12/30/2007",2007,"December","2000s",30,67,6
"9798","200712300chi","Chicago Bears",33,"New Orleans Saints",25,58,8,TRUE,"12/30/2007",2007,"December","2000s",26,81,9
"9799","200712300den","Denver Broncos",22,"Minnesota Vikings",19,41,3,TRUE,"12/30/2007",2007,"December","2000s",24,48,14
"9800","200712300phi","Philadelphia Eagles",17,"Buffalo Bills",9,26,8,TRUE,"12/30/2007",2007,"December","2000s",39,70,7
"9801","200712300tam","Tampa Bay Buccaneers",23,"Carolina Panthers",31,54,-8,FALSE,"12/30/2007",2007,"December","2000s",72,85,8
"9802","200712300mia","Miami Dolphins",25,"Cincinnati Bengals",38,63,-13,FALSE,"12/30/2007",2007,"December","2000s",77,70,11
"9803","200712300was","Washington Redskins",27,"Dallas Cowboys",6,33,21,TRUE,"12/30/2007",2007,"December","2000s",43,70,6
"9804","200712300gnb","Green Bay Packers",34,"Detroit Lions",13,47,21,TRUE,"12/30/2007",2007,"December","2000s",22,80,5
"9805","200712300htx","Houston Texans",42,"Jacksonville Jaguars",28,70,14,TRUE,"12/30/2007",2007,"December","2000s",72,NA,NA
"9806","200712300nyj","New York Jets",13,"Kansas City Chiefs",10,23,3,TRUE,"12/30/2007",2007,"December","2000s",42,55,10
"9807","200801050pit","Pittsburgh Steelers",29,"Jacksonville Jaguars",31,60,-2,FALSE,"1/5/2008",2008,"January","2000s",33,49,8
"9808","200801050sea","Seattle Seahawks",35,"Washington Redskins",14,49,21,TRUE,"1/5/2008",2008,"January","2000s",44,72,21
"9809","200801060sdg","San Diego Chargers",17,"Tennessee Titans",6,23,11,TRUE,"1/6/2008",2008,"January","2000s",55,91,8
"9810","200801060tam","Tampa Bay Buccaneers",14,"New York Giants",24,38,-10,FALSE,"1/6/2008",2008,"January","2000s",64,75,7
"9811","200801120gnb","Green Bay Packers",42,"Seattle Seahawks",20,62,22,TRUE,"1/12/2008",2008,"January","2000s",29,79,7
"9812","200801120nwe","New England Patriots",31,"Jacksonville Jaguars",20,51,11,TRUE,"1/12/2008",2008,"January","2000s",44,69,10
"9813","200801130dal","Dallas Cowboys",17,"New York Giants",21,38,-4,FALSE,"1/13/2008",2008,"January","2000s",46,53,9
"9814","200801130clt","Indianapolis Colts",24,"San Diego Chargers",28,52,-4,FALSE,"1/13/2008",2008,"January","2000s",72,NA,NA
"9815","200801200gnb","Green Bay Packers",20,"New York Giants",23,43,-3,FALSE,"1/20/2008",2008,"January","2000s",-7,56,13
"9816","200801200nwe","New England Patriots",21,"San Diego Chargers",12,33,9,TRUE,"1/20/2008",2008,"January","2000s",29,41,15
"9817","200802030nwe","New England Patriots",14,"New York Giants",17,31,-3,FALSE,"2/3/2008",2008,"Feburary","2000s",72,NA,NA
"9818","200809040nyg","New York Giants",16,"Washington Redskins",7,23,9,TRUE,"9/4/2008",2008,"September","2000s",79,61,10
"9819","200809070phi","Philadelphia Eagles",38,"St. Louis Rams",3,41,35,TRUE,"9/7/2008",2008,"September","2000s",73,61,15
"9820","200809070pit","Pittsburgh Steelers",38,"Houston Texans",17,55,21,TRUE,"9/7/2008",2008,"September","2000s",63,70,8
"9821","200809070sfo","San Francisco 49ers",13,"Arizona Cardinals",23,36,-10,FALSE,"9/7/2008",2008,"September","2000s",66,67,16
"9822","200809070rav","Baltimore Ravens",17,"Cincinnati Bengals",10,27,7,TRUE,"9/7/2008",2008,"September","2000s",73,60,8
"9823","200809070sdg","San Diego Chargers",24,"Carolina Panthers",26,50,-2,FALSE,"9/7/2008",2008,"September","2000s",71,75,7
"9824","200809070clt","Indianapolis Colts",13,"Chicago Bears",29,42,-16,FALSE,"9/7/2008",2008,"September","2000s",72,NA,NA
"9825","200809070nor","New Orleans Saints",24,"Tampa Bay Buccaneers",20,44,4,TRUE,"9/7/2008",2008,"September","2000s",72,NA,NA
"9826","200809070buf","Buffalo Bills",34,"Seattle Seahawks",10,44,24,TRUE,"9/7/2008",2008,"September","2000s",60,82,8
"9827","200809070cle","Cleveland Browns",10,"Dallas Cowboys",28,38,-18,FALSE,"9/7/2008",2008,"September","2000s",64,76,7
"9828","200809070atl","Atlanta Falcons",34,"Detroit Lions",21,55,13,TRUE,"9/7/2008",2008,"September","2000s",72,NA,NA
"9829","200809070oti","Tennessee Titans",17,"Jacksonville Jaguars",10,27,7,TRUE,"9/7/2008",2008,"September","2000s",72,70,3
"9830","200809070nwe","New England Patriots",17,"Kansas City Chiefs",10,27,7,TRUE,"9/7/2008",2008,"September","2000s",74,72,16
"9831","200809070mia","Miami Dolphins",14,"New York Jets",20,34,-6,FALSE,"9/7/2008",2008,"September","2000s",84,70,9
"9832","200809080rai","Oakland Raiders",14,"Denver Broncos",41,55,-27,FALSE,"9/8/2008",2008,"September","2000s",60,79,12
"9833","200809080gnb","Green Bay Packers",24,"Minnesota Vikings",19,43,5,TRUE,"9/8/2008",2008,"September","2000s",53,83,5
"9834","200809140kan","Kansas City Chiefs",8,"Oakland Raiders",23,31,-15,FALSE,"9/14/2008",2008,"September","2000s",64,77,14
"9835","200809140den","Denver Broncos",39,"San Diego Chargers",38,77,1,TRUE,"9/14/2008",2008,"September","2000s",54,64,11
"9836","200809140tam","Tampa Bay Buccaneers",24,"Atlanta Falcons",9,33,15,TRUE,"9/14/2008",2008,"September","2000s",83,73,8
"9837","200809140was","Washington Redskins",29,"New Orleans Saints",24,53,5,TRUE,"9/14/2008",2008,"September","2000s",82,71,11
"9838","200809140ram","St. Louis Rams",13,"New York Giants",41,54,-28,FALSE,"9/14/2008",2008,"September","2000s",72,NA,NA
"9839","200809140sea","Seattle Seahawks",30,"San Francisco 49ers",33,63,-3,FALSE,"9/14/2008",2008,"September","2000s",64,59,10
"9840","200809140cle","Cleveland Browns",6,"Pittsburgh Steelers",10,16,-4,FALSE,"9/14/2008",2008,"September","2000s",78,76,20
"9841","200809140cin","Cincinnati Bengals",7,"Tennessee Titans",24,31,-17,FALSE,"9/14/2008",2008,"September","2000s",79,68,24
"9842","200809140jax","Jacksonville Jaguars",16,"Buffalo Bills",20,36,-4,FALSE,"9/14/2008",2008,"September","2000s",84,71,9
"9843","200809140nyj","New York Jets",10,"New England Patriots",19,29,-9,FALSE,"9/14/2008",2008,"September","2000s",77,75,11
"9844","200809140crd","Arizona Cardinals",31,"Miami Dolphins",10,41,21,TRUE,"9/14/2008",2008,"September","2000s",72,NA,NA
"9845","200809140det","Detroit Lions",25,"Green Bay Packers",48,73,-23,FALSE,"9/14/2008",2008,"September","2000s",72,NA,NA
"9846","200809140min","Minnesota Vikings",15,"Indianapolis Colts",18,33,-3,FALSE,"9/14/2008",2008,"September","2000s",72,NA,NA
"9847","200809140car","Carolina Panthers",20,"Chicago Bears",17,37,3,TRUE,"9/14/2008",2008,"September","2000s",78,77,10
"9848","200809150dal","Dallas Cowboys",41,"Philadelphia Eagles",37,78,4,TRUE,"9/15/2008",2008,"September","2000s",72,46,9
"9849","200809210oti","Tennessee Titans",31,"Houston Texans",12,43,19,TRUE,"9/21/2008",2008,"September","2000s",72,66,3
"9850","200809210sea","Seattle Seahawks",37,"St. Louis Rams",13,50,24,TRUE,"9/21/2008",2008,"September","2000s",55,87,6
"9851","200809210phi","Philadelphia Eagles",15,"Pittsburgh Steelers",6,21,9,TRUE,"9/21/2008",2008,"September","2000s",66,65,5
"9852","200809210sfo","San Francisco 49ers",31,"Detroit Lions",13,44,18,TRUE,"9/21/2008",2008,"September","2000s",62,77,16
"9853","200809210was","Washington Redskins",24,"Arizona Cardinals",17,41,7,TRUE,"9/21/2008",2008,"September","2000s",68,60,4
"9854","200809210rav","Baltimore Ravens",28,"Cleveland Browns",10,38,18,TRUE,"9/21/2008",2008,"September","2000s",63,67,2
"9855","200809210chi","Chicago Bears",24,"Tampa Bay Buccaneers",27,51,-3,FALSE,"9/21/2008",2008,"September","2000s",68,72,6
"9856","200809210buf","Buffalo Bills",24,"Oakland Raiders",23,47,1,TRUE,"9/21/2008",2008,"September","2000s",60,84,8
"9857","200809210den","Denver Broncos",34,"New Orleans Saints",32,66,2,TRUE,"9/21/2008",2008,"September","2000s",63,54,16
"9858","200809210nwe","New England Patriots",13,"Miami Dolphins",38,51,-25,FALSE,"9/21/2008",2008,"September","2000s",61,68,7
"9859","200809210min","Minnesota Vikings",20,"Carolina Panthers",10,30,10,TRUE,"9/21/2008",2008,"September","2000s",72,NA,NA
"9860","200809210nyg","New York Giants",26,"Cincinnati Bengals",23,49,3,TRUE,"9/21/2008",2008,"September","2000s",67,56,6
"9861","200809210gnb","Green Bay Packers",16,"Dallas Cowboys",27,43,-11,FALSE,"9/21/2008",2008,"September","2000s",59,75,9
"9862","200809210clt","Indianapolis Colts",21,"Jacksonville Jaguars",23,44,-2,FALSE,"9/21/2008",2008,"September","2000s",72,NA,NA
"9863","200809210atl","Atlanta Falcons",38,"Kansas City Chiefs",14,52,24,TRUE,"9/21/2008",2008,"September","2000s",72,NA,NA
"9864","200809220sdg","San Diego Chargers",48,"New York Jets",29,77,19,TRUE,"9/22/2008",2008,"September","2000s",67,65,6
"9865","200809280jax","Jacksonville Jaguars",30,"Houston Texans",27,57,3,TRUE,"9/28/2008",2008,"September","2000s",76,57,5
"9866","200809280nor","New Orleans Saints",31,"San Francisco 49ers",17,48,14,TRUE,"9/28/2008",2008,"September","2000s",72,NA,NA
"9867","200809280dal","Dallas Cowboys",24,"Washington Redskins",26,50,-2,FALSE,"9/28/2008",2008,"September","2000s",79,44,4
"9868","200809280ram","St. Louis Rams",14,"Buffalo Bills",31,45,-17,FALSE,"9/28/2008",2008,"September","2000s",72,NA,NA
"9869","200809280tam","Tampa Bay Buccaneers",30,"Green Bay Packers",21,51,9,TRUE,"9/28/2008",2008,"September","2000s",77,68,6
"9870","200809280rai","Oakland Raiders",18,"San Diego Chargers",28,46,-10,FALSE,"9/28/2008",2008,"September","2000s",61,78,10
"9871","200809280chi","Chicago Bears",24,"Philadelphia Eagles",20,44,4,TRUE,"9/28/2008",2008,"September","2000s",65,74,10
"9872","200809280oti","Tennessee Titans",30,"Minnesota Vikings",17,47,13,TRUE,"9/28/2008",2008,"September","2000s",74,50,8
"9873","200809280car","Carolina Panthers",24,"Atlanta Falcons",9,33,15,TRUE,"9/28/2008",2008,"September","2000s",70,77,4
"9874","200809280kan","Kansas City Chiefs",33,"Denver Broncos",19,52,14,TRUE,"9/28/2008",2008,"September","2000s",72,70,5
"9875","200809280nyj","New York Jets",56,"Arizona Cardinals",35,91,21,TRUE,"9/28/2008",2008,"September","2000s",69,89,6
"9876","200809280cin","Cincinnati Bengals",12,"Cleveland Browns",20,32,-8,FALSE,"9/28/2008",2008,"September","2000s",68,65,8
"9877","200809290pit","Pittsburgh Steelers",23,"Baltimore Ravens",20,43,3,TRUE,"9/29/2008",2008,"September","2000s",63,77,6
"9878","200810050sfo","San Francisco 49ers",21,"New England Patriots",30,51,-9,FALSE,"10/5/2008",2008,"October","2000s",62,72,14
"9879","200810050htx","Houston Texans",27,"Indianapolis Colts",31,58,-4,FALSE,"10/5/2008",2008,"October","2000s",72,NA,NA
"9880","200810050nyg","New York Giants",44,"Seattle Seahawks",6,50,38,TRUE,"10/5/2008",2008,"October","2000s",59,69,9
"9881","200810050mia","Miami Dolphins",17,"San Diego Chargers",10,27,7,TRUE,"10/5/2008",2008,"October","2000s",80,84,11
"9882","200810050jax","Jacksonville Jaguars",21,"Pittsburgh Steelers",26,47,-5,FALSE,"10/5/2008",2008,"October","2000s",76,64,11
"9883","200810050rav","Baltimore Ravens",10,"Tennessee Titans",13,23,-3,FALSE,"10/5/2008",2008,"October","2000s",60,72,5
"9884","200810050car","Carolina Panthers",34,"Kansas City Chiefs",0,34,34,TRUE,"10/5/2008",2008,"October","2000s",66,67,3
"9885","200810050phi","Philadelphia Eagles",17,"Washington Redskins",23,40,-6,FALSE,"10/5/2008",2008,"October","2000s",62,65,6
"9886","200810050dal","Dallas Cowboys",31,"Cincinnati Bengals",22,53,9,TRUE,"10/5/2008",2008,"October","2000s",78,46,16
"9887","200810050det","Detroit Lions",7,"Chicago Bears",34,41,-27,FALSE,"10/5/2008",2008,"October","2000s",72,NA,NA
"9888","200810050crd","Arizona Cardinals",41,"Buffalo Bills",17,58,24,TRUE,"10/5/2008",2008,"October","2000s",72,NA,NA
"9889","200810050gnb","Green Bay Packers",24,"Atlanta Falcons",27,51,-3,FALSE,"10/5/2008",2008,"October","2000s",47,74,7
"9890","200810050den","Denver Broncos",16,"Tampa Bay Buccaneers",13,29,3,TRUE,"10/5/2008",2008,"October","2000s",61,44,14
"9891","200810060nor","New Orleans Saints",27,"Minnesota Vikings",30,57,-3,FALSE,"10/6/2008",2008,"October","2000s",72,NA,NA
"9892","200810120was","Washington Redskins",17,"St. Louis Rams",19,36,-2,FALSE,"10/12/2008",2008,"October","2000s",65,59,3
"9893","200810120sdg","San Diego Chargers",30,"New England Patriots",10,40,20,TRUE,"10/12/2008",2008,"October","2000s",61,38,8
"9894","200810120clt","Indianapolis Colts",31,"Baltimore Ravens",3,34,28,TRUE,"10/12/2008",2008,"October","2000s",72,NA,NA
"9895","200810120htx","Houston Texans",29,"Miami Dolphins",28,57,1,TRUE,"10/12/2008",2008,"October","2000s",72,NA,NA
"9896","200810120min","Minnesota Vikings",12,"Detroit Lions",10,22,2,TRUE,"10/12/2008",2008,"October","2000s",72,NA,NA
"9897","200810120sea","Seattle Seahawks",17,"Green Bay Packers",27,44,-10,FALSE,"10/12/2008",2008,"October","2000s",50,61,4
"9898","200810120nor","New Orleans Saints",34,"Oakland Raiders",3,37,31,TRUE,"10/12/2008",2008,"October","2000s",72,NA,NA
"9899","200810120den","Denver Broncos",17,"Jacksonville Jaguars",24,41,-7,FALSE,"10/12/2008",2008,"October","2000s",40,90,11
"9900","200810120sfo","San Francisco 49ers",26,"Philadelphia Eagles",40,66,-14,FALSE,"10/12/2008",2008,"October","2000s",61,32,16
"9901","200810120crd","Arizona Cardinals",30,"Dallas Cowboys",24,54,6,TRUE,"10/12/2008",2008,"October","2000s",72,NA,NA
"9902","200810120nyj","New York Jets",26,"Cincinnati Bengals",14,40,12,TRUE,"10/12/2008",2008,"October","2000s",63,60,7
"9903","200810120atl","Atlanta Falcons",22,"Chicago Bears",20,42,2,TRUE,"10/12/2008",2008,"October","2000s",72,NA,NA
"9904","200810120tam","Tampa Bay Buccaneers",27,"Carolina Panthers",3,30,24,TRUE,"10/12/2008",2008,"October","2000s",80,74,9
"9905","200810130cle","Cleveland Browns",35,"New York Giants",14,49,21,TRUE,"10/13/2008",2008,"October","2000s",66,52,7
"9906","200810190tam","Tampa Bay Buccaneers",20,"Seattle Seahawks",10,30,10,TRUE,"10/19/2008",2008,"October","2000s",70,60,12
"9907","200810190rai","Oakland Raiders",16,"New York Jets",13,29,3,TRUE,"10/19/2008",2008,"October","2000s",54,80,10
"9908","200810190was","Washington Redskins",14,"Cleveland Browns",11,25,3,TRUE,"10/19/2008",2008,"October","2000s",51,43,14
"9909","200810190nyg","New York Giants",29,"San Francisco 49ers",17,46,12,TRUE,"10/19/2008",2008,"October","2000s",50,45,17
"9910","200810190gnb","Green Bay Packers",34,"Indianapolis Colts",14,48,20,TRUE,"10/19/2008",2008,"October","2000s",50,68,14
"9911","200810190htx","Houston Texans",28,"Detroit Lions",21,49,7,TRUE,"10/19/2008",2008,"October","2000s",72,NA,NA
"9912","200810190kan","Kansas City Chiefs",10,"Tennessee Titans",34,44,-24,FALSE,"10/19/2008",2008,"October","2000s",57,66,15
"9913","200810190mia","Miami Dolphins",13,"Baltimore Ravens",27,40,-14,FALSE,"10/19/2008",2008,"October","2000s",77,73,10
"9914","200810190buf","Buffalo Bills",23,"San Diego Chargers",14,37,9,TRUE,"10/19/2008",2008,"October","2000s",43,60,4
"9915","200810190ram","St. Louis Rams",34,"Dallas Cowboys",14,48,20,TRUE,"10/19/2008",2008,"October","2000s",72,NA,NA
"9916","200810190cin","Cincinnati Bengals",10,"Pittsburgh Steelers",38,48,-28,FALSE,"10/19/2008",2008,"October","2000s",50,51,6
"9917","200810190car","Carolina Panthers",30,"New Orleans Saints",7,37,23,TRUE,"10/19/2008",2008,"October","2000s",51,59,11
"9918","200810190chi","Chicago Bears",48,"Minnesota Vikings",41,89,7,TRUE,"10/19/2008",2008,"October","2000s",50,62,14
"9919","200810200nwe","New England Patriots",41,"Denver Broncos",7,48,34,TRUE,"10/20/2008",2008,"October","2000s",45,49,10
"9920","200810260nyj","New York Jets",28,"Kansas City Chiefs",24,52,4,TRUE,"10/26/2008",2008,"October","2000s",58,63,17
"9921","200810260sfo","San Francisco 49ers",13,"Seattle Seahawks",34,47,-21,FALSE,"10/26/2008",2008,"October","2000s",61,65,11
"9922","200810260rav","Baltimore Ravens",29,"Oakland Raiders",10,39,19,TRUE,"10/26/2008",2008,"October","2000s",52,72,7
"9923","200810260pit","Pittsburgh Steelers",14,"New York Giants",21,35,-7,FALSE,"10/26/2008",2008,"October","2000s",48,64,13
"9924","200810260mia","Miami Dolphins",25,"Buffalo Bills",16,41,9,TRUE,"10/26/2008",2008,"October","2000s",78,84,6
"9925","200810260phi","Philadelphia Eagles",27,"Atlanta Falcons",14,41,13,TRUE,"10/26/2008",2008,"October","2000s",54,70,10
"9926","200810260nwe","New England Patriots",23,"St. Louis Rams",16,39,7,TRUE,"10/26/2008",2008,"October","2000s",61,69,19
"9927","200810260jax","Jacksonville Jaguars",17,"Cleveland Browns",23,40,-6,FALSE,"10/26/2008",2008,"October","2000s",65,56,8
"9928","200810260det","Detroit Lions",17,"Washington Redskins",25,42,-8,FALSE,"10/26/2008",2008,"October","2000s",72,NA,NA
"9929","200810260dal","Dallas Cowboys",13,"Tampa Bay Buccaneers",9,22,4,TRUE,"10/26/2008",2008,"October","2000s",69,51,10
"9930","200810260nor","New Orleans Saints",37,"San Diego Chargers",32,69,5,TRUE,"10/26/2008",2008,"October","2000s",55,89,14
"9931","200810260car","Carolina Panthers",27,"Arizona Cardinals",23,50,4,TRUE,"10/26/2008",2008,"October","2000s",54,71,4
"9932","200810260htx","Houston Texans",35,"Cincinnati Bengals",6,41,29,TRUE,"10/26/2008",2008,"October","2000s",72,NA,NA
"9933","200810270oti","Tennessee Titans",31,"Indianapolis Colts",21,52,10,TRUE,"10/27/2008",2008,"October","2000s",50,38,13
"9934","200811020sea","Seattle Seahawks",7,"Philadelphia Eagles",26,33,-19,FALSE,"11/2/2008",2008,"November","2000s",54,82,12
"9935","200811020ram","St. Louis Rams",13,"Arizona Cardinals",34,47,-21,FALSE,"11/2/2008",2008,"November","2000s",72,NA,NA
"9936","200811020rai","Oakland Raiders",0,"Atlanta Falcons",24,24,-24,FALSE,"11/2/2008",2008,"November","2000s",61,85,13
"9937","200811020kan","Kansas City Chiefs",27,"Tampa Bay Buccaneers",30,57,-3,FALSE,"11/2/2008",2008,"November","2000s",58,78,10
"9938","200811020cle","Cleveland Browns",27,"Baltimore Ravens",37,64,-10,FALSE,"11/2/2008",2008,"November","2000s",46,79,5
"9939","200811020buf","Buffalo Bills",17,"New York Jets",26,43,-9,FALSE,"11/2/2008",2008,"November","2000s",38,69,8
"9940","200811020clt","Indianapolis Colts",18,"New England Patriots",15,33,3,TRUE,"11/2/2008",2008,"November","2000s",72,NA,NA
"9941","200811020den","Denver Broncos",17,"Miami Dolphins",26,43,-9,FALSE,"11/2/2008",2008,"November","2000s",59,29,13
"9942","200811020min","Minnesota Vikings",28,"Houston Texans",21,49,7,TRUE,"11/2/2008",2008,"November","2000s",72,NA,NA
"9943","200811020oti","Tennessee Titans",19,"Green Bay Packers",16,35,3,TRUE,"11/2/2008",2008,"November","2000s",55,60,2
"9944","200811020chi","Chicago Bears",27,"Detroit Lions",23,50,4,TRUE,"11/2/2008",2008,"November","2000s",54,74,10
"9945","200811020cin","Cincinnati Bengals",21,"Jacksonville Jaguars",19,40,2,TRUE,"11/2/2008",2008,"November","2000s",59,68,4
"9946","200811020nyg","New York Giants",35,"Dallas Cowboys",14,49,21,TRUE,"11/2/2008",2008,"November","2000s",47,49,12
"9947","200811030was","Washington Redskins",6,"Pittsburgh Steelers",23,29,-17,FALSE,"11/3/2008",2008,"November","2000s",52,74,6
"9948","200811060cle","Cleveland Browns",30,"Denver Broncos",34,64,-4,FALSE,"11/6/2008",2008,"November","2000s",56,66,6
"9949","200811090phi","Philadelphia Eagles",31,"New York Giants",36,67,-5,FALSE,"11/9/2008",2008,"November","2000s",52,63,12
"9950","200811090sdg","San Diego Chargers",20,"Kansas City Chiefs",19,39,1,TRUE,"11/9/2008",2008,"November","2000s",64,72,16
"9951","200811090pit","Pittsburgh Steelers",20,"Indianapolis Colts",24,44,-4,FALSE,"11/9/2008",2008,"November","2000s",41,66,10
"9952","200811090rai","Oakland Raiders",6,"Carolina Panthers",17,23,-11,FALSE,"11/9/2008",2008,"November","2000s",56,75,17
"9953","200811090mia","Miami Dolphins",21,"Seattle Seahawks",19,40,2,TRUE,"11/9/2008",2008,"November","2000s",75,70,8
"9954","200811090htx","Houston Texans",13,"Baltimore Ravens",41,54,-28,FALSE,"11/9/2008",2008,"November","2000s",72,NA,NA
"9955","200811090nyj","New York Jets",47,"St. Louis Rams",3,50,44,TRUE,"11/9/2008",2008,"November","2000s",55,54,14
"9956","200811090nwe","New England Patriots",20,"Buffalo Bills",10,30,10,TRUE,"11/9/2008",2008,"November","2000s",56,69,12
"9957","200811090min","Minnesota Vikings",28,"Green Bay Packers",27,55,1,TRUE,"11/9/2008",2008,"November","2000s",72,NA,NA
"9958","200811090det","Detroit Lions",14,"Jacksonville Jaguars",38,52,-24,FALSE,"11/9/2008",2008,"November","2000s",72,NA,NA
"9959","200811090atl","Atlanta Falcons",34,"New Orleans Saints",20,54,14,TRUE,"11/9/2008",2008,"November","2000s",72,NA,NA
"9960","200811090chi","Chicago Bears",14,"Tennessee Titans",21,35,-7,FALSE,"11/9/2008",2008,"November","2000s",36,74,14
"9961","200811100crd","Arizona Cardinals",29,"San Francisco 49ers",24,53,5,TRUE,"11/10/2008",2008,"November","2000s",72,NA,NA
"9962","200811130nwe","New England Patriots",31,"New York Jets",34,65,-3,FALSE,"11/13/2008",2008,"November","2000s",43,61,8
"9963","200811160nyg","New York Giants",30,"Baltimore Ravens",10,40,20,TRUE,"11/16/2008",2008,"November","2000s",53,60,19
"9964","200811160sea","Seattle Seahawks",20,"Arizona Cardinals",26,46,-6,FALSE,"11/16/2008",2008,"November","2000s",48,87,2
"9965","200811160was","Washington Redskins",10,"Dallas Cowboys",14,24,-4,FALSE,"11/16/2008",2008,"November","2000s",49,51,16
"9966","200811160tam","Tampa Bay Buccaneers",19,"Minnesota Vikings",13,32,6,TRUE,"11/16/2008",2008,"November","2000s",60,53,13
"9967","200811160sfo","San Francisco 49ers",35,"St. Louis Rams",16,51,19,TRUE,"11/16/2008",2008,"November","2000s",62,66,4
"9968","200811160pit","Pittsburgh Steelers",11,"San Diego Chargers",10,21,1,TRUE,"11/16/2008",2008,"November","2000s",36,76,17
"9969","200811160cin","Cincinnati Bengals",13,"Philadelphia Eagles",13,26,0,FALSE,"11/16/2008",2008,"November","2000s",37,72,14
"9970","200811160jax","Jacksonville Jaguars",14,"Tennessee Titans",24,38,-10,FALSE,"11/16/2008",2008,"November","2000s",52,59,12
"9971","200811160gnb","Green Bay Packers",37,"Chicago Bears",3,40,34,TRUE,"11/16/2008",2008,"November","2000s",32,67,11
"9972","200811160mia","Miami Dolphins",17,"Oakland Raiders",15,32,2,TRUE,"11/16/2008",2008,"November","2000s",70,59,12
"9973","200811160atl","Atlanta Falcons",20,"Denver Broncos",24,44,-4,FALSE,"11/16/2008",2008,"November","2000s",72,NA,NA
"9974","200811160car","Carolina Panthers",31,"Detroit Lions",22,53,9,TRUE,"11/16/2008",2008,"November","2000s",46,54,9
"9975","200811160clt","Indianapolis Colts",33,"Houston Texans",27,60,6,TRUE,"11/16/2008",2008,"November","2000s",72,NA,NA
"9976","200811160kan","Kansas City Chiefs",20,"New Orleans Saints",30,50,-10,FALSE,"11/16/2008",2008,"November","2000s",39,61,12
"9977","200811170buf","Buffalo Bills",27,"Cleveland Browns",29,56,-2,FALSE,"11/17/2008",2008,"November","2000s",34,68,14
"9978","200811200pit","Pittsburgh Steelers",27,"Cincinnati Bengals",10,37,17,TRUE,"11/20/2008",2008,"November","2000s",32,67,14
"9979","200811230det","Detroit Lions",20,"Tampa Bay Buccaneers",38,58,-18,FALSE,"11/23/2008",2008,"November","2000s",72,NA,NA
"9980","200811230ram","St. Louis Rams",3,"Chicago Bears",27,30,-24,FALSE,"11/23/2008",2008,"November","2000s",72,NA,NA
"9981","200811230jax","Jacksonville Jaguars",12,"Minnesota Vikings",30,42,-18,FALSE,"11/23/2008",2008,"November","2000s",49,74,9
"9982","200811230sdg","San Diego Chargers",20,"Indianapolis Colts",23,43,-3,FALSE,"11/23/2008",2008,"November","2000s",60,81,4
"9983","200811230rav","Baltimore Ravens",36,"Philadelphia Eagles",7,43,29,TRUE,"11/23/2008",2008,"November","2000s",31,42,7
"9984","200811230sea","Seattle Seahawks",17,"Washington Redskins",20,37,-3,FALSE,"11/23/2008",2008,"November","2000s",43,79,5
"9985","200811230dal","Dallas Cowboys",35,"San Francisco 49ers",22,57,13,TRUE,"11/23/2008",2008,"November","2000s",59,60,13
"9986","200811230den","Denver Broncos",10,"Oakland Raiders",31,41,-21,FALSE,"11/23/2008",2008,"November","2000s",41,33,12
"9987","200811230oti","Tennessee Titans",13,"New York Jets",34,47,-21,FALSE,"11/23/2008",2008,"November","2000s",40,48,5
"9988","200811230crd","Arizona Cardinals",29,"New York Giants",37,66,-8,FALSE,"11/23/2008",2008,"November","2000s",72,NA,NA
"9989","200811230mia","Miami Dolphins",28,"New England Patriots",48,76,-20,FALSE,"11/23/2008",2008,"November","2000s",68,57,10
"9990","200811230cle","Cleveland Browns",6,"Houston Texans",16,22,-10,FALSE,"11/23/2008",2008,"November","2000s",24,66,7
"9991","200811230atl","Atlanta Falcons",45,"Carolina Panthers",28,73,17,TRUE,"11/23/2008",2008,"November","2000s",72,NA,NA
"9992","200811230kan","Kansas City Chiefs",31,"Buffalo Bills",54,85,-23,FALSE,"11/23/2008",2008,"November","2000s",39,68,12
"9993","200811240nor","New Orleans Saints",51,"Green Bay Packers",29,80,22,TRUE,"11/24/2008",2008,"November","2000s",72,NA,NA
"9994","200811270det","Detroit Lions",10,"Tennessee Titans",47,57,-37,FALSE,"11/27/2008",2008,"November","2000s",72,NA,NA
"9995","200811270phi","Philadelphia Eagles",48,"Arizona Cardinals",20,68,28,TRUE,"11/27/2008",2008,"November","2000s",40,57,12
"9996","200811270dal","Dallas Cowboys",34,"Seattle Seahawks",9,43,25,TRUE,"11/27/2008",2008,"November","2000s",57,46,6
"9997","200811300ram","St. Louis Rams",12,"Miami Dolphins",16,28,-4,FALSE,"11/30/2008",2008,"November","2000s",72,NA,NA
"9998","200811300rai","Oakland Raiders",13,"Kansas City Chiefs",20,33,-7,FALSE,"11/30/2008",2008,"November","2000s",56,74,4
"9999","200811300was","Washington Redskins",7,"New York Giants",23,30,-16,FALSE,"11/30/2008",2008,"November","2000s",40,80,8
"10000","200811300sdg","San Diego Chargers",16,"Atlanta Falcons",22,38,-6,FALSE,"11/30/2008",2008,"November","2000s",59,87,6
"10001","200811300buf","Buffalo Bills",3,"San Francisco 49ers",10,13,-7,FALSE,"11/30/2008",2008,"November","2000s",31,75,11
"10002","200811300tam","Tampa Bay Buccaneers",23,"New Orleans Saints",20,43,3,TRUE,"11/30/2008",2008,"November","2000s",68,81,13
"10003","200811300cin","Cincinnati Bengals",3,"Baltimore Ravens",34,37,-31,FALSE,"11/30/2008",2008,"November","2000s",39,75,8
"10004","200811300nwe","New England Patriots",10,"Pittsburgh Steelers",33,43,-23,FALSE,"11/30/2008",2008,"November","2000s",36,69,11
"10005","200811300nyj","New York Jets",17,"Denver Broncos",34,51,-17,FALSE,"11/30/2008",2008,"November","2000s",40,65,14
"10006","200811300cle","Cleveland Browns",6,"Indianapolis Colts",10,16,-4,FALSE,"11/30/2008",2008,"November","2000s",34,76,10
"10007","200811300min","Minnesota Vikings",34,"Chicago Bears",14,48,20,TRUE,"11/30/2008",2008,"November","2000s",72,NA,NA
"10008","200811300gnb","Green Bay Packers",31,"Carolina Panthers",35,66,-4,FALSE,"11/30/2008",2008,"November","2000s",30,83,9
"10009","200812010htx","Houston Texans",30,"Jacksonville Jaguars",17,47,13,TRUE,"12/1/2008",2008,"December","2000s",72,NA,NA
"10010","200812040sdg","San Diego Chargers",34,"Oakland Raiders",7,41,27,TRUE,"12/4/2008",2008,"December","2000s",61,72,6
"10011","200812070sea","Seattle Seahawks",21,"New England Patriots",24,45,-3,FALSE,"12/7/2008",2008,"December","2000s",48,84,12
"10012","200812070pit","Pittsburgh Steelers",20,"Dallas Cowboys",13,33,7,TRUE,"12/7/2008",2008,"December","2000s",24,66,20
"10013","200812070rav","Baltimore Ravens",24,"Washington Redskins",10,34,14,TRUE,"12/7/2008",2008,"December","2000s",31,66,15
"10014","200812070crd","Arizona Cardinals",34,"St. Louis Rams",10,44,24,TRUE,"12/7/2008",2008,"December","2000s",72,NA,NA
"10015","200812070nyg","New York Giants",14,"Philadelphia Eagles",20,34,-6,FALSE,"12/7/2008",2008,"December","2000s",35,60,19
"10016","200812070sfo","San Francisco 49ers",24,"New York Jets",14,38,10,TRUE,"12/7/2008",2008,"December","2000s",51,83,6
"10017","200812070det","Detroit Lions",16,"Minnesota Vikings",20,36,-4,FALSE,"12/7/2008",2008,"December","2000s",72,NA,NA
"10018","200812070den","Denver Broncos",24,"Kansas City Chiefs",17,41,7,TRUE,"12/7/2008",2008,"December","2000s",50,47,10
"10019","200812070chi","Chicago Bears",23,"Jacksonville Jaguars",10,33,13,TRUE,"12/7/2008",2008,"December","2000s",13,63,13
"10020","200812070gnb","Green Bay Packers",21,"Houston Texans",24,45,-3,FALSE,"12/7/2008",2008,"December","2000s",6,71,10
"10021","200812070oti","Tennessee Titans",28,"Cleveland Browns",9,37,19,TRUE,"12/7/2008",2008,"December","2000s",31,53,7
"10022","200812070clt","Indianapolis Colts",35,"Cincinnati Bengals",3,38,32,TRUE,"12/7/2008",2008,"December","2000s",72,NA,NA
"10023","200812070nor","New Orleans Saints",29,"Atlanta Falcons",25,54,4,TRUE,"12/7/2008",2008,"December","2000s",72,NA,NA
"10024","200812070buf","Buffalo Bills",3,"Miami Dolphins",16,19,-13,FALSE,"12/7/2008",2008,"December","2000s",72,NA,NA
"10025","200812080car","Carolina Panthers",38,"Tampa Bay Buccaneers",23,61,15,TRUE,"12/8/2008",2008,"December","2000s",35,39,4
"10026","200812110chi","Chicago Bears",27,"New Orleans Saints",24,51,3,TRUE,"12/11/2008",2008,"December","2000s",24,69,8
"10027","200812140ram","St. Louis Rams",20,"Seattle Seahawks",23,43,-3,FALSE,"12/14/2008",2008,"December","2000s",72,NA,NA
"10028","200812140rav","Baltimore Ravens",9,"Pittsburgh Steelers",13,22,-4,FALSE,"12/14/2008",2008,"December","2000s",34,64,6
"10029","200812140rai","Oakland Raiders",26,"New England Patriots",49,75,-23,FALSE,"12/14/2008",2008,"December","2000s",45,73,15
"10030","200812140cin","Cincinnati Bengals",20,"Washington Redskins",13,33,7,TRUE,"12/14/2008",2008,"December","2000s",43,54,18
"10031","200812140atl","Atlanta Falcons",13,"Tampa Bay Buccaneers",10,23,3,TRUE,"12/14/2008",2008,"December","2000s",72,NA,NA
"10032","200812140mia","Miami Dolphins",14,"San Francisco 49ers",9,23,5,TRUE,"12/14/2008",2008,"December","2000s",74,58,16
"10033","200812140kan","Kansas City Chiefs",21,"San Diego Chargers",22,43,-1,FALSE,"12/14/2008",2008,"December","2000s",46,68,26
"10034","200812140htx","Houston Texans",13,"Tennessee Titans",12,25,1,TRUE,"12/14/2008",2008,"December","2000s",72,NA,NA
"10035","200812140nyj","New York Jets",31,"Buffalo Bills",27,58,4,TRUE,"12/14/2008",2008,"December","2000s",36,52,10
"10036","200812140car","Carolina Panthers",30,"Denver Broncos",10,40,20,TRUE,"12/14/2008",2008,"December","2000s",39,59,5
"10037","200812140clt","Indianapolis Colts",31,"Detroit Lions",21,52,10,TRUE,"12/14/2008",2008,"December","2000s",72,NA,NA
"10038","200812140jax","Jacksonville Jaguars",20,"Green Bay Packers",16,36,4,TRUE,"12/14/2008",2008,"December","2000s",56,78,9
"10039","200812140crd","Arizona Cardinals",14,"Minnesota Vikings",35,49,-21,FALSE,"12/14/2008",2008,"December","2000s",72,NA,NA
"10040","200812140dal","Dallas Cowboys",20,"New York Giants",8,28,12,TRUE,"12/14/2008",2008,"December","2000s",70,56,27
"10041","200812150phi","Philadelphia Eagles",30,"Cleveland Browns",10,40,20,TRUE,"12/15/2008",2008,"December","2000s",52,74,12
"10042","200812180jax","Jacksonville Jaguars",24,"Indianapolis Colts",31,55,-7,FALSE,"12/18/2008",2008,"December","2000s",67,78,2
"10043","200812200dal","Dallas Cowboys",24,"Baltimore Ravens",33,57,-9,FALSE,"12/20/2008",2008,"December","2000s",61,50,11
"10044","200812210oti","Tennessee Titans",31,"Pittsburgh Steelers",14,45,17,TRUE,"12/21/2008",2008,"December","2000s",36,61,13
"10045","200812210rai","Oakland Raiders",27,"Houston Texans",16,43,11,TRUE,"12/21/2008",2008,"December","2000s",46,74,5
"10046","200812210sea","Seattle Seahawks",13,"New York Jets",3,16,10,TRUE,"12/21/2008",2008,"December","2000s",26,80,18
"10047","200812210ram","St. Louis Rams",16,"San Francisco 49ers",17,33,-1,FALSE,"12/21/2008",2008,"December","2000s",72,NA,NA
"10048","200812210det","Detroit Lions",7,"New Orleans Saints",42,49,-35,FALSE,"12/21/2008",2008,"December","2000s",72,NA,NA
"10049","200812210kan","Kansas City Chiefs",31,"Miami Dolphins",38,69,-7,FALSE,"12/21/2008",2008,"December","2000s",4,56,16
"10050","200812210was","Washington Redskins",10,"Philadelphia Eagles",3,13,7,TRUE,"12/21/2008",2008,"December","2000s",34,69,12
"10051","200812210nwe","New England Patriots",47,"Arizona Cardinals",7,54,40,TRUE,"12/21/2008",2008,"December","2000s",27,86,24
"10052","200812210cle","Cleveland Browns",0,"Cincinnati Bengals",14,14,-14,FALSE,"12/21/2008",2008,"December","2000s",21,75,21
"10053","200812210nyg","New York Giants",34,"Carolina Panthers",28,62,6,TRUE,"12/21/2008",2008,"December","2000s",31,82,18
"10054","200812210den","Denver Broncos",23,"Buffalo Bills",30,53,-7,FALSE,"12/21/2008",2008,"December","2000s",11,62,16
"10055","200812210min","Minnesota Vikings",17,"Atlanta Falcons",24,41,-7,FALSE,"12/21/2008",2008,"December","2000s",72,NA,NA
"10056","200812210tam","Tampa Bay Buccaneers",24,"San Diego Chargers",41,65,-17,FALSE,"12/21/2008",2008,"December","2000s",68,84,7
"10057","200812220chi","Chicago Bears",20,"Green Bay Packers",17,37,3,TRUE,"12/22/2008",2008,"December","2000s",0,68,15
"10058","200812280sfo","San Francisco 49ers",27,"Washington Redskins",24,51,3,TRUE,"12/28/2008",2008,"December","2000s",50,82,3
"10059","200812280tam","Tampa Bay Buccaneers",24,"Oakland Raiders",31,55,-7,FALSE,"12/28/2008",2008,"December","2000s",72,69,5
"10060","200812280rav","Baltimore Ravens",27,"Jacksonville Jaguars",7,34,20,TRUE,"12/28/2008",2008,"December","2000s",59,72,16
"10061","200812280sdg","San Diego Chargers",52,"Denver Broncos",21,73,31,TRUE,"12/28/2008",2008,"December","2000s",51,47,4
"10062","200812280phi","Philadelphia Eagles",44,"Dallas Cowboys",6,50,38,TRUE,"12/28/2008",2008,"December","2000s",56,82,17
"10063","200812280pit","Pittsburgh Steelers",31,"Cleveland Browns",0,31,31,TRUE,"12/28/2008",2008,"December","2000s",56,56,17
"10064","200812280crd","Arizona Cardinals",34,"Seattle Seahawks",21,55,13,TRUE,"12/28/2008",2008,"December","2000s",72,NA,NA
"10065","200812280atl","Atlanta Falcons",31,"St. Louis Rams",27,58,4,TRUE,"12/28/2008",2008,"December","2000s",72,NA,NA
"10066","200812280clt","Indianapolis Colts",23,"Tennessee Titans",0,23,23,TRUE,"12/28/2008",2008,"December","2000s",72,NA,NA
"10067","200812280nor","New Orleans Saints",31,"Carolina Panthers",33,64,-2,FALSE,"12/28/2008",2008,"December","2000s",72,NA,NA
"10068","200812280htx","Houston Texans",31,"Chicago Bears",24,55,7,TRUE,"12/28/2008",2008,"December","2000s",72,NA,NA
"10069","200812280gnb","Green Bay Packers",31,"Detroit Lions",21,52,10,TRUE,"12/28/2008",2008,"December","2000s",28,85,17
"10070","200812280cin","Cincinnati Bengals",16,"Kansas City Chiefs",6,22,10,TRUE,"12/28/2008",2008,"December","2000s",49,68,18
"10071","200812280nyj","New York Jets",17,"Miami Dolphins",24,41,-7,FALSE,"12/28/2008",2008,"December","2000s",55,79,16
"10072","200812280buf","Buffalo Bills",0,"New England Patriots",13,13,-13,FALSE,"12/28/2008",2008,"December","2000s",51,67,32
"10073","200812280min","Minnesota Vikings",20,"New York Giants",19,39,1,TRUE,"12/28/2008",2008,"December","2000s",72,NA,NA
"10074","200901030crd","Arizona Cardinals",30,"Atlanta Falcons",24,54,6,TRUE,"1/3/2009",2009,"January","2000s",72,NA,NA
"10075","200901030sdg","San Diego Chargers",23,"Indianapolis Colts",17,40,6,TRUE,"1/3/2009",2009,"January","2000s",54,78,7
"10076","200901040min","Minnesota Vikings",14,"Philadelphia Eagles",26,40,-12,FALSE,"1/4/2009",2009,"January","2000s",72,NA,NA
"10077","200901040mia","Miami Dolphins",9,"Baltimore Ravens",27,36,-18,FALSE,"1/4/2009",2009,"January","2000s",74,72,10
"10078","200901100oti","Tennessee Titans",10,"Baltimore Ravens",13,23,-3,FALSE,"1/10/2009",2009,"January","2000s",53,68,12
"10079","200901100car","Carolina Panthers",13,"Arizona Cardinals",33,46,-20,FALSE,"1/10/2009",2009,"January","2000s",43,58,10
"10080","200901110nyg","New York Giants",11,"Philadelphia Eagles",23,34,-12,FALSE,"1/11/2009",2009,"January","2000s",29,80,15
"10081","200901110pit","Pittsburgh Steelers",35,"San Diego Chargers",24,59,11,TRUE,"1/11/2009",2009,"January","2000s",26,85,12
"10082","200901180pit","Pittsburgh Steelers",23,"Baltimore Ravens",14,37,9,TRUE,"1/18/2009",2009,"January","2000s",26,79,11
"10083","200901180crd","Arizona Cardinals",32,"Philadelphia Eagles",25,57,7,TRUE,"1/18/2009",2009,"January","2000s",72,NA,NA
"10084","200902010crd","Arizona Cardinals",23,"Pittsburgh Steelers",27,50,-4,FALSE,"2/1/2009",2009,"Feburary","2000s",53,53,4
"10085","200909100pit","Pittsburgh Steelers",13,"Tennessee Titans",10,23,3,TRUE,"9/10/2009",2009,"September","2000s",67,64,9
"10086","200909130htx","Houston Texans",7,"New York Jets",24,31,-17,FALSE,"9/13/2009",2009,"September","2000s",72,NA,NA
"10087","200909130nyg","New York Giants",23,"Washington Redskins",17,40,6,TRUE,"9/13/2009",2009,"September","2000s",71,70,9
"10088","200909130crd","Arizona Cardinals",16,"San Francisco 49ers",20,36,-4,FALSE,"9/13/2009",2009,"September","2000s",72,NA,NA
"10089","200909130sea","Seattle Seahawks",28,"St. Louis Rams",0,28,28,TRUE,"9/13/2009",2009,"September","2000s",68,63,8
"10090","200909130car","Carolina Panthers",10,"Philadelphia Eagles",38,48,-28,FALSE,"9/13/2009",2009,"September","2000s",73,59,7
"10091","200909130cle","Cleveland Browns",20,"Minnesota Vikings",34,54,-14,FALSE,"9/13/2009",2009,"September","2000s",64,71,4
"10092","200909130atl","Atlanta Falcons",19,"Miami Dolphins",7,26,12,TRUE,"9/13/2009",2009,"September","2000s",72,NA,NA
"10093","200909130rav","Baltimore Ravens",38,"Kansas City Chiefs",24,62,14,TRUE,"9/13/2009",2009,"September","2000s",69,74,7
"10094","200909130gnb","Green Bay Packers",21,"Chicago Bears",15,36,6,TRUE,"9/13/2009",2009,"September","2000s",67,69,5
"10095","200909130clt","Indianapolis Colts",14,"Jacksonville Jaguars",12,26,2,TRUE,"9/13/2009",2009,"September","2000s",72,NA,NA
"10096","200909130nor","New Orleans Saints",45,"Detroit Lions",27,72,18,TRUE,"9/13/2009",2009,"September","2000s",72,NA,NA
"10097","200909130cin","Cincinnati Bengals",7,"Denver Broncos",12,19,-5,FALSE,"9/13/2009",2009,"September","2000s",67,55,8
"10098","200909130tam","Tampa Bay Buccaneers",21,"Dallas Cowboys",34,55,-13,FALSE,"9/13/2009",2009,"September","2000s",82,82,9
"10099","200909140rai","Oakland Raiders",20,"San Diego Chargers",24,44,-4,FALSE,"9/14/2009",2009,"September","2000s",64,81,12
"10100","200909140nwe","New England Patriots",25,"Buffalo Bills",24,49,1,TRUE,"9/14/2009",2009,"September","2000s",68,56,11
"10101","200909200dal","Dallas Cowboys",31,"New York Giants",33,64,-2,FALSE,"9/20/2009",2009,"September","2000s",78,NA,6
"10102","200909200chi","Chicago Bears",17,"Pittsburgh Steelers",14,31,3,TRUE,"9/20/2009",2009,"September","2000s",64,66,9
"10103","200909200kan","Kansas City Chiefs",10,"Oakland Raiders",13,23,-3,FALSE,"9/20/2009",2009,"September","2000s",71,64,7
"10104","200909200was","Washington Redskins",9,"St. Louis Rams",7,16,2,TRUE,"9/20/2009",2009,"September","2000s",65,60,5
"10105","200909200sdg","San Diego Chargers",26,"Baltimore Ravens",31,57,-5,FALSE,"9/20/2009",2009,"September","2000s",70,80,7
"10106","200909200sfo","San Francisco 49ers",23,"Seattle Seahawks",10,33,13,TRUE,"9/20/2009",2009,"September","2000s",64,76,12
"10107","200909200buf","Buffalo Bills",33,"Tampa Bay Buccaneers",20,53,13,TRUE,"9/20/2009",2009,"September","2000s",58,57,5
"10108","200909200nyj","New York Jets",16,"New England Patriots",9,25,7,TRUE,"9/20/2009",2009,"September","2000s",65,52,7
"10109","200909200phi","Philadelphia Eagles",22,"New Orleans Saints",48,70,-26,FALSE,"9/20/2009",2009,"September","2000s",62,60,4
"10110","200909200atl","Atlanta Falcons",28,"Carolina Panthers",20,48,8,TRUE,"9/20/2009",2009,"September","2000s",72,NA,NA
"10111","200909200gnb","Green Bay Packers",24,"Cincinnati Bengals",31,55,-7,FALSE,"9/20/2009",2009,"September","2000s",57,73,6
"10112","200909200den","Denver Broncos",27,"Cleveland Browns",6,33,21,TRUE,"9/20/2009",2009,"September","2000s",68,33,15
"10113","200909200jax","Jacksonville Jaguars",17,"Arizona Cardinals",31,48,-14,FALSE,"9/20/2009",2009,"September","2000s",83,73,9
"10114","200909200oti","Tennessee Titans",31,"Houston Texans",34,65,-3,FALSE,"9/20/2009",2009,"September","2000s",74,86,9
"10115","200909200det","Detroit Lions",13,"Minnesota Vikings",27,40,-14,FALSE,"9/20/2009",2009,"September","2000s",72,NA,NA
"10116","200909210mia","Miami Dolphins",23,"Indianapolis Colts",27,50,-4,FALSE,"9/21/2009",2009,"September","2000s",85,72,9
"10117","200909270sdg","San Diego Chargers",23,"Miami Dolphins",13,36,10,TRUE,"9/27/2009",2009,"September","2000s",70,82,6
"10118","200909270buf","Buffalo Bills",7,"New Orleans Saints",27,34,-20,FALSE,"9/27/2009",2009,"September","2000s",60,87,11
"10119","200909270tam","Tampa Bay Buccaneers",0,"New York Giants",24,24,-24,FALSE,"9/27/2009",2009,"September","2000s",84,78,7
"10120","200909270nyj","New York Jets",24,"Tennessee Titans",17,41,7,TRUE,"9/27/2009",2009,"September","2000s",64,85,8
"10121","200909270cin","Cincinnati Bengals",23,"Pittsburgh Steelers",20,43,3,TRUE,"9/27/2009",2009,"September","2000s",62,86,8
"10122","200909270min","Minnesota Vikings",27,"San Francisco 49ers",24,51,3,TRUE,"9/27/2009",2009,"September","2000s",72,NA,NA
"10123","200909270det","Detroit Lions",19,"Washington Redskins",14,33,5,TRUE,"9/27/2009",2009,"September","2000s",72,NA,NA
"10124","200909270phi","Philadelphia Eagles",34,"Kansas City Chiefs",14,48,20,TRUE,"9/27/2009",2009,"September","2000s",65,88,9
"10125","200909270htx","Houston Texans",24,"Jacksonville Jaguars",31,55,-7,FALSE,"9/27/2009",2009,"September","2000s",72,NA,NA
"10126","200909270nwe","New England Patriots",26,"Atlanta Falcons",10,36,16,TRUE,"9/27/2009",2009,"September","2000s",58,84,14
"10127","200909270sea","Seattle Seahawks",19,"Chicago Bears",25,44,-6,FALSE,"9/27/2009",2009,"September","2000s",58,62,11
"10128","200909270rav","Baltimore Ravens",34,"Cleveland Browns",3,37,31,TRUE,"9/27/2009",2009,"September","2000s",65,87,8
"10129","200909270crd","Arizona Cardinals",10,"Indianapolis Colts",31,41,-21,FALSE,"9/27/2009",2009,"September","2000s",72,NA,NA
"10130","200909270rai","Oakland Raiders",3,"Denver Broncos",23,26,-20,FALSE,"9/27/2009",2009,"September","2000s",70,61,6
"10131","200909270ram","St. Louis Rams",17,"Green Bay Packers",36,53,-19,FALSE,"9/27/2009",2009,"September","2000s",72,NA,NA
"10132","200909280dal","Dallas Cowboys",21,"Carolina Panthers",7,28,14,TRUE,"9/28/2009",2009,"September","2000s",78,NA,14
"10133","200910040jax","Jacksonville Jaguars",37,"Tennessee Titans",17,54,20,TRUE,"10/4/2009",2009,"October","2000s",79,72,7
"10134","200910040htx","Houston Texans",29,"Oakland Raiders",6,35,23,TRUE,"10/4/2009",2009,"October","2000s",72,NA,NA
"10135","200910040sfo","San Francisco 49ers",35,"St. Louis Rams",0,35,35,TRUE,"10/4/2009",2009,"October","2000s",55,65,27
"10136","200910040nwe","New England Patriots",27,"Baltimore Ravens",21,48,6,TRUE,"10/4/2009",2009,"October","2000s",62,89,5
"10137","200910040pit","Pittsburgh Steelers",38,"San Diego Chargers",28,66,10,TRUE,"10/4/2009",2009,"October","2000s",55,65,7
"10138","200910040was","Washington Redskins",16,"Tampa Bay Buccaneers",13,29,3,TRUE,"10/4/2009",2009,"October","2000s",64,54,9
"10139","200910040nor","New Orleans Saints",24,"New York Jets",10,34,14,TRUE,"10/4/2009",2009,"October","2000s",72,NA,NA
"10140","200910040kan","Kansas City Chiefs",16,"New York Giants",27,43,-11,FALSE,"10/4/2009",2009,"October","2000s",52,63,6
"10141","200910040clt","Indianapolis Colts",34,"Seattle Seahawks",17,51,17,TRUE,"10/4/2009",2009,"October","2000s",72,NA,NA
"10142","200910040chi","Chicago Bears",48,"Detroit Lions",24,72,24,TRUE,"10/4/2009",2009,"October","2000s",51,76,11
"10143","200910040den","Denver Broncos",17,"Dallas Cowboys",10,27,7,TRUE,"10/4/2009",2009,"October","2000s",48,50,12
"10144","200910040cle","Cleveland Browns",20,"Cincinnati Bengals",23,43,-3,FALSE,"10/4/2009",2009,"October","2000s",54,72,12
"10145","200910040mia","Miami Dolphins",38,"Buffalo Bills",10,48,28,TRUE,"10/4/2009",2009,"October","2000s",83,72,7
"10146","200910050min","Minnesota Vikings",30,"Green Bay Packers",23,53,7,TRUE,"10/5/2009",2009,"October","2000s",72,NA,NA
"10147","200910110crd","Arizona Cardinals",28,"Houston Texans",21,49,7,TRUE,"10/11/2009",2009,"October","2000s",72,NA,NA
"10148","200910110car","Carolina Panthers",20,"Washington Redskins",17,37,3,TRUE,"10/11/2009",2009,"October","2000s",65,67,8
"10149","200910110phi","Philadelphia Eagles",33,"Tampa Bay Buccaneers",14,47,19,TRUE,"10/11/2009",2009,"October","2000s",56,54,8
"10150","200910110sfo","San Francisco 49ers",10,"Atlanta Falcons",45,55,-35,FALSE,"10/11/2009",2009,"October","2000s",54,76,12
"10151","200910110nyg","New York Giants",44,"Oakland Raiders",7,51,37,TRUE,"10/11/2009",2009,"October","2000s",57,47,11
"10152","200910110det","Detroit Lions",20,"Pittsburgh Steelers",28,48,-8,FALSE,"10/11/2009",2009,"October","2000s",72,NA,NA
"10153","200910110den","Denver Broncos",20,"New England Patriots",17,37,3,TRUE,"10/11/2009",2009,"October","2000s",28,72,8
"10154","200910110ram","St. Louis Rams",10,"Minnesota Vikings",38,48,-28,FALSE,"10/11/2009",2009,"October","2000s",72,NA,NA
"10155","200910110sea","Seattle Seahawks",41,"Jacksonville Jaguars",0,41,41,TRUE,"10/11/2009",2009,"October","2000s",50,28,11
"10156","200910110kan","Kansas City Chiefs",20,"Dallas Cowboys",26,46,-6,FALSE,"10/11/2009",2009,"October","2000s",38,64,10
"10157","200910110oti","Tennessee Titans",9,"Indianapolis Colts",31,40,-22,FALSE,"10/11/2009",2009,"October","2000s",54,75,7
"10158","200910110buf","Buffalo Bills",3,"Cleveland Browns",6,9,-3,FALSE,"10/11/2009",2009,"October","2000s",46,57,13
"10159","200910110rav","Baltimore Ravens",14,"Cincinnati Bengals",17,31,-3,FALSE,"10/11/2009",2009,"October","2000s",54,65,5
"10160","200910120mia","Miami Dolphins",31,"New York Jets",27,58,4,TRUE,"10/12/2009",2009,"October","2000s",86,67,12
"10161","200910180sea","Seattle Seahawks",3,"Arizona Cardinals",27,30,-24,FALSE,"10/18/2009",2009,"October","2000s",56,86,10
"10162","200910180tam","Tampa Bay Buccaneers",21,"Carolina Panthers",28,49,-7,FALSE,"10/18/2009",2009,"October","2000s",58,61,14
"10163","200910180atl","Atlanta Falcons",21,"Chicago Bears",14,35,7,TRUE,"10/18/2009",2009,"October","2000s",72,NA,NA
"10164","200910180rai","Oakland Raiders",13,"Philadelphia Eagles",9,22,4,TRUE,"10/18/2009",2009,"October","2000s",61,84,9
"10165","200910180nor","New Orleans Saints",48,"New York Giants",27,75,21,TRUE,"10/18/2009",2009,"October","2000s",72,NA,NA
"10166","200910180min","Minnesota Vikings",33,"Baltimore Ravens",31,64,2,TRUE,"10/18/2009",2009,"October","2000s",72,NA,NA
"10167","200910180jax","Jacksonville Jaguars",23,"St. Louis Rams",20,43,3,TRUE,"10/18/2009",2009,"October","2000s",57,56,14
"10168","200910180nwe","New England Patriots",59,"Tennessee Titans",0,59,59,TRUE,"10/18/2009",2009,"October","2000s",44,80,20
"10169","200910180was","Washington Redskins",6,"Kansas City Chiefs",14,20,-8,FALSE,"10/18/2009",2009,"October","2000s",45,74,17
"10170","200910180cin","Cincinnati Bengals",17,"Houston Texans",28,45,-11,FALSE,"10/18/2009",2009,"October","2000s",41,60,6
"10171","200910180gnb","Green Bay Packers",26,"Detroit Lions",0,26,26,TRUE,"10/18/2009",2009,"October","2000s",38,76,8
"10172","200910180nyj","New York Jets",13,"Buffalo Bills",16,29,-3,FALSE,"10/18/2009",2009,"October","2000s",46,73,17
"10173","200910180pit","Pittsburgh Steelers",27,"Cleveland Browns",14,41,13,TRUE,"10/18/2009",2009,"October","2000s",40,71,11
"10174","200910190sdg","San Diego Chargers",23,"Denver Broncos",34,57,-11,FALSE,"10/19/2009",2009,"October","2000s",66,75,8
"10175","200910250dal","Dallas Cowboys",37,"Atlanta Falcons",21,58,16,TRUE,"10/25/2009",2009,"October","2000s",64,NA,13
"10176","200910250cin","Cincinnati Bengals",45,"Chicago Bears",10,55,35,TRUE,"10/25/2009",2009,"October","2000s",46,68,5
"10177","200910250mia","Miami Dolphins",34,"New Orleans Saints",46,80,-12,FALSE,"10/25/2009",2009,"October","2000s",79,79,5
"10178","200910250ram","St. Louis Rams",6,"Indianapolis Colts",42,48,-36,FALSE,"10/25/2009",2009,"October","2000s",72,NA,NA
"10179","200910250nyg","New York Giants",17,"Arizona Cardinals",24,41,-7,FALSE,"10/25/2009",2009,"October","2000s",60,56,16
"10180","200910250rai","Oakland Raiders",0,"New York Jets",38,38,-38,FALSE,"10/25/2009",2009,"October","2000s",61,76,6
"10181","200910250cle","Cleveland Browns",3,"Green Bay Packers",31,34,-28,FALSE,"10/25/2009",2009,"October","2000s",48,64,10
"10182","200910250kan","Kansas City Chiefs",7,"San Diego Chargers",37,44,-30,FALSE,"10/25/2009",2009,"October","2000s",55,76,12
"10183","200910250htx","Houston Texans",24,"San Francisco 49ers",21,45,3,TRUE,"10/25/2009",2009,"October","2000s",72,NA,NA
"10184","200910250car","Carolina Panthers",9,"Buffalo Bills",20,29,-11,FALSE,"10/25/2009",2009,"October","2000s",55,64,8
"10185","200910250pit","Pittsburgh Steelers",27,"Minnesota Vikings",17,44,10,TRUE,"10/25/2009",2009,"October","2000s",48,61,9
"10186","200910250tam","Tampa Bay Buccaneers",7,"New England Patriots",35,42,-28,FALSE,"10/25/2009",2009,"October","2000s",56,73,17
"10187","200910260was","Washington Redskins",17,"Philadelphia Eagles",27,44,-10,FALSE,"10/26/2009",2009,"October","2000s",53,66,5
"10188","200911010dal","Dallas Cowboys",38,"Seattle Seahawks",17,55,21,TRUE,"11/1/2009",2009,"November","2000s",61,NA,7
"10189","200911010det","Detroit Lions",10,"St. Louis Rams",17,27,-7,FALSE,"11/1/2009",2009,"November","2000s",72,NA,NA
"10190","200911010gnb","Green Bay Packers",26,"Minnesota Vikings",38,64,-12,FALSE,"11/1/2009",2009,"November","2000s",40,70,7
"10191","200911010clt","Indianapolis Colts",18,"San Francisco 49ers",14,32,4,TRUE,"11/1/2009",2009,"November","2000s",72,NA,NA
"10192","200911010crd","Arizona Cardinals",21,"Carolina Panthers",34,55,-13,FALSE,"11/1/2009",2009,"November","2000s",72,NA,NA
"10193","200911010chi","Chicago Bears",30,"Cleveland Browns",6,36,24,TRUE,"11/1/2009",2009,"November","2000s",41,65,5
"10194","200911010rav","Baltimore Ravens",30,"Denver Broncos",7,37,23,TRUE,"11/1/2009",2009,"November","2000s",54,78,7
"10195","200911010oti","Tennessee Titans",30,"Jacksonville Jaguars",13,43,17,TRUE,"11/1/2009",2009,"November","2000s",48,72,6
"10196","200911010nyj","New York Jets",25,"Miami Dolphins",30,55,-5,FALSE,"11/1/2009",2009,"November","2000s",58,59,13
"10197","200911010buf","Buffalo Bills",10,"Houston Texans",31,41,-21,FALSE,"11/1/2009",2009,"November","2000s",46,59,12
"10198","200911010phi","Philadelphia Eagles",40,"New York Giants",17,57,23,TRUE,"11/1/2009",2009,"November","2000s",56,70,12
"10199","200911010sdg","San Diego Chargers",24,"Oakland Raiders",16,40,8,TRUE,"11/1/2009",2009,"November","2000s",64,53,4
"10200","200911020nor","New Orleans Saints",35,"Atlanta Falcons",27,62,8,TRUE,"11/2/2009",2009,"November","2000s",72,NA,NA
"10201","200911080sfo","San Francisco 49ers",27,"Tennessee Titans",34,61,-7,FALSE,"11/8/2009",2009,"November","2000s",57,66,8
"10202","200911080cin","Cincinnati Bengals",17,"Baltimore Ravens",7,24,10,TRUE,"11/8/2009",2009,"November","2000s",59,53,8
"10203","200911080atl","Atlanta Falcons",31,"Washington Redskins",17,48,14,TRUE,"11/8/2009",2009,"November","2000s",72,NA,NA
"10204","200911080nwe","New England Patriots",27,"Miami Dolphins",17,44,10,TRUE,"11/8/2009",2009,"November","2000s",53,55,11
"10205","200911080jax","Jacksonville Jaguars",24,"Kansas City Chiefs",21,45,3,TRUE,"11/8/2009",2009,"November","2000s",70,70,12
"10206","200911080clt","Indianapolis Colts",20,"Houston Texans",17,37,3,TRUE,"11/8/2009",2009,"November","2000s",72,NA,NA
"10207","200911080nor","New Orleans Saints",30,"Carolina Panthers",20,50,10,TRUE,"11/8/2009",2009,"November","2000s",72,NA,NA
"10208","200911080chi","Chicago Bears",21,"Arizona Cardinals",41,62,-20,FALSE,"11/8/2009",2009,"November","2000s",56,76,7
"10209","200911080phi","Philadelphia Eagles",16,"Dallas Cowboys",20,36,-4,FALSE,"11/8/2009",2009,"November","2000s",53,67,3
"10210","200911080sea","Seattle Seahawks",32,"Detroit Lions",20,52,12,TRUE,"11/8/2009",2009,"November","2000s",44,84,11
"10211","200911080tam","Tampa Bay Buccaneers",38,"Green Bay Packers",28,66,10,TRUE,"11/8/2009",2009,"November","2000s",73,62,9
"10212","200911080nyg","New York Giants",20,"San Diego Chargers",21,41,-1,FALSE,"11/8/2009",2009,"November","2000s",55,58,6
"10213","200911090den","Denver Broncos",10,"Pittsburgh Steelers",28,38,-18,FALSE,"11/9/2009",2009,"November","2000s",47,45,14
"10214","200911120sfo","San Francisco 49ers",10,"Chicago Bears",6,16,4,TRUE,"11/12/2009",2009,"November","2000s",57,67,14
"10215","200911150ram","St. Louis Rams",23,"New Orleans Saints",28,51,-5,FALSE,"11/15/2009",2009,"November","2000s",72,NA,NA
"10216","200911150clt","Indianapolis Colts",35,"New England Patriots",34,69,1,TRUE,"11/15/2009",2009,"November","2000s",72,NA,NA
"10217","200911150sdg","San Diego Chargers",31,"Philadelphia Eagles",23,54,8,TRUE,"11/15/2009",2009,"November","2000s",60,64,6
"10218","200911150crd","Arizona Cardinals",31,"Seattle Seahawks",20,51,11,TRUE,"11/15/2009",2009,"November","2000s",72,NA,NA
"10219","200911150mia","Miami Dolphins",25,"Tampa Bay Buccaneers",23,48,2,TRUE,"11/15/2009",2009,"November","2000s",72,61,6
"10220","200911150rai","Oakland Raiders",10,"Kansas City Chiefs",16,26,-6,FALSE,"11/15/2009",2009,"November","2000s",50,70,5
"10221","200911150nyj","New York Jets",22,"Jacksonville Jaguars",24,46,-2,FALSE,"11/15/2009",2009,"November","2000s",56,94,8
"10222","200911150car","Carolina Panthers",28,"Atlanta Falcons",19,47,9,TRUE,"11/15/2009",2009,"November","2000s",60,71,2
"10223","200911150oti","Tennessee Titans",41,"Buffalo Bills",17,58,24,TRUE,"11/15/2009",2009,"November","2000s",55,67,5
"10224","200911150pit","Pittsburgh Steelers",12,"Cincinnati Bengals",18,30,-6,FALSE,"11/15/2009",2009,"November","2000s",54,73,4
"10225","200911150gnb","Green Bay Packers",17,"Dallas Cowboys",7,24,10,TRUE,"11/15/2009",2009,"November","2000s",41,66,11
"10226","200911150was","Washington Redskins",27,"Denver Broncos",17,44,10,TRUE,"11/15/2009",2009,"November","2000s",59,71,7
"10227","200911150min","Minnesota Vikings",27,"Detroit Lions",10,37,17,TRUE,"11/15/2009",2009,"November","2000s",72,NA,NA
"10228","200911160cle","Cleveland Browns",0,"Baltimore Ravens",16,16,-16,FALSE,"11/16/2009",2009,"November","2000s",48,72,14
"10229","200911190car","Carolina Panthers",17,"Miami Dolphins",24,41,-7,FALSE,"11/19/2009",2009,"November","2000s",58,91,5
"10230","200911220chi","Chicago Bears",20,"Philadelphia Eagles",24,44,-4,FALSE,"11/22/2009",2009,"November","2000s",45,79,7
"10231","200911220kan","Kansas City Chiefs",27,"Pittsburgh Steelers",24,51,3,TRUE,"11/22/2009",2009,"November","2000s",52,78,11
"10232","200911220den","Denver Broncos",3,"San Diego Chargers",32,35,-29,FALSE,"11/22/2009",2009,"November","2000s",38,54,10
"10233","200911220min","Minnesota Vikings",35,"Seattle Seahawks",9,44,26,TRUE,"11/22/2009",2009,"November","2000s",72,NA,NA
"10234","200911220gnb","Green Bay Packers",30,"San Francisco 49ers",24,54,6,TRUE,"11/22/2009",2009,"November","2000s",44,85,8
"10235","200911220dal","Dallas Cowboys",7,"Washington Redskins",6,13,1,TRUE,"11/22/2009",2009,"November","2000s",54,NA,7
"10236","200911220nwe","New England Patriots",31,"New York Jets",14,45,17,TRUE,"11/22/2009",2009,"November","2000s",47,69,11
"10237","200911220tam","Tampa Bay Buccaneers",7,"New Orleans Saints",38,45,-31,FALSE,"11/22/2009",2009,"November","2000s",74,78,10
"10238","200911220nyg","New York Giants",34,"Atlanta Falcons",31,65,3,TRUE,"11/22/2009",2009,"November","2000s",50,65,10
"10239","200911220jax","Jacksonville Jaguars",18,"Buffalo Bills",15,33,3,TRUE,"11/22/2009",2009,"November","2000s",69,86,8
"10240","200911220rai","Oakland Raiders",20,"Cincinnati Bengals",17,37,3,TRUE,"11/22/2009",2009,"November","2000s",49,76,8
"10241","200911220det","Detroit Lions",38,"Cleveland Browns",37,75,1,TRUE,"11/22/2009",2009,"November","2000s",72,NA,NA
"10242","200911220rav","Baltimore Ravens",15,"Indianapolis Colts",17,32,-2,FALSE,"11/22/2009",2009,"November","2000s",45,77,6
"10243","200911220ram","St. Louis Rams",13,"Arizona Cardinals",21,34,-8,FALSE,"11/22/2009",2009,"November","2000s",72,NA,NA
"10244","200911230htx","Houston Texans",17,"Tennessee Titans",20,37,-3,FALSE,"11/23/2009",2009,"November","2000s",72,NA,NA
"10245","200911260den","Denver Broncos",26,"New York Giants",6,32,20,TRUE,"11/26/2009",2009,"November","2000s",41,42,11
"10246","200911260det","Detroit Lions",12,"Green Bay Packers",34,46,-22,FALSE,"11/26/2009",2009,"November","2000s",72,NA,NA
"10247","200911260dal","Dallas Cowboys",24,"Oakland Raiders",7,31,17,TRUE,"11/26/2009",2009,"November","2000s",51,NA,8
"10248","200911290rav","Baltimore Ravens",20,"Pittsburgh Steelers",17,37,3,TRUE,"11/29/2009",2009,"November","2000s",45,59,4
"10249","200911290ram","St. Louis Rams",17,"Seattle Seahawks",27,44,-10,FALSE,"11/29/2009",2009,"November","2000s",72,NA,NA
"10250","200911290atl","Atlanta Falcons",20,"Tampa Bay Buccaneers",17,37,3,TRUE,"11/29/2009",2009,"November","2000s",72,NA,NA
"10251","200911290phi","Philadelphia Eagles",27,"Washington Redskins",24,51,3,TRUE,"11/29/2009",2009,"November","2000s",46,60,7
"10252","200911290buf","Buffalo Bills",31,"Miami Dolphins",14,45,17,TRUE,"11/29/2009",2009,"November","2000s",40,75,8
"10253","200911290sdg","San Diego Chargers",43,"Kansas City Chiefs",14,57,29,TRUE,"11/29/2009",2009,"November","2000s",54,72,7
"10254","200911290sfo","San Francisco 49ers",20,"Jacksonville Jaguars",3,23,17,TRUE,"11/29/2009",2009,"November","2000s",61,32,13
"10255","200911290oti","Tennessee Titans",20,"Arizona Cardinals",17,37,3,TRUE,"11/29/2009",2009,"November","2000s",53,60,9
"10256","200911290htx","Houston Texans",27,"Indianapolis Colts",35,62,-8,FALSE,"11/29/2009",2009,"November","2000s",72,NA,NA
"10257","200911290cin","Cincinnati Bengals",16,"Cleveland Browns",7,23,9,TRUE,"11/29/2009",2009,"November","2000s",51,64,12
"10258","200911290min","Minnesota Vikings",36,"Chicago Bears",10,46,26,TRUE,"11/29/2009",2009,"November","2000s",72,NA,NA
"10259","200911290nyj","New York Jets",17,"Carolina Panthers",6,23,11,TRUE,"11/29/2009",2009,"November","2000s",48,50,10
"10260","200911300nor","New Orleans Saints",38,"New England Patriots",17,55,21,TRUE,"11/30/2009",2009,"November","2000s",72,NA,NA
"10261","200912030buf","Buffalo Bills",13,"New York Jets",19,32,-6,FALSE,"12/3/2009",2009,"December","2000s",72,NA,NA
"10262","200912060sea","Seattle Seahawks",20,"San Francisco 49ers",17,37,3,TRUE,"12/6/2009",2009,"December","2000s",35,57,12
"10263","200912060cle","Cleveland Browns",23,"San Diego Chargers",30,53,-7,FALSE,"12/6/2009",2009,"December","2000s",28,59,10
"10264","200912060chi","Chicago Bears",17,"St. Louis Rams",9,26,8,TRUE,"12/6/2009",2009,"December","2000s",30,62,10
"10265","200912060pit","Pittsburgh Steelers",24,"Oakland Raiders",27,51,-3,FALSE,"12/6/2009",2009,"December","2000s",24,70,6
"10266","200912060atl","Atlanta Falcons",7,"Philadelphia Eagles",34,41,-27,FALSE,"12/6/2009",2009,"December","2000s",72,NA,NA
"10267","200912060clt","Indianapolis Colts",27,"Tennessee Titans",17,44,10,TRUE,"12/6/2009",2009,"December","2000s",72,NA,NA
"10268","200912060car","Carolina Panthers",16,"Tampa Bay Buccaneers",6,22,10,TRUE,"12/6/2009",2009,"December","2000s",35,72,4
"10269","200912060mia","Miami Dolphins",22,"New England Patriots",21,43,1,TRUE,"12/6/2009",2009,"December","2000s",67,81,10
"10270","200912060nyg","New York Giants",31,"Dallas Cowboys",24,55,7,TRUE,"12/6/2009",2009,"December","2000s",37,64,17
"10271","200912060kan","Kansas City Chiefs",13,"Denver Broncos",44,57,-31,FALSE,"12/6/2009",2009,"December","2000s",35,55,11
"10272","200912060cin","Cincinnati Bengals",23,"Detroit Lions",13,36,10,TRUE,"12/6/2009",2009,"December","2000s",25,68,5
"10273","200912060jax","Jacksonville Jaguars",23,"Houston Texans",18,41,5,TRUE,"12/6/2009",2009,"December","2000s",49,78,14
"10274","200912060crd","Arizona Cardinals",30,"Minnesota Vikings",17,47,13,TRUE,"12/6/2009",2009,"December","2000s",72,NA,NA
"10275","200912060was","Washington Redskins",30,"New Orleans Saints",33,63,-3,FALSE,"12/6/2009",2009,"December","2000s",34,61,11
"10276","200912070gnb","Green Bay Packers",27,"Baltimore Ravens",14,41,13,TRUE,"12/7/2009",2009,"December","2000s",25,62,9
"10277","200912100cle","Cleveland Browns",13,"Pittsburgh Steelers",6,19,7,TRUE,"12/10/2009",2009,"December","2000s",22,65,27
"10278","200912130tam","Tampa Bay Buccaneers",3,"New York Jets",26,29,-23,FALSE,"12/13/2009",2009,"December","2000s",73,88,5
"10279","200912130nyg","New York Giants",38,"Philadelphia Eagles",45,83,-7,FALSE,"12/13/2009",2009,"December","2000s",40,54,11
"10280","200912130oti","Tennessee Titans",47,"St. Louis Rams",7,54,40,TRUE,"12/13/2009",2009,"December","2000s",48,84,10
"10281","200912130dal","Dallas Cowboys",17,"San Diego Chargers",20,37,-3,FALSE,"12/13/2009",2009,"December","2000s",51,NA,10
"10282","200912130htx","Houston Texans",34,"Seattle Seahawks",7,41,27,TRUE,"12/13/2009",2009,"December","2000s",72,NA,NA
"10283","200912130rai","Oakland Raiders",13,"Washington Redskins",34,47,-21,FALSE,"12/13/2009",2009,"December","2000s",52,88,14
"10284","200912130atl","Atlanta Falcons",23,"New Orleans Saints",26,49,-3,FALSE,"12/13/2009",2009,"December","2000s",72,NA,NA
"10285","200912130jax","Jacksonville Jaguars",10,"Miami Dolphins",14,24,-4,FALSE,"12/13/2009",2009,"December","2000s",69,88,9
"10286","200912130kan","Kansas City Chiefs",10,"Buffalo Bills",16,26,-6,FALSE,"12/13/2009",2009,"December","2000s",39,95,9
"10287","200912130nwe","New England Patriots",20,"Carolina Panthers",10,30,10,TRUE,"12/13/2009",2009,"December","2000s",33,62,9
"10288","200912130min","Minnesota Vikings",30,"Cincinnati Bengals",10,40,20,TRUE,"12/13/2009",2009,"December","2000s",72,NA,NA
"10289","200912130clt","Indianapolis Colts",28,"Denver Broncos",16,44,12,TRUE,"12/13/2009",2009,"December","2000s",72,NA,NA
"10290","200912130rav","Baltimore Ravens",48,"Detroit Lions",3,51,45,TRUE,"12/13/2009",2009,"December","2000s",35,71,4
"10291","200912130chi","Chicago Bears",14,"Green Bay Packers",21,35,-7,FALSE,"12/13/2009",2009,"December","2000s",35,81,12
"10292","200912140sfo","San Francisco 49ers",24,"Arizona Cardinals",9,33,15,TRUE,"12/14/2009",2009,"December","2000s",52,87,6
"10293","200912170jax","Jacksonville Jaguars",31,"Indianapolis Colts",35,66,-4,FALSE,"12/17/2009",2009,"December","2000s",60,68,17
"10294","200912190nor","New Orleans Saints",17,"Dallas Cowboys",24,41,-7,FALSE,"12/19/2009",2009,"December","2000s",72,NA,NA
"10295","200912200car","Carolina Panthers",26,"Minnesota Vikings",7,33,19,TRUE,"12/20/2009",2009,"December","2000s",39,66,7
"10296","200912200buf","Buffalo Bills",10,"New England Patriots",17,27,-7,FALSE,"12/20/2009",2009,"December","2000s",26,58,6
"10297","200912200den","Denver Broncos",19,"Oakland Raiders",20,39,-1,FALSE,"12/20/2009",2009,"December","2000s",36,42,8
"10298","200912200phi","Philadelphia Eagles",27,"San Francisco 49ers",13,40,14,TRUE,"12/20/2009",2009,"December","2000s",28,66,17
"10299","200912200sea","Seattle Seahawks",7,"Tampa Bay Buccaneers",24,31,-17,FALSE,"12/20/2009",2009,"December","2000s",47,94,7
"10300","200912200oti","Tennessee Titans",27,"Miami Dolphins",24,51,3,TRUE,"12/20/2009",2009,"December","2000s",35,76,9
"10301","200912200ram","St. Louis Rams",13,"Houston Texans",16,29,-3,FALSE,"12/20/2009",2009,"December","2000s",72,NA,NA
"10302","200912200pit","Pittsburgh Steelers",37,"Green Bay Packers",36,73,1,TRUE,"12/20/2009",2009,"December","2000s",24,77,8
"10303","200912200nyj","New York Jets",7,"Atlanta Falcons",10,17,-3,FALSE,"12/20/2009",2009,"December","2000s",27,62,21
"10304","200912200rav","Baltimore Ravens",31,"Chicago Bears",7,38,24,TRUE,"12/20/2009",2009,"December","2000s",28,68,12
"10305","200912200sdg","San Diego Chargers",27,"Cincinnati Bengals",24,51,3,TRUE,"12/20/2009",2009,"December","2000s",61,42,3
"10306","200912200kan","Kansas City Chiefs",34,"Cleveland Browns",41,75,-7,FALSE,"12/20/2009",2009,"December","2000s",31,82,11
"10307","200912200det","Detroit Lions",24,"Arizona Cardinals",31,55,-7,FALSE,"12/20/2009",2009,"December","2000s",72,NA,NA
"10308","200912210was","Washington Redskins",12,"New York Giants",45,57,-33,FALSE,"12/21/2009",2009,"December","2000s",33,54,10
"10309","200912250oti","Tennessee Titans",17,"San Diego Chargers",42,59,-25,FALSE,"12/25/2009",2009,"December","2000s",46,75,20
"10310","200912270cle","Cleveland Browns",23,"Oakland Raiders",9,32,14,TRUE,"12/27/2009",2009,"December","2000s",33,66,7
"10311","200912270crd","Arizona Cardinals",31,"St. Louis Rams",10,41,21,TRUE,"12/27/2009",2009,"December","2000s",72,NA,NA
"10312","200912270pit","Pittsburgh Steelers",23,"Baltimore Ravens",20,43,3,TRUE,"12/27/2009",2009,"December","2000s",35,57,8
"10313","200912270gnb","Green Bay Packers",48,"Seattle Seahawks",10,58,38,TRUE,"12/27/2009",2009,"December","2000s",18,90,5
"10314","200912270nor","New Orleans Saints",17,"Tampa Bay Buccaneers",20,37,-3,FALSE,"12/27/2009",2009,"December","2000s",72,NA,NA
"10315","200912270clt","Indianapolis Colts",15,"New York Jets",29,44,-14,FALSE,"12/27/2009",2009,"December","2000s",72,NA,NA
"10316","200912270cin","Cincinnati Bengals",17,"Kansas City Chiefs",10,27,7,TRUE,"12/27/2009",2009,"December","2000s",34,61,11
"10317","200912270was","Washington Redskins",0,"Dallas Cowboys",17,17,-17,FALSE,"12/27/2009",2009,"December","2000s",42,75,6
"10318","200912270nwe","New England Patriots",35,"Jacksonville Jaguars",7,42,28,TRUE,"12/27/2009",2009,"December","2000s",46,88,18
"10319","200912270mia","Miami Dolphins",20,"Houston Texans",27,47,-7,FALSE,"12/27/2009",2009,"December","2000s",67,73,5
"10320","200912270sfo","San Francisco 49ers",20,"Detroit Lions",6,26,14,TRUE,"12/27/2009",2009,"December","2000s",50,91,6
"10321","200912270phi","Philadelphia Eagles",30,"Denver Broncos",27,57,3,TRUE,"12/27/2009",2009,"December","2000s",48,67,11
"10322","200912270atl","Atlanta Falcons",31,"Buffalo Bills",3,34,28,TRUE,"12/27/2009",2009,"December","2000s",72,NA,NA
"10323","200912270nyg","New York Giants",9,"Carolina Panthers",41,50,-32,FALSE,"12/27/2009",2009,"December","2000s",49,73,17
"10324","200912280chi","Chicago Bears",36,"Minnesota Vikings",30,66,6,TRUE,"12/28/2009",2009,"December","2000s",23,78,16
"10325","201001030min","Minnesota Vikings",44,"New York Giants",7,51,37,TRUE,"1/3/2010",2010,"January","2010s",72,NA,NA
"10326","201001030sea","Seattle Seahawks",13,"Tennessee Titans",17,30,-4,FALSE,"1/3/2010",2010,"January","2010s",44,91,8
"10327","201001030dal","Dallas Cowboys",24,"Philadelphia Eagles",0,24,24,TRUE,"1/3/2010",2010,"January","2010s",39,NA,8
"10328","201001030mia","Miami Dolphins",24,"Pittsburgh Steelers",30,54,-6,FALSE,"1/3/2010",2010,"January","2010s",54,50,8
"10329","201001030rai","Oakland Raiders",13,"Baltimore Ravens",21,34,-8,FALSE,"1/3/2010",2010,"January","2010s",49,85,5
"10330","201001030ram","St. Louis Rams",6,"San Francisco 49ers",28,34,-22,FALSE,"1/3/2010",2010,"January","2010s",72,NA,NA
"10331","201001030sdg","San Diego Chargers",23,"Washington Redskins",20,43,3,TRUE,"1/3/2010",2010,"January","2010s",60,39,4
"10332","201001030htx","Houston Texans",34,"New England Patriots",27,61,7,TRUE,"1/3/2010",2010,"January","2010s",72,NA,NA
"10333","201001030car","Carolina Panthers",23,"New Orleans Saints",10,33,13,TRUE,"1/3/2010",2010,"January","2010s",24,42,8
"10334","201001030den","Denver Broncos",24,"Kansas City Chiefs",44,68,-20,FALSE,"1/3/2010",2010,"January","2010s",31,72,6
"10335","201001030cle","Cleveland Browns",23,"Jacksonville Jaguars",17,40,6,TRUE,"1/3/2010",2010,"January","2010s",14,67,17
"10336","201001030crd","Arizona Cardinals",7,"Green Bay Packers",33,40,-26,FALSE,"1/3/2010",2010,"January","2010s",72,NA,NA
"10337","201001030buf","Buffalo Bills",30,"Indianapolis Colts",7,37,23,TRUE,"1/3/2010",2010,"January","2010s",11,84,13
"10338","201001030nyj","New York Jets",37,"Cincinnati Bengals",0,37,37,TRUE,"1/3/2010",2010,"January","2010s",20,60,27
"10339","201001030det","Detroit Lions",23,"Chicago Bears",37,60,-14,FALSE,"1/3/2010",2010,"January","2010s",72,NA,NA
"10340","201001030tam","Tampa Bay Buccaneers",10,"Atlanta Falcons",20,30,-10,FALSE,"1/3/2010",2010,"January","2010s",42,50,9
"10341","201001090dal","Dallas Cowboys",34,"Philadelphia Eagles",14,48,20,TRUE,"1/9/2010",2010,"January","2010s",23,NA,6
"10342","201001090cin","Cincinnati Bengals",14,"New York Jets",24,38,-10,FALSE,"1/9/2010",2010,"January","2010s",19,82,9
"10343","201001100crd","Arizona Cardinals",51,"Green Bay Packers",45,96,6,TRUE,"1/10/2010",2010,"January","2010s",72,NA,NA
"10344","201001100nwe","New England Patriots",14,"Baltimore Ravens",33,47,-19,FALSE,"1/10/2010",2010,"January","2010s",17,37,15
"10345","201001160clt","Indianapolis Colts",20,"Baltimore Ravens",3,23,17,TRUE,"1/16/2010",2010,"January","2010s",72,NA,NA
"10346","201001160nor","New Orleans Saints",45,"Arizona Cardinals",14,59,31,TRUE,"1/16/2010",2010,"January","2010s",72,NA,NA
"10347","201001170min","Minnesota Vikings",34,"Dallas Cowboys",3,37,31,TRUE,"1/17/2010",2010,"January","2010s",72,NA,NA
"10348","201001170sdg","San Diego Chargers",14,"New York Jets",17,31,-3,FALSE,"1/17/2010",2010,"January","2010s",58,68,4
"10349","201001240nor","New Orleans Saints",31,"Minnesota Vikings",28,59,3,TRUE,"1/24/2010",2010,"January","2010s",72,NA,NA
"10350","201001240clt","Indianapolis Colts",30,"New York Jets",17,47,13,TRUE,"1/24/2010",2010,"January","2010s",72,NA,NA
"10351","201002070clt","Indianapolis Colts",17,"New Orleans Saints",31,48,-14,FALSE,"2/7/2010",2010,"Feburary","2010s",61,63,10
"10352","201009120pit","Pittsburgh Steelers",15,"Atlanta Falcons",9,24,6,TRUE,"9/12/2010",2010,"September","2010s",65,67,9
"10353","201009120oti","Tennessee Titans",38,"Oakland Raiders",13,51,25,TRUE,"9/12/2010",2010,"September","2010s",77,45,9
"10354","201009120buf","Buffalo Bills",10,"Miami Dolphins",15,25,-5,FALSE,"9/12/2010",2010,"September","2010s",62,81,7
"10355","201009120phi","Philadelphia Eagles",20,"Green Bay Packers",27,47,-7,FALSE,"9/12/2010",2010,"September","2010s",69,72,4
"10356","201009120chi","Chicago Bears",19,"Detroit Lions",14,33,5,TRUE,"9/12/2010",2010,"September","2010s",75,45,1
"10357","201009120jax","Jacksonville Jaguars",24,"Denver Broncos",17,41,7,TRUE,"9/12/2010",2010,"September","2010s",90,67,1
"10358","201009120was","Washington Redskins",13,"Dallas Cowboys",7,20,6,TRUE,"9/12/2010",2010,"September","2010s",66,85,2
"10359","201009120htx","Houston Texans",34,"Indianapolis Colts",24,58,10,TRUE,"9/12/2010",2010,"September","2010s",89,NA,5
"10360","201009120tam","Tampa Bay Buccaneers",17,"Cleveland Browns",14,31,3,TRUE,"9/12/2010",2010,"September","2010s",87,78,6
"10361","201009120nyg","New York Giants",31,"Carolina Panthers",18,49,13,TRUE,"9/12/2010",2010,"September","2010s",64,67,1
"10362","201009130kan","Kansas City Chiefs",21,"San Diego Chargers",14,35,7,TRUE,"9/13/2010",2010,"September","2010s",78,75,1
"10363","201009130nyj","New York Jets",9,"Baltimore Ravens",10,19,-1,FALSE,"9/13/2010",2010,"September","2010s",67,100,1
"10364","201009190clt","Indianapolis Colts",38,"New York Giants",14,52,24,TRUE,"9/19/2010",2010,"September","2010s",74,NA,3
"10365","201009190oti","Tennessee Titans",11,"Pittsburgh Steelers",19,30,-8,FALSE,"9/19/2010",2010,"September","2010s",87,49,3
"10366","201009190rai","Oakland Raiders",16,"St. Louis Rams",14,30,2,TRUE,"9/19/2010",2010,"September","2010s",72,60,6
"10367","201009190cin","Cincinnati Bengals",15,"Baltimore Ravens",10,25,5,TRUE,"9/19/2010",2010,"September","2010s",78,52,1
"10368","201009190den","Denver Broncos",31,"Seattle Seahawks",14,45,17,TRUE,"9/19/2010",2010,"September","2010s",91,4,9
"10369","201009190car","Carolina Panthers",7,"Tampa Bay Buccaneers",20,27,-13,FALSE,"9/19/2010",2010,"September","2010s",89,39,4
"10370","201009190nyj","New York Jets",28,"New England Patriots",14,42,14,TRUE,"9/19/2010",2010,"September","2010s",81,36,6
"10371","201009190cle","Cleveland Browns",14,"Kansas City Chiefs",16,30,-2,FALSE,"9/19/2010",2010,"September","2010s",65,0,1
"10372","201009190sdg","San Diego Chargers",38,"Jacksonville Jaguars",13,51,25,TRUE,"9/19/2010",2010,"September","2010s",76,63,8
"10373","201009190was","Washington Redskins",27,"Houston Texans",30,57,-3,FALSE,"9/19/2010",2010,"September","2010s",85,43,6
"10374","201009190gnb","Green Bay Packers",34,"Buffalo Bills",7,41,27,TRUE,"9/19/2010",2010,"September","2010s",58,51,4
"10375","201009200sfo","San Francisco 49ers",22,"New Orleans Saints",25,47,-3,FALSE,"9/20/2010",2010,"September","2010s",65,60,1
"10376","201009260nyg","New York Giants",10,"Tennessee Titans",29,39,-19,FALSE,"9/26/2010",2010,"September","2010s",70,48,3
"10377","201009260jax","Jacksonville Jaguars",3,"Philadelphia Eagles",28,31,-25,FALSE,"9/26/2010",2010,"September","2010s",89,67,5
"10378","201009260tam","Tampa Bay Buccaneers",13,"Pittsburgh Steelers",38,51,-25,FALSE,"9/26/2010",2010,"September","2010s",90,62,7
"10379","201009260kan","Kansas City Chiefs",31,"San Francisco 49ers",10,41,21,TRUE,"9/26/2010",2010,"September","2010s",55,72,1
"10380","201009260mia","Miami Dolphins",23,"New York Jets",31,54,-8,FALSE,"9/26/2010",2010,"September","2010s",83,77,9
"10381","201009260htx","Houston Texans",13,"Dallas Cowboys",27,40,-14,FALSE,"9/26/2010",2010,"September","2010s",81,NA,8
"10382","201009260den","Denver Broncos",13,"Indianapolis Colts",27,40,-14,FALSE,"9/26/2010",2010,"September","2010s",85,12,6
"10383","201009260rav","Baltimore Ravens",24,"Cleveland Browns",17,41,7,TRUE,"9/26/2010",2010,"September","2010s",64,83,6
"10384","201009260car","Carolina Panthers",7,"Cincinnati Bengals",20,27,-13,FALSE,"9/26/2010",2010,"September","2010s",67,86,8
"10385","201009270chi","Chicago Bears",20,"Green Bay Packers",17,37,3,TRUE,"9/27/2010",2010,"September","2010s",56,75,6
"10386","201010030phi","Philadelphia Eagles",12,"Washington Redskins",17,29,-5,FALSE,"10/3/2010",2010,"October","2010s",63,57,1
"10387","201010030pit","Pittsburgh Steelers",14,"Baltimore Ravens",17,31,-3,FALSE,"10/3/2010",2010,"October","2010s",52,86,5
"10388","201010030buf","Buffalo Bills",14,"New York Jets",38,52,-24,FALSE,"10/3/2010",2010,"October","2010s",51,66,1
"10389","201010030rai","Oakland Raiders",24,"Houston Texans",31,55,-7,FALSE,"10/3/2010",2010,"October","2010s",71,53,1
"10390","201010030gnb","Green Bay Packers",28,"Detroit Lions",26,54,2,TRUE,"10/3/2010",2010,"October","2010s",52,61,8
"10391","201010030oti","Tennessee Titans",20,"Denver Broncos",26,46,-6,FALSE,"10/3/2010",2010,"October","2010s",54,67,1
"10392","201010030nyg","New York Giants",17,"Chicago Bears",3,20,14,TRUE,"10/3/2010",2010,"October","2010s",59,52,1
"10393","201010030jax","Jacksonville Jaguars",31,"Indianapolis Colts",28,59,3,TRUE,"10/3/2010",2010,"October","2010s",80,30,1
"10394","201010030sdg","San Diego Chargers",41,"Arizona Cardinals",10,51,31,TRUE,"10/3/2010",2010,"October","2010s",72,67,8
"10395","201010040mia","Miami Dolphins",14,"New England Patriots",41,55,-27,FALSE,"10/4/2010",2010,"October","2010s",80,60,1
"10396","201010100htx","Houston Texans",10,"New York Giants",34,44,-24,FALSE,"10/10/2010",2010,"October","2010s",78,NA,6
"10397","201010100sfo","San Francisco 49ers",24,"Philadelphia Eagles",27,51,-3,FALSE,"10/10/2010",2010,"October","2010s",71,51,1
"10398","201010100cin","Cincinnati Bengals",21,"Tampa Bay Buccaneers",24,45,-3,FALSE,"10/10/2010",2010,"October","2010s",81,32,2
"10399","201010100clt","Indianapolis Colts",19,"Kansas City Chiefs",9,28,10,TRUE,"10/10/2010",2010,"October","2010s",83,NA,NA
"10400","201010100buf","Buffalo Bills",26,"Jacksonville Jaguars",36,62,-10,FALSE,"10/10/2010",2010,"October","2010s",62,52,1
"10401","201010100was","Washington Redskins",16,"Green Bay Packers",13,29,3,TRUE,"10/10/2010",2010,"October","2010s",72,46,NA
"10402","201010100rav","Baltimore Ravens",31,"Denver Broncos",17,48,14,TRUE,"10/10/2010",2010,"October","2010s",67,40,6
"10403","201010100car","Carolina Panthers",6,"Chicago Bears",23,29,-17,FALSE,"10/10/2010",2010,"October","2010s",81,29,2
"10404","201010110nyj","New York Jets",29,"Minnesota Vikings",20,49,9,TRUE,"10/11/2010",2010,"October","2010s",72,56,1
"10405","201010170chi","Chicago Bears",20,"Seattle Seahawks",23,43,-3,FALSE,"10/17/2010",2010,"October","2010s",61,49,9
"10406","201010170sfo","San Francisco 49ers",17,"Oakland Raiders",9,26,8,TRUE,"10/17/2010",2010,"October","2010s",53,72,1
"10407","201010170den","Denver Broncos",20,"New York Jets",24,44,-4,FALSE,"10/17/2010",2010,"October","2010s",73,13,4
"10408","201010170tam","Tampa Bay Buccaneers",6,"New Orleans Saints",31,37,-25,FALSE,"10/17/2010",2010,"October","2010s",81,48,9
"10409","201010170gnb","Green Bay Packers",20,"Miami Dolphins",23,43,-3,FALSE,"10/17/2010",2010,"October","2010s",57,45,1
"10410","201010170htx","Houston Texans",35,"Kansas City Chiefs",31,66,4,TRUE,"10/17/2010",2010,"October","2010s",78,NA,3
"10411","201010170nyg","New York Giants",28,"Detroit Lions",20,48,8,TRUE,"10/17/2010",2010,"October","2010s",63,44,9
"10412","201010170phi","Philadelphia Eagles",31,"Atlanta Falcons",17,48,14,TRUE,"10/17/2010",2010,"October","2010s",66,45,1
"10413","201010170pit","Pittsburgh Steelers",28,"Cleveland Browns",10,38,18,TRUE,"10/17/2010",2010,"October","2010s",61,48,1
"10414","201010170was","Washington Redskins",24,"Indianapolis Colts",27,51,-3,FALSE,"10/17/2010",2010,"October","2010s",70,46,7
"10415","201010180jax","Jacksonville Jaguars",3,"Tennessee Titans",30,33,-27,FALSE,"10/18/2010",2010,"October","2010s",0,0,NA
"10416","201010240mia","Miami Dolphins",22,"Pittsburgh Steelers",23,45,-1,FALSE,"10/24/2010",2010,"October","2010s",80,84,1
"10417","201010240sdg","San Diego Chargers",20,"New England Patriots",23,43,-3,FALSE,"10/24/2010",2010,"October","2010s",69,68,7
"10418","201010240rav","Baltimore Ravens",37,"Buffalo Bills",34,71,3,TRUE,"10/24/2010",2010,"October","2010s",70,52,5
"10419","201010240car","Carolina Panthers",23,"San Francisco 49ers",20,43,3,TRUE,"10/24/2010",2010,"October","2010s",75,57,9
"10420","201010240tam","Tampa Bay Buccaneers",18,"St. Louis Rams",17,35,1,TRUE,"10/24/2010",2010,"October","2010s",84,62,9
"10421","201010240den","Denver Broncos",14,"Oakland Raiders",59,73,-45,FALSE,"10/24/2010",2010,"October","2010s",63,23,9
"10422","201010240gnb","Green Bay Packers",28,"Minnesota Vikings",24,52,4,TRUE,"10/24/2010",2010,"October","2010s",58,96,4
"10423","201010240kan","Kansas City Chiefs",42,"Jacksonville Jaguars",20,62,22,TRUE,"10/24/2010",2010,"October","2010s",63,80,1
"10424","201010240chi","Chicago Bears",14,"Washington Redskins",17,31,-3,FALSE,"10/24/2010",2010,"October","2010s",67,65,1
"10425","201010240oti","Tennessee Titans",37,"Philadelphia Eagles",19,56,18,TRUE,"10/24/2010",2010,"October","2010s",78,39,2
"10426","201010250dal","Dallas Cowboys",35,"New York Giants",41,76,-6,FALSE,"10/25/2010",2010,"October","2010s",84,NA,2
"10427","201010310cin","Cincinnati Bengals",14,"Miami Dolphins",22,36,-8,FALSE,"10/31/2010",2010,"October","2010s",54,57,1
"10428","201010310kan","Kansas City Chiefs",13,"Buffalo Bills",10,23,3,TRUE,"10/31/2010",2010,"October","2010s",51,60,1
"10429","201010310sdg","San Diego Chargers",33,"Tennessee Titans",25,58,8,TRUE,"10/31/2010",2010,"October","2010s",65,65,1
"10430","201010310nyj","New York Jets",0,"Green Bay Packers",9,9,-9,FALSE,"10/31/2010",2010,"October","2010s",57,41,1
"10431","201010310rai","Oakland Raiders",33,"Seattle Seahawks",3,36,30,TRUE,"10/31/2010",2010,"October","2010s",66,60,5
"10432","201011010clt","Indianapolis Colts",30,"Houston Texans",17,47,13,TRUE,"11/1/2010",2010,"November","2010s",47,NA,1
"10433","201011070htx","Houston Texans",23,"San Diego Chargers",29,52,-6,FALSE,"11/7/2010",2010,"November","2010s",63,NA,8
"10434","201011070car","Carolina Panthers",3,"New Orleans Saints",34,37,-31,FALSE,"11/7/2010",2010,"November","2010s",50,33,7
"10435","201011070phi","Philadelphia Eagles",26,"Indianapolis Colts",24,50,2,TRUE,"11/7/2010",2010,"November","2010s",52,34,1
"10436","201011070gnb","Green Bay Packers",45,"Dallas Cowboys",7,52,38,TRUE,"11/7/2010",2010,"November","2010s",43,62,3
"10437","201011070rai","Oakland Raiders",23,"Kansas City Chiefs",20,43,3,TRUE,"11/7/2010",2010,"November","2010s",62,82,9
"10438","201011070rav","Baltimore Ravens",26,"Miami Dolphins",10,36,16,TRUE,"11/7/2010",2010,"November","2010s",50,38,1
"10439","201011080cin","Cincinnati Bengals",21,"Pittsburgh Steelers",27,48,-6,FALSE,"11/8/2010",2010,"November","2010s",44,65,2
"10440","201011140sfo","San Francisco 49ers",23,"St. Louis Rams",20,43,3,TRUE,"11/14/2010",2010,"November","2010s",74,50,5
"10441","201011140mia","Miami Dolphins",29,"Tennessee Titans",17,46,12,TRUE,"11/14/2010",2010,"November","2010s",79,46,9
"10442","201011140cle","Cleveland Browns",20,"New York Jets",26,46,-6,FALSE,"11/14/2010",2010,"November","2010s",46,77,1
"10443","201011140pit","Pittsburgh Steelers",26,"New England Patriots",39,65,-13,FALSE,"11/14/2010",2010,"November","2010s",49,86,8
"10444","201011140chi","Chicago Bears",27,"Minnesota Vikings",13,40,14,TRUE,"11/14/2010",2010,"November","2010s",44,57,2
"10445","201011140den","Denver Broncos",49,"Kansas City Chiefs",29,78,20,TRUE,"11/14/2010",2010,"November","2010s",43,34,6
"10446","201011140tam","Tampa Bay Buccaneers",31,"Carolina Panthers",16,47,15,TRUE,"11/14/2010",2010,"November","2010s",73,57,7
"10447","201011140clt","Indianapolis Colts",23,"Cincinnati Bengals",17,40,6,TRUE,"11/14/2010",2010,"November","2010s",46,NA,1
"10448","201011140nyg","New York Giants",20,"Dallas Cowboys",33,53,-13,FALSE,"11/14/2010",2010,"November","2010s",60,45,8
"10449","201011140buf","Buffalo Bills",14,"Detroit Lions",12,26,2,TRUE,"11/14/2010",2010,"November","2010s",58,36,1
"10450","201011140jax","Jacksonville Jaguars",31,"Houston Texans",24,55,7,TRUE,"11/14/2010",2010,"November","2010s",70,50,5
"10451","201011150was","Washington Redskins",28,"Philadelphia Eagles",59,87,-31,FALSE,"11/15/2010",2010,"November","2010s",52,67,3
"10452","201011180mia","Miami Dolphins",0,"Chicago Bears",16,16,-16,FALSE,"11/18/2010",2010,"November","2010s",75,77,8
"10453","201011210phi","Philadelphia Eagles",27,"New York Giants",17,44,10,TRUE,"11/21/2010",2010,"November","2010s",45,68,7
"10454","201011210pit","Pittsburgh Steelers",35,"Oakland Raiders",3,38,32,TRUE,"11/21/2010",2010,"November","2010s",57,62,9
"10455","201011210car","Carolina Panthers",13,"Baltimore Ravens",37,50,-24,FALSE,"11/21/2010",2010,"November","2010s",65,43,6
"10456","201011210sfo","San Francisco 49ers",0,"Tampa Bay Buccaneers",21,21,-21,FALSE,"11/21/2010",2010,"November","2010s",54,65,2
"10457","201011210oti","Tennessee Titans",16,"Washington Redskins",19,35,-3,FALSE,"11/21/2010",2010,"November","2010s",66,53,1
"10458","201011210nyj","New York Jets",30,"Houston Texans",27,57,3,TRUE,"11/21/2010",2010,"November","2010s",46,37,1
"10459","201011210kan","Kansas City Chiefs",31,"Arizona Cardinals",13,44,18,TRUE,"11/21/2010",2010,"November","2010s",66,65,2
"10460","201011210jax","Jacksonville Jaguars",24,"Cleveland Browns",20,44,4,TRUE,"11/21/2010",2010,"November","2010s",0,0,NA
"10461","201011210cin","Cincinnati Bengals",31,"Buffalo Bills",49,80,-18,FALSE,"11/21/2010",2010,"November","2010s",65,56,1
"10462","201011220sdg","San Diego Chargers",35,"Denver Broncos",14,49,21,TRUE,"11/22/2010",2010,"November","2010s",55,69,5
"10463","201011250nyj","New York Jets",26,"Cincinnati Bengals",10,36,16,TRUE,"11/25/2010",2010,"November","2010s",39,87,6
"10464","201011280rav","Baltimore Ravens",17,"Tampa Bay Buccaneers",10,27,7,TRUE,"11/28/2010",2010,"November","2010s",48,37,3
"10465","201011280clt","Indianapolis Colts",14,"San Diego Chargers",36,50,-22,FALSE,"11/28/2010",2010,"November","2010s",38,NA,8
"10466","201011280den","Denver Broncos",33,"St. Louis Rams",36,69,-3,FALSE,"11/28/2010",2010,"November","2010s",45,23,1
"10467","201011280buf","Buffalo Bills",16,"Pittsburgh Steelers",19,35,-3,FALSE,"11/28/2010",2010,"November","2010s",36,78,1
"10468","201011280chi","Chicago Bears",31,"Philadelphia Eagles",26,57,5,TRUE,"11/28/2010",2010,"November","2010s",45,57,1
"10469","201011280htx","Houston Texans",20,"Tennessee Titans",0,20,20,TRUE,"11/28/2010",2010,"November","2010s",58,NA,5
"10470","201011280was","Washington Redskins",13,"Minnesota Vikings",17,30,-4,FALSE,"11/28/2010",2010,"November","2010s",47,44,5
"10471","201011280rai","Oakland Raiders",17,"Miami Dolphins",33,50,-16,FALSE,"11/28/2010",2010,"November","2010s",54,49,1
"10472","201011280nyg","New York Giants",24,"Jacksonville Jaguars",20,44,4,TRUE,"11/28/2010",2010,"November","2010s",43,43,6
"10473","201012020phi","Philadelphia Eagles",34,"Houston Texans",24,58,10,TRUE,"12/2/2010",2010,"December","2010s",36,55,5
"10474","201012050nyg","New York Giants",31,"Washington Redskins",7,38,24,TRUE,"12/5/2010",2010,"December","2010s",33,51,1
"10475","201012050crd","Arizona Cardinals",6,"St. Louis Rams",19,25,-13,FALSE,"12/5/2010",2010,"December","2010s",67,NA,NA
"10476","201012050sdg","San Diego Chargers",13,"Oakland Raiders",28,41,-15,FALSE,"12/5/2010",2010,"December","2010s",67,39,5
"10477","201012050rav","Baltimore Ravens",10,"Pittsburgh Steelers",13,23,-3,FALSE,"12/5/2010",2010,"December","2010s",35,48,NA
"10478","201012050cin","Cincinnati Bengals",30,"New Orleans Saints",34,64,-4,FALSE,"12/5/2010",2010,"December","2010s",32,68,1
"10479","201012050oti","Tennessee Titans",6,"Jacksonville Jaguars",17,23,-11,FALSE,"12/5/2010",2010,"December","2010s",35,70,1
"10480","201012050gnb","Green Bay Packers",34,"San Francisco 49ers",16,50,18,TRUE,"12/5/2010",2010,"December","2010s",26,60,1
"10481","201012050kan","Kansas City Chiefs",10,"Denver Broncos",6,16,4,TRUE,"12/5/2010",2010,"December","2010s",26,55,8
"10482","201012050tam","Tampa Bay Buccaneers",24,"Atlanta Falcons",28,52,-4,FALSE,"12/5/2010",2010,"December","2010s",72,53,9
"10483","201012050mia","Miami Dolphins",10,"Cleveland Browns",13,23,-3,FALSE,"12/5/2010",2010,"December","2010s",76,52,1
"10484","201012050clt","Indianapolis Colts",35,"Dallas Cowboys",38,73,-3,FALSE,"12/5/2010",2010,"December","2010s",25,NA,1
"10485","201012090oti","Tennessee Titans",28,"Indianapolis Colts",30,58,-2,FALSE,"12/9/2010",2010,"December","2010s",35,46,6
"10486","201012120jax","Jacksonville Jaguars",38,"Oakland Raiders",31,69,7,TRUE,"12/12/2010",2010,"December","2010s",54,86,1
"10487","201012120sfo","San Francisco 49ers",40,"Seattle Seahawks",21,61,19,TRUE,"12/12/2010",2010,"December","2010s",55,90,3
"10488","201012120was","Washington Redskins",16,"Tampa Bay Buccaneers",17,33,-1,FALSE,"12/12/2010",2010,"December","2010s",43,96,5
"10489","201012120chi","Chicago Bears",7,"New England Patriots",36,43,-29,FALSE,"12/12/2010",2010,"December","2010s",26,81,3
"10490","201012120nyj","New York Jets",6,"Miami Dolphins",10,16,-4,FALSE,"12/12/2010",2010,"December","2010s",53,83,8
"10491","201012120sdg","San Diego Chargers",31,"Kansas City Chiefs",0,31,31,TRUE,"12/12/2010",2010,"December","2010s",86,22,5
"10492","201012120car","Carolina Panthers",10,"Atlanta Falcons",31,41,-21,FALSE,"12/12/2010",2010,"December","2010s",44,94,1
"10493","201012120pit","Pittsburgh Steelers",23,"Cincinnati Bengals",7,30,16,TRUE,"12/12/2010",2010,"December","2010s",37,89,8
"10494","201012120buf","Buffalo Bills",13,"Cleveland Browns",6,19,7,TRUE,"12/12/2010",2010,"December","2010s",36,95,6
"10495","201012130htx","Houston Texans",28,"Baltimore Ravens",34,62,-6,FALSE,"12/13/2010",2010,"December","2010s",0,NA,NA
"10496","201012160sdg","San Diego Chargers",34,"San Francisco 49ers",7,41,27,TRUE,"12/16/2010",2010,"December","2010s",56,69,7
"10497","201012190clt","Indianapolis Colts",34,"Jacksonville Jaguars",24,58,10,TRUE,"12/19/2010",2010,"December","2010s",26,NA,6
"10498","201012190rav","Baltimore Ravens",30,"New Orleans Saints",24,54,6,TRUE,"12/19/2010",2010,"December","2010s",34,40,1
"10499","201012190pit","Pittsburgh Steelers",17,"New York Jets",22,39,-5,FALSE,"12/19/2010",2010,"December","2010s",25,62,9
"10500","201012190nyg","New York Giants",31,"Philadelphia Eagles",38,69,-7,FALSE,"12/19/2010",2010,"December","2010s",33,58,6
"10501","201012190dal","Dallas Cowboys",33,"Washington Redskins",30,63,3,TRUE,"12/19/2010",2010,"December","2010s",51,NA,NA
"10502","201012190oti","Tennessee Titans",31,"Houston Texans",17,48,14,TRUE,"12/19/2010",2010,"December","2010s",36,56,4
"10503","201012190tam","Tampa Bay Buccaneers",20,"Detroit Lions",23,43,-3,FALSE,"12/19/2010",2010,"December","2010s",54,96,1
"10504","201012190car","Carolina Panthers",19,"Arizona Cardinals",12,31,7,TRUE,"12/19/2010",2010,"December","2010s",42,57,6
"10505","201012190cin","Cincinnati Bengals",19,"Cleveland Browns",17,36,2,TRUE,"12/19/2010",2010,"December","2010s",28,59,8
"10506","201012190mia","Miami Dolphins",14,"Buffalo Bills",17,31,-3,FALSE,"12/19/2010",2010,"December","2010s",67,74,1
"10507","201012200min","Minnesota Vikings",14,"Chicago Bears",40,54,-26,FALSE,"12/20/2010",2010,"December","2010s",23,NA,1
"10508","201012230pit","Pittsburgh Steelers",27,"Carolina Panthers",3,30,24,TRUE,"12/23/2010",2010,"December","2010s",27,70,1
"10509","201012250crd","Arizona Cardinals",27,"Dallas Cowboys",26,53,1,TRUE,"12/25/2010",2010,"December","2010s",64,NA,7
"10510","201012260jax","Jacksonville Jaguars",17,"Washington Redskins",20,37,-3,FALSE,"12/26/2010",2010,"December","2010s",38,64,NA
"10511","201012260tam","Tampa Bay Buccaneers",38,"Seattle Seahawks",15,53,23,TRUE,"12/26/2010",2010,"December","2010s",49,56,1
"10512","201012260cin","Cincinnati Bengals",34,"San Diego Chargers",20,54,14,TRUE,"12/26/2010",2010,"December","2010s",29,62,1
"10513","201012260cle","Cleveland Browns",10,"Baltimore Ravens",20,30,-10,FALSE,"12/26/2010",2010,"December","2010s",26,73,1
"10514","201012260kan","Kansas City Chiefs",34,"Tennessee Titans",14,48,20,TRUE,"12/26/2010",2010,"December","2010s",19,77,7
"10515","201012260chi","Chicago Bears",38,"New York Jets",34,72,4,TRUE,"12/26/2010",2010,"December","2010s",33,85,9
"10516","201012260gnb","Green Bay Packers",45,"New York Giants",17,62,28,TRUE,"12/26/2010",2010,"December","2010s",25,74,5
"10517","201012260rai","Oakland Raiders",26,"Indianapolis Colts",31,57,-5,FALSE,"12/26/2010",2010,"December","2010s",58,65,5
"10518","201012260mia","Miami Dolphins",27,"Detroit Lions",34,61,-7,FALSE,"12/26/2010",2010,"December","2010s",69,47,2
"10519","201012260den","Denver Broncos",24,"Houston Texans",23,47,1,TRUE,"12/26/2010",2010,"December","2010s",50,18,7
"10520","201012260buf","Buffalo Bills",3,"New England Patriots",34,37,-31,FALSE,"12/26/2010",2010,"December","2010s",22,69,1
"10521","201012280phi","Philadelphia Eagles",14,"Minnesota Vikings",24,38,-10,FALSE,"12/28/2010",2010,"December","2010s",32,46,1
"10522","201101020was","Washington Redskins",14,"New York Giants",17,31,-3,FALSE,"1/2/2011",2011,"January","2010s",37,79,7
"10523","201101020clt","Indianapolis Colts",23,"Tennessee Titans",20,43,3,TRUE,"1/2/2011",2011,"January","2010s",28,NA,1
"10524","201101020cle","Cleveland Browns",9,"Pittsburgh Steelers",41,50,-32,FALSE,"1/2/2011",2011,"January","2010s",25,51,1
"10525","201101020kan","Kansas City Chiefs",10,"Oakland Raiders",31,41,-21,FALSE,"1/2/2011",2011,"January","2010s",30,40,1
"10526","201101020den","Denver Broncos",28,"San Diego Chargers",33,61,-5,FALSE,"1/2/2011",2011,"January","2010s",42,22,4
"10527","201101020nwe","New England Patriots",38,"Miami Dolphins",7,45,31,TRUE,"1/2/2011",2011,"January","2010s",47,91,5
"10528","201101020nyj","New York Jets",38,"Buffalo Bills",7,45,31,TRUE,"1/2/2011",2011,"January","2010s",48,78,5
"10529","201101020gnb","Green Bay Packers",10,"Chicago Bears",3,13,7,TRUE,"1/2/2011",2011,"January","2010s",19,49,1
"10530","201101020rav","Baltimore Ravens",13,"Cincinnati Bengals",7,20,6,TRUE,"1/2/2011",2011,"January","2010s",51,73,7
"10531","201101020sfo","San Francisco 49ers",38,"Arizona Cardinals",7,45,31,TRUE,"1/2/2011",2011,"January","2010s",49,85,3
"10532","201101020phi","Philadelphia Eagles",13,"Dallas Cowboys",14,27,-1,FALSE,"1/2/2011",2011,"January","2010s",40,66,1
"10533","201101020htx","Houston Texans",34,"Jacksonville Jaguars",17,51,17,TRUE,"1/2/2011",2011,"January","2010s",60,NA,1
"10534","201101080clt","Indianapolis Colts",16,"New York Jets",17,33,-1,FALSE,"1/8/2011",2011,"January","2010s",15,NA,7
"10535","201101090phi","Philadelphia Eagles",16,"Green Bay Packers",21,37,-5,FALSE,"1/9/2011",2011,"January","2010s",30,42,1
"10536","201101090kan","Kansas City Chiefs",7,"Baltimore Ravens",30,37,-23,FALSE,"1/9/2011",2011,"January","2010s",26,53,1
"10537","201101150pit","Pittsburgh Steelers",31,"Baltimore Ravens",24,55,7,TRUE,"1/15/2011",2011,"January","2010s",36,58,1
"10538","201101160chi","Chicago Bears",35,"Seattle Seahawks",24,59,11,TRUE,"1/16/2011",2011,"January","2010s",24,55,4
"10539","201101230chi","Chicago Bears",14,"Green Bay Packers",21,35,-7,FALSE,"1/23/2011",2011,"January","2010s",20,34,1
"10540","201101230pit","Pittsburgh Steelers",24,"New York Jets",19,43,5,TRUE,"1/23/2011",2011,"January","2010s",17,44,1
"10541","201102060gnb","Green Bay Packers",31,"Pittsburgh Steelers",25,56,6,TRUE,"2/6/2011",2011,"Feburary","2010s",72,0,NA
"10542","201109080gnb","Green Bay Packers",42,"New Orleans Saints",34,76,8,TRUE,"9/8/2011",2011,"September","2010s",68,67,5
"10543","201109110sfo","San Francisco 49ers",33,"Seattle Seahawks",17,50,16,TRUE,"9/11/2011",2011,"September","2010s",68,63,1
"10544","201109110was","Washington Redskins",28,"New York Giants",14,42,14,TRUE,"9/11/2011",2011,"September","2010s",87,38,5
"10545","201109110nyj","New York Jets",27,"Dallas Cowboys",24,51,3,TRUE,"9/11/2011",2011,"September","2010s",70,89,6
"10546","201109110sdg","San Diego Chargers",24,"Minnesota Vikings",17,41,7,TRUE,"9/11/2011",2011,"September","2010s",74,52,7
"10547","201109110chi","Chicago Bears",30,"Atlanta Falcons",12,42,18,TRUE,"9/11/2011",2011,"September","2010s",76,57,7
"10548","201109110htx","Houston Texans",34,"Indianapolis Colts",7,41,27,TRUE,"9/11/2011",2011,"September","2010s",84,NA,4
"10549","201109110rav","Baltimore Ravens",35,"Pittsburgh Steelers",7,42,28,TRUE,"9/11/2011",2011,"September","2010s",75,71,2
"10550","201109110kan","Kansas City Chiefs",7,"Buffalo Bills",41,48,-34,FALSE,"9/11/2011",2011,"September","2010s",75,65,NA
"10551","201109110tam","Tampa Bay Buccaneers",20,"Detroit Lions",27,47,-7,FALSE,"9/11/2011",2011,"September","2010s",86,55,6
"10552","201109110jax","Jacksonville Jaguars",16,"Tennessee Titans",14,30,2,TRUE,"9/11/2011",2011,"September","2010s",87,52,5
"10553","201109120mia","Miami Dolphins",24,"New England Patriots",38,62,-14,FALSE,"9/12/2011",2011,"September","2010s",82,73,1
"10554","201109120den","Denver Broncos",20,"Oakland Raiders",23,43,-3,FALSE,"9/12/2011",2011,"September","2010s",75,29,6
"10555","201109180buf","Buffalo Bills",38,"Oakland Raiders",35,73,3,TRUE,"9/18/2011",2011,"September","2010s",65,47,5
"10556","201109180sfo","San Francisco 49ers",24,"Dallas Cowboys",27,51,-3,FALSE,"9/18/2011",2011,"September","2010s",70,60,3
"10557","201109180pit","Pittsburgh Steelers",24,"Seattle Seahawks",0,24,24,TRUE,"9/18/2011",2011,"September","2010s",63,59,1
"10558","201109180mia","Miami Dolphins",13,"Houston Texans",23,36,-10,FALSE,"9/18/2011",2011,"September","2010s",87,59,1
"10559","201109180car","Carolina Panthers",23,"Green Bay Packers",30,53,-7,FALSE,"9/18/2011",2011,"September","2010s",64,67,1
"10560","201109180nor","New Orleans Saints",30,"Chicago Bears",13,43,17,TRUE,"9/18/2011",2011,"September","2010s",80,NA,4
"10561","201109180nyj","New York Jets",32,"Jacksonville Jaguars",3,35,29,TRUE,"9/18/2011",2011,"September","2010s",66,71,1
"10562","201109180clt","Indianapolis Colts",19,"Cleveland Browns",27,46,-8,FALSE,"9/18/2011",2011,"September","2010s",65,NA,9
"10563","201109180was","Washington Redskins",22,"Arizona Cardinals",21,43,1,TRUE,"9/18/2011",2011,"September","2010s",66,71,7
"10564","201109180oti","Tennessee Titans",26,"Baltimore Ravens",13,39,13,TRUE,"9/18/2011",2011,"September","2010s",76,54,1
"10565","201109180den","Denver Broncos",24,"Cincinnati Bengals",22,46,2,TRUE,"9/18/2011",2011,"September","2010s",69,27,6
"10566","201109190nyg","New York Giants",28,"St. Louis Rams",16,44,12,TRUE,"9/19/2011",2011,"September","2010s",60,72,6
"10567","201109250chi","Chicago Bears",17,"Green Bay Packers",27,44,-10,FALSE,"9/25/2011",2011,"September","2010s",61,85,1
"10568","201109250cle","Cleveland Browns",17,"Miami Dolphins",16,33,1,TRUE,"9/25/2011",2011,"September","2010s",70,72,5
"10569","201109250nor","New Orleans Saints",40,"Houston Texans",33,73,7,TRUE,"9/25/2011",2011,"September","2010s",85,NA,8
"10570","201109250cin","Cincinnati Bengals",8,"San Francisco 49ers",13,21,-5,FALSE,"9/25/2011",2011,"September","2010s",71,61,2
"10571","201109250clt","Indianapolis Colts",20,"Pittsburgh Steelers",23,43,-3,FALSE,"9/25/2011",2011,"September","2010s",57,NA,7
"10572","201109250sdg","San Diego Chargers",20,"Kansas City Chiefs",17,37,3,TRUE,"9/25/2011",2011,"September","2010s",67,68,8
"10573","201109250oti","Tennessee Titans",17,"Denver Broncos",14,31,3,TRUE,"9/25/2011",2011,"September","2010s",73,51,1
"10574","201109250tam","Tampa Bay Buccaneers",16,"Atlanta Falcons",13,29,3,TRUE,"9/25/2011",2011,"September","2010s",89,94,9
"10575","201109250buf","Buffalo Bills",34,"New England Patriots",31,65,3,TRUE,"9/25/2011",2011,"September","2010s",78,60,8
"10576","201109250phi","Philadelphia Eagles",16,"New York Giants",29,45,-13,FALSE,"9/25/2011",2011,"September","2010s",76,79,5
"10577","201109250rai","Oakland Raiders",34,"New York Jets",24,58,10,TRUE,"9/25/2011",2011,"September","2010s",70,70,7
"10578","201109250car","Carolina Panthers",16,"Jacksonville Jaguars",10,26,6,TRUE,"9/25/2011",2011,"September","2010s",75,87,4
"10579","201110020rai","Oakland Raiders",19,"New England Patriots",31,50,-12,FALSE,"10/2/2011",2011,"October","2010s",71,50,6
"10580","201110020gnb","Green Bay Packers",49,"Denver Broncos",23,72,26,TRUE,"10/2/2011",2011,"October","2010s",67,37,1
"10581","201110020chi","Chicago Bears",34,"Carolina Panthers",29,63,5,TRUE,"10/2/2011",2011,"October","2010s",60,50,8
"10582","201110020phi","Philadelphia Eagles",23,"San Francisco 49ers",24,47,-1,FALSE,"10/2/2011",2011,"October","2010s",54,78,2
"10583","201110020rav","Baltimore Ravens",34,"New York Jets",17,51,17,TRUE,"10/2/2011",2011,"October","2010s",51,66,6
"10584","201110020cle","Cleveland Browns",13,"Tennessee Titans",31,44,-18,FALSE,"10/2/2011",2011,"October","2010s",48,0,2
"10585","201110020cin","Cincinnati Bengals",23,"Buffalo Bills",20,43,3,TRUE,"10/2/2011",2011,"October","2010s",57,48,1
"10586","201110020kan","Kansas City Chiefs",22,"Minnesota Vikings",17,39,5,TRUE,"10/2/2011",2011,"October","2010s",65,40,7
"10587","201110020htx","Houston Texans",17,"Pittsburgh Steelers",10,27,7,TRUE,"10/2/2011",2011,"October","2010s",75,NA,1
"10588","201110020jax","Jacksonville Jaguars",10,"New Orleans Saints",23,33,-13,FALSE,"10/2/2011",2011,"October","2010s",71,40,5
"10589","201110020sdg","San Diego Chargers",26,"Miami Dolphins",16,42,10,TRUE,"10/2/2011",2011,"October","2010s",84,32,9
"10590","201110090car","Carolina Panthers",27,"New Orleans Saints",30,57,-3,FALSE,"10/9/2011",2011,"October","2010s",68,50,1
"10591","201110090buf","Buffalo Bills",31,"Philadelphia Eagles",24,55,7,TRUE,"10/9/2011",2011,"October","2010s",74,47,6
"10592","201110090pit","Pittsburgh Steelers",38,"Tennessee Titans",17,55,21,TRUE,"10/9/2011",2011,"October","2010s",70,53,3
"10593","201110090jax","Jacksonville Jaguars",20,"Cincinnati Bengals",30,50,-10,FALSE,"10/9/2011",2011,"October","2010s",79,68,1
"10594","201110090nwe","New England Patriots",30,"New York Jets",21,51,9,TRUE,"10/9/2011",2011,"October","2010s",82,40,9
"10595","201110090sfo","San Francisco 49ers",48,"Tampa Bay Buccaneers",3,51,45,TRUE,"10/9/2011",2011,"October","2010s",62,75,6
"10596","201110090den","Denver Broncos",24,"San Diego Chargers",29,53,-5,FALSE,"10/9/2011",2011,"October","2010s",52,45,6
"10597","201110090htx","Houston Texans",20,"Oakland Raiders",25,45,-5,FALSE,"10/9/2011",2011,"October","2010s",72,NA,6
"10598","201110090nyg","New York Giants",25,"Seattle Seahawks",36,61,-11,FALSE,"10/9/2011",2011,"October","2010s",81,42,4
"10599","201110090clt","Indianapolis Colts",24,"Kansas City Chiefs",28,52,-4,FALSE,"10/9/2011",2011,"October","2010s",72,NA,1
"10600","201110160rai","Oakland Raiders",24,"Cleveland Browns",17,41,7,TRUE,"10/16/2011",2011,"October","2010s",71,60,8
"10601","201110160was","Washington Redskins",13,"Philadelphia Eagles",20,33,-7,FALSE,"10/16/2011",2011,"October","2010s",68,26,7
"10602","201110160rav","Baltimore Ravens",29,"Houston Texans",14,43,15,TRUE,"10/16/2011",2011,"October","2010s",72,29,1
"10603","201110160cin","Cincinnati Bengals",27,"Indianapolis Colts",17,44,10,TRUE,"10/16/2011",2011,"October","2010s",71,41,1
"10604","201110160chi","Chicago Bears",39,"Minnesota Vikings",10,49,29,TRUE,"10/16/2011",2011,"October","2010s",56,48,1
"10605","201110160nyg","New York Giants",27,"Buffalo Bills",24,51,3,TRUE,"10/16/2011",2011,"October","2010s",65,40,1
"10606","201110160gnb","Green Bay Packers",24,"St. Louis Rams",3,27,21,TRUE,"10/16/2011",2011,"October","2010s",57,41,2
"10607","201110160pit","Pittsburgh Steelers",17,"Jacksonville Jaguars",13,30,4,TRUE,"10/16/2011",2011,"October","2010s",58,52,1
"10608","201110170nyj","New York Jets",24,"Miami Dolphins",6,30,18,TRUE,"10/17/2011",2011,"October","2010s",62,37,1
"10609","201110230mia","Miami Dolphins",15,"Denver Broncos",18,33,-3,FALSE,"10/23/2011",2011,"October","2010s",77,57,9
"10610","201110230cle","Cleveland Browns",6,"Seattle Seahawks",3,9,3,TRUE,"10/23/2011",2011,"October","2010s",56,53,7
"10611","201110230rai","Oakland Raiders",0,"Kansas City Chiefs",28,28,-28,FALSE,"10/23/2011",2011,"October","2010s",79,46,6
"10612","201110230nyj","New York Jets",27,"San Diego Chargers",21,48,6,TRUE,"10/23/2011",2011,"October","2010s",58,46,NA
"10613","201110230oti","Tennessee Titans",7,"Houston Texans",41,48,-34,FALSE,"10/23/2011",2011,"October","2010s",72,35,NA
"10614","201110230tam","Tampa Bay Buccaneers",18,"Chicago Bears",24,42,-6,FALSE,"10/23/2011",2011,"October","2010s",62,54,1
"10615","201110230nor","New Orleans Saints",62,"Indianapolis Colts",7,69,55,TRUE,"10/23/2011",2011,"October","2010s",75,NA,8
"10616","201110230car","Carolina Panthers",33,"Washington Redskins",20,53,13,TRUE,"10/23/2011",2011,"October","2010s",62,56,NA
"10617","201110240jax","Jacksonville Jaguars",12,"Baltimore Ravens",7,19,5,TRUE,"10/24/2011",2011,"October","2010s",60,77,NA
"10618","201110300sfo","San Francisco 49ers",20,"Cleveland Browns",10,30,10,TRUE,"10/30/2011",2011,"October","2010s",67,68,5
"10619","201110300nyg","New York Giants",20,"Miami Dolphins",17,37,3,TRUE,"10/30/2011",2011,"October","2010s",41,55,1
"10620","201110300den","Denver Broncos",10,"Detroit Lions",45,55,-35,FALSE,"10/30/2011",2011,"October","2010s",56,31,5
"10621","201110300pit","Pittsburgh Steelers",25,"New England Patriots",17,42,8,TRUE,"10/30/2011",2011,"October","2010s",40,79,3
"10622","201110300phi","Philadelphia Eagles",34,"Dallas Cowboys",7,41,27,TRUE,"10/30/2011",2011,"October","2010s",42,64,5
"10623","201110300rav","Baltimore Ravens",30,"Arizona Cardinals",27,57,3,TRUE,"10/30/2011",2011,"October","2010s",48,49,9
"10624","201110300oti","Tennessee Titans",27,"Indianapolis Colts",10,37,17,TRUE,"10/30/2011",2011,"October","2010s",62,35,NA
"10625","201110300car","Carolina Panthers",21,"Minnesota Vikings",24,45,-3,FALSE,"10/30/2011",2011,"October","2010s",54,52,6
"10626","201110300htx","Houston Texans",24,"Jacksonville Jaguars",14,38,10,TRUE,"10/30/2011",2011,"October","2010s",68,NA,4
"10627","201110310kan","Kansas City Chiefs",23,"San Diego Chargers",20,43,3,TRUE,"10/31/2011",2011,"October","2010s",63,31,NA
"10628","201111060was","Washington Redskins",11,"San Francisco 49ers",19,30,-8,FALSE,"11/6/2011",2011,"November","2010s",56,48,6
"10629","201111060buf","Buffalo Bills",11,"New York Jets",27,38,-16,FALSE,"11/6/2011",2011,"November","2010s",57,26,8
"10630","201111060htx","Houston Texans",30,"Cleveland Browns",12,42,18,TRUE,"11/6/2011",2011,"November","2010s",78,NA,1
"10631","201111060kan","Kansas City Chiefs",3,"Miami Dolphins",31,34,-28,FALSE,"11/6/2011",2011,"November","2010s",62,45,1
"10632","201111060clt","Indianapolis Colts",7,"Atlanta Falcons",31,38,-24,FALSE,"11/6/2011",2011,"November","2010s",57,NA,1
"10633","201111060sdg","San Diego Chargers",38,"Green Bay Packers",45,83,-7,FALSE,"11/6/2011",2011,"November","2010s",53,90,1
"10634","201111060oti","Tennessee Titans",17,"Cincinnati Bengals",24,41,-7,FALSE,"11/6/2011",2011,"November","2010s",68,39,1
"10635","201111060pit","Pittsburgh Steelers",20,"Baltimore Ravens",23,43,-3,FALSE,"11/6/2011",2011,"November","2010s",50,43,2
"10636","201111060nor","New Orleans Saints",27,"Tampa Bay Buccaneers",16,43,11,TRUE,"11/6/2011",2011,"November","2010s",70,NA,1
"10637","201111070phi","Philadelphia Eagles",24,"Chicago Bears",30,54,-6,FALSE,"11/7/2011",2011,"November","2010s",51,74,2
"10638","201111100sdg","San Diego Chargers",17,"Oakland Raiders",24,41,-7,FALSE,"11/10/2011",2011,"November","2010s",69,27,5
"10639","201111130mia","Miami Dolphins",20,"Washington Redskins",9,29,11,TRUE,"11/13/2011",2011,"November","2010s",79,58,1
"10640","201111130kan","Kansas City Chiefs",10,"Denver Broncos",17,27,-7,FALSE,"11/13/2011",2011,"November","2010s",67,23,1
"10641","201111130nyj","New York Jets",16,"New England Patriots",37,53,-21,FALSE,"11/13/2011",2011,"November","2010s",58,37,1
"10642","201111130phi","Philadelphia Eagles",17,"Arizona Cardinals",21,38,-4,FALSE,"11/13/2011",2011,"November","2010s",60,40,1
"10643","201111130sfo","San Francisco 49ers",27,"New York Giants",20,47,7,TRUE,"11/13/2011",2011,"November","2010s",58,74,1
"10644","201111130chi","Chicago Bears",37,"Detroit Lions",13,50,24,TRUE,"11/13/2011",2011,"November","2010s",69,44,2
"10645","201111130car","Carolina Panthers",3,"Tennessee Titans",30,33,-27,FALSE,"11/13/2011",2011,"November","2010s",57,54,1
"10646","201111130cin","Cincinnati Bengals",17,"Pittsburgh Steelers",24,41,-7,FALSE,"11/13/2011",2011,"November","2010s",62,60,2
"10647","201111130tam","Tampa Bay Buccaneers",9,"Houston Texans",37,46,-28,FALSE,"11/13/2011",2011,"November","2010s",77,47,9
"10648","201111130clt","Indianapolis Colts",3,"Jacksonville Jaguars",17,20,-14,FALSE,"11/13/2011",2011,"November","2010s",62,NA,2
"10649","201111170den","Denver Broncos",17,"New York Jets",13,30,4,TRUE,"11/17/2011",2011,"November","2010s",54,20,3
"10650","201111200mia","Miami Dolphins",35,"Buffalo Bills",8,43,27,TRUE,"11/20/2011",2011,"November","2010s",80,79,1
"10651","201111200was","Washington Redskins",24,"Dallas Cowboys",27,51,-3,FALSE,"11/20/2011",2011,"November","2010s",62,55,4
"10652","201111200sfo","San Francisco 49ers",23,"Arizona Cardinals",7,30,16,TRUE,"11/20/2011",2011,"November","2010s",55,72,1
"10653","201111200chi","Chicago Bears",31,"San Diego Chargers",20,51,11,TRUE,"11/20/2011",2011,"November","2010s",42,78,1
"10654","201111200rav","Baltimore Ravens",31,"Cincinnati Bengals",24,55,7,TRUE,"11/20/2011",2011,"November","2010s",67,59,7
"10655","201111200gnb","Green Bay Packers",35,"Tampa Bay Buccaneers",26,61,9,TRUE,"11/20/2011",2011,"November","2010s",32,66,7
"10656","201111200nyg","New York Giants",10,"Philadelphia Eagles",17,27,-7,FALSE,"11/20/2011",2011,"November","2010s",58,66,1
"10657","201111200cle","Cleveland Browns",14,"Jacksonville Jaguars",10,24,4,TRUE,"11/20/2011",2011,"November","2010s",57,5,1
"10658","201111240rav","Baltimore Ravens",16,"San Francisco 49ers",6,22,10,TRUE,"11/24/2011",2011,"November","2010s",53,32,5
"10659","201111270oti","Tennessee Titans",23,"Tampa Bay Buccaneers",17,40,6,TRUE,"11/27/2011",2011,"November","2010s",47,96,2
"10660","201111270sdg","San Diego Chargers",13,"Denver Broncos",16,29,-3,FALSE,"11/27/2011",2011,"November","2010s",84,12,NA
"10661","201111270jax","Jacksonville Jaguars",13,"Houston Texans",20,33,-7,FALSE,"11/27/2011",2011,"November","2010s",75,61,1
"10662","201111270rai","Oakland Raiders",25,"Chicago Bears",20,45,5,TRUE,"11/27/2011",2011,"November","2010s",59,76,6
"10663","201111270phi","Philadelphia Eagles",20,"New England Patriots",38,58,-18,FALSE,"11/27/2011",2011,"November","2010s",63,56,1
"10664","201111270nyj","New York Jets",28,"Buffalo Bills",24,52,4,TRUE,"11/27/2011",2011,"November","2010s",60,63,1
"10665","201111270clt","Indianapolis Colts",19,"Carolina Panthers",27,46,-8,FALSE,"11/27/2011",2011,"November","2010s",45,NA,7
"10666","201111270cin","Cincinnati Bengals",23,"Cleveland Browns",20,43,3,TRUE,"11/27/2011",2011,"November","2010s",57,98,7
"10667","201111280nor","New Orleans Saints",49,"New York Giants",24,73,25,TRUE,"11/28/2011",2011,"November","2010s",45,NA,2
"10668","201112040htx","Houston Texans",17,"Atlanta Falcons",10,27,7,TRUE,"12/4/2011",2011,"December","2010s",72,NA,2
"10669","201112040buf","Buffalo Bills",17,"Tennessee Titans",23,40,-6,FALSE,"12/4/2011",2011,"December","2010s",57,41,1
"10670","201112040sfo","San Francisco 49ers",26,"St. Louis Rams",0,26,26,TRUE,"12/4/2011",2011,"December","2010s",53,48,2
"10671","201112040nor","New Orleans Saints",31,"Detroit Lions",17,48,14,TRUE,"12/4/2011",2011,"December","2010s",70,NA,1
"10672","201112040pit","Pittsburgh Steelers",35,"Cincinnati Bengals",7,42,28,TRUE,"12/4/2011",2011,"December","2010s",59,28,1
"10673","201112040was","Washington Redskins",19,"New York Jets",34,53,-15,FALSE,"12/4/2011",2011,"December","2010s",53,57,5
"10674","201112040tam","Tampa Bay Buccaneers",19,"Carolina Panthers",38,57,-19,FALSE,"12/4/2011",2011,"December","2010s",79,46,1
"10675","201112040mia","Miami Dolphins",34,"Oakland Raiders",14,48,20,TRUE,"12/4/2011",2011,"December","2010s",80,49,2
"10676","201112040nyg","New York Giants",35,"Green Bay Packers",38,73,-3,FALSE,"12/4/2011",2011,"December","2010s",52,67,9
"10677","201112040chi","Chicago Bears",3,"Kansas City Chiefs",10,13,-7,FALSE,"12/4/2011",2011,"December","2010s",46,79,1
"10678","201112050jax","Jacksonville Jaguars",14,"San Diego Chargers",38,52,-24,FALSE,"12/5/2011",2011,"December","2010s",67,81,6
"10679","201112080pit","Pittsburgh Steelers",14,"Cleveland Browns",3,17,11,TRUE,"12/8/2011",2011,"December","2010s",31,74,6
"10680","201112110den","Denver Broncos",13,"Chicago Bears",10,23,3,TRUE,"12/11/2011",2011,"December","2010s",50,22,7
"10681","201112110gnb","Green Bay Packers",46,"Oakland Raiders",16,62,30,TRUE,"12/11/2011",2011,"December","2010s",43,55,1
"10682","201112110cin","Cincinnati Bengals",19,"Houston Texans",20,39,-1,FALSE,"12/11/2011",2011,"December","2010s",34,47,4
"10683","201112110rav","Baltimore Ravens",24,"Indianapolis Colts",10,34,14,TRUE,"12/11/2011",2011,"December","2010s",43,34,2
"10684","201112110oti","Tennessee Titans",17,"New Orleans Saints",22,39,-5,FALSE,"12/11/2011",2011,"December","2010s",41,44,7
"10685","201112110car","Carolina Panthers",23,"Atlanta Falcons",31,54,-8,FALSE,"12/11/2011",2011,"December","2010s",43,45,1
"10686","201112110nyj","New York Jets",37,"Kansas City Chiefs",10,47,27,TRUE,"12/11/2011",2011,"December","2010s",37,35,5
"10687","201112110mia","Miami Dolphins",10,"Philadelphia Eagles",26,36,-16,FALSE,"12/11/2011",2011,"December","2010s",75,83,1
"10688","201112110was","Washington Redskins",27,"New England Patriots",34,61,-7,FALSE,"12/11/2011",2011,"December","2010s",40,33,NA
"10689","201112110sdg","San Diego Chargers",37,"Buffalo Bills",10,47,27,TRUE,"12/11/2011",2011,"December","2010s",59,61,5
"10690","201112170tam","Tampa Bay Buccaneers",15,"Dallas Cowboys",31,46,-16,FALSE,"12/17/2011",2011,"December","2010s",66,78,3
"10691","201112180sdg","San Diego Chargers",34,"Baltimore Ravens",14,48,20,TRUE,"12/18/2011",2011,"December","2010s",58,67,7
"10692","201112180buf","Buffalo Bills",23,"Miami Dolphins",30,53,-7,FALSE,"12/18/2011",2011,"December","2010s",31,64,1
"10693","201112180htx","Houston Texans",13,"Carolina Panthers",28,41,-15,FALSE,"12/18/2011",2011,"December","2010s",57,NA,1
"10694","201112180nyg","New York Giants",10,"Washington Redskins",23,33,-13,FALSE,"12/18/2011",2011,"December","2010s",29,34,9
"10695","201112180den","Denver Broncos",23,"New England Patriots",41,64,-18,FALSE,"12/18/2011",2011,"December","2010s",63,16,3
"10696","201112180clt","Indianapolis Colts",27,"Tennessee Titans",13,40,14,TRUE,"12/18/2011",2011,"December","2010s",41,NA,9
"10697","201112180phi","Philadelphia Eagles",45,"New York Jets",19,64,26,TRUE,"12/18/2011",2011,"December","2010s",35,41,9
"10698","201112180chi","Chicago Bears",14,"Seattle Seahawks",38,52,-24,FALSE,"12/18/2011",2011,"December","2010s",39,65,5
"10699","201112180kan","Kansas City Chiefs",19,"Green Bay Packers",14,33,5,TRUE,"12/18/2011",2011,"December","2010s",50,58,1
"10700","201112180rai","Oakland Raiders",27,"Detroit Lions",28,55,-1,FALSE,"12/18/2011",2011,"December","2010s",50,84,1
"10701","201112190sfo","San Francisco 49ers",20,"Pittsburgh Steelers",3,23,17,TRUE,"12/19/2011",2011,"December","2010s",51,74,1
"10702","201112220clt","Indianapolis Colts",19,"Houston Texans",16,35,3,TRUE,"12/22/2011",2011,"December","2010s",42,NA,2
"10703","201112240kan","Kansas City Chiefs",13,"Oakland Raiders",16,29,-3,FALSE,"12/24/2011",2011,"December","2010s",38,57,7
"10704","201112240oti","Tennessee Titans",23,"Jacksonville Jaguars",17,40,6,TRUE,"12/24/2011",2011,"December","2010s",44,60,2
"10705","201112240cin","Cincinnati Bengals",23,"Arizona Cardinals",16,39,7,TRUE,"12/24/2011",2011,"December","2010s",38,63,8
"10706","201112240pit","Pittsburgh Steelers",27,"St. Louis Rams",0,27,27,TRUE,"12/24/2011",2011,"December","2010s",36,67,4
"10707","201112240buf","Buffalo Bills",40,"Denver Broncos",14,54,26,TRUE,"12/24/2011",2011,"December","2010s",30,42,2
"10708","201112240rav","Baltimore Ravens",20,"Cleveland Browns",14,34,6,TRUE,"12/24/2011",2011,"December","2010s",44,32,1
"10709","201112240was","Washington Redskins",26,"Minnesota Vikings",33,59,-7,FALSE,"12/24/2011",2011,"December","2010s",45,36,9
"10710","201112240car","Carolina Panthers",48,"Tampa Bay Buccaneers",16,64,32,TRUE,"12/24/2011",2011,"December","2010s",51,57,9
"10711","201112250gnb","Green Bay Packers",35,"Chicago Bears",21,56,14,TRUE,"12/25/2011",2011,"December","2010s",37,64,1
"10712","201112260nor","New Orleans Saints",45,"Atlanta Falcons",16,61,29,TRUE,"12/26/2011",2011,"December","2010s",67,NA,5
"10713","201201010cin","Cincinnati Bengals",16,"Baltimore Ravens",24,40,-8,FALSE,"1/1/2012",2012,"January","2010s",42,68,1
"10714","201201010cle","Cleveland Browns",9,"Pittsburgh Steelers",13,22,-4,FALSE,"1/1/2012",2012,"January","2010s",49,66,2
"10715","201201010gnb","Green Bay Packers",45,"Detroit Lions",41,86,4,TRUE,"1/1/2012",2012,"January","2010s",31,78,2
"10716","201201010nyg","New York Giants",31,"Dallas Cowboys",14,45,17,TRUE,"1/1/2012",2012,"January","2010s",48,83,7
"10717","201201010nor","New Orleans Saints",45,"Carolina Panthers",17,62,28,TRUE,"1/1/2012",2012,"January","2010s",68,NA,8
"10718","201201010phi","Philadelphia Eagles",34,"Washington Redskins",10,44,24,TRUE,"1/1/2012",2012,"January","2010s",53,58,1
"10719","201201010mia","Miami Dolphins",19,"New York Jets",17,36,2,TRUE,"1/1/2012",2012,"January","2010s",78,44,8
"10720","201201010den","Denver Broncos",3,"Kansas City Chiefs",7,10,-4,FALSE,"1/1/2012",2012,"January","2010s",35,46,6
"10721","201201010htx","Houston Texans",22,"Tennessee Titans",23,45,-1,FALSE,"1/1/2012",2012,"January","2010s",63,NA,1
"10722","201201010rai","Oakland Raiders",26,"San Diego Chargers",38,64,-12,FALSE,"1/1/2012",2012,"January","2010s",56,63,8
"10723","201201070htx","Houston Texans",31,"Cincinnati Bengals",10,41,21,TRUE,"1/7/2012",2012,"January","2010s",75,NA,8
"10724","201201070nor","New Orleans Saints",45,"Detroit Lions",28,73,17,TRUE,"1/7/2012",2012,"January","2010s",66,NA,8
"10725","201201080den","Denver Broncos",29,"Pittsburgh Steelers",23,52,6,TRUE,"1/8/2012",2012,"January","2010s",40,38,6
"10726","201201150gnb","Green Bay Packers",20,"New York Giants",37,57,-17,FALSE,"1/15/2012",2012,"January","2010s",31,66,2
"10727","201209050nyg","New York Giants",17,"Dallas Cowboys",24,41,-7,FALSE,"9/5/2012",2012,"September","2010s",77,63,5
"10728","201209090cle","Cleveland Browns",16,"Philadelphia Eagles",17,33,-1,FALSE,"9/9/2012",2012,"September","2010s",68,57,9
"10729","201209090oti","Tennessee Titans",13,"New England Patriots",34,47,-21,FALSE,"9/9/2012",2012,"September","2010s",74,45,4
"10730","201209090den","Denver Broncos",31,"Pittsburgh Steelers",19,50,12,TRUE,"9/9/2012",2012,"September","2010s",85,12,1
"10731","201209090gnb","Green Bay Packers",22,"San Francisco 49ers",30,52,-8,FALSE,"9/9/2012",2012,"September","2010s",72,40,1
"10732","201209090nor","New Orleans Saints",32,"Washington Redskins",40,72,-8,FALSE,"9/9/2012",2012,"September","2010s",78,NA,1
"10733","201209090chi","Chicago Bears",41,"Indianapolis Colts",21,62,20,TRUE,"9/9/2012",2012,"September","2010s",67,66,1
"10734","201209090kan","Kansas City Chiefs",24,"Atlanta Falcons",40,64,-16,FALSE,"9/9/2012",2012,"September","2010s",69,47,7
"10735","201209090htx","Houston Texans",30,"Miami Dolphins",10,40,20,TRUE,"9/9/2012",2012,"September","2010s",81,NA,1
"10736","201209090tam","Tampa Bay Buccaneers",16,"Carolina Panthers",10,26,6,TRUE,"9/9/2012",2012,"September","2010s",83,79,1
"10737","201209090nyj","New York Jets",48,"Buffalo Bills",28,76,20,TRUE,"9/9/2012",2012,"September","2010s",74,48,1
"10738","201209100rav","Baltimore Ravens",44,"Cincinnati Bengals",13,57,31,TRUE,"9/10/2012",2012,"September","2010s",74,37,1
"10739","201209100rai","Oakland Raiders",14,"San Diego Chargers",22,36,-8,FALSE,"9/10/2012",2012,"September","2010s",67,59,1
"10740","201209130gnb","Green Bay Packers",23,"Chicago Bears",10,33,13,TRUE,"9/13/2012",2012,"September","2010s",60,67,NA
"10741","201209160nyg","New York Giants",41,"Tampa Bay Buccaneers",34,75,7,TRUE,"9/16/2012",2012,"September","2010s",73,39,1
"10742","201209160mia","Miami Dolphins",35,"Oakland Raiders",13,48,22,TRUE,"9/16/2012",2012,"September","2010s",80,75,8
"10743","201209160car","Carolina Panthers",35,"New Orleans Saints",27,62,8,TRUE,"9/16/2012",2012,"September","2010s",71,85,4
"10744","201209160sea","Seattle Seahawks",27,"Dallas Cowboys",7,34,20,TRUE,"9/16/2012",2012,"September","2010s",68,56,4
"10745","201209160buf","Buffalo Bills",35,"Kansas City Chiefs",17,52,18,TRUE,"9/16/2012",2012,"September","2010s",66,55,1
"10746","201209160cin","Cincinnati Bengals",34,"Cleveland Browns",27,61,7,TRUE,"9/16/2012",2012,"September","2010s",76,37,5
"10747","201209160nwe","New England Patriots",18,"Arizona Cardinals",20,38,-2,FALSE,"9/16/2012",2012,"September","2010s",64,55,2
"10748","201209160jax","Jacksonville Jaguars",7,"Houston Texans",27,34,-20,FALSE,"9/16/2012",2012,"September","2010s",83,66,5
"10749","201209160phi","Philadelphia Eagles",24,"Baltimore Ravens",23,47,1,TRUE,"9/16/2012",2012,"September","2010s",72,40,5
"10750","201209160clt","Indianapolis Colts",23,"Minnesota Vikings",20,43,3,TRUE,"9/16/2012",2012,"September","2010s",72,NA,7
"10751","201209160pit","Pittsburgh Steelers",27,"New York Jets",10,37,17,TRUE,"9/16/2012",2012,"September","2010s",71,36,2
"10752","201209160sdg","San Diego Chargers",38,"Tennessee Titans",10,48,28,TRUE,"9/16/2012",2012,"September","2010s",85,37,8
"10753","201209160sfo","San Francisco 49ers",27,"Detroit Lions",19,46,8,TRUE,"9/16/2012",2012,"September","2010s",62,62,1
"10754","201209200car","Carolina Panthers",7,"New York Giants",36,43,-29,FALSE,"9/20/2012",2012,"September","2010s",75,56,3
"10755","201209230rai","Oakland Raiders",34,"Pittsburgh Steelers",31,65,3,TRUE,"9/23/2012",2012,"September","2010s",69,53,1
"10756","201209230chi","Chicago Bears",23,"St. Louis Rams",6,29,17,TRUE,"9/23/2012",2012,"September","2010s",56,42,1
"10757","201209230clt","Indianapolis Colts",17,"Jacksonville Jaguars",22,39,-5,FALSE,"9/23/2012",2012,"September","2010s",59,NA,1
"10758","201209230oti","Tennessee Titans",44,"Detroit Lions",41,85,3,TRUE,"9/23/2012",2012,"September","2010s",68,32,5
"10759","201209230sdg","San Diego Chargers",3,"Atlanta Falcons",27,30,-24,FALSE,"9/23/2012",2012,"September","2010s",82,52,1
"10760","201209230rav","Baltimore Ravens",31,"New England Patriots",30,61,1,TRUE,"9/23/2012",2012,"September","2010s",67,39,5
"10761","201209230mia","Miami Dolphins",20,"New York Jets",23,43,-3,FALSE,"9/23/2012",2012,"September","2010s",83,76,4
"10762","201209230was","Washington Redskins",31,"Cincinnati Bengals",38,69,-7,FALSE,"9/23/2012",2012,"September","2010s",65,40,6
"10763","201209230den","Denver Broncos",25,"Houston Texans",31,56,-6,FALSE,"9/23/2012",2012,"September","2010s",84,10,1
"10764","201209230nor","New Orleans Saints",24,"Kansas City Chiefs",27,51,-3,FALSE,"9/23/2012",2012,"September","2010s",84,NA,6
"10765","201209230cle","Cleveland Browns",14,"Buffalo Bills",24,38,-10,FALSE,"9/23/2012",2012,"September","2010s",53,79,9
"10766","201209240sea","Seattle Seahawks",14,"Green Bay Packers",12,26,2,TRUE,"9/24/2012",2012,"September","2010s",67,49,3
"10767","201209270rav","Baltimore Ravens",23,"Cleveland Browns",16,39,7,TRUE,"9/27/2012",2012,"September","2010s",77,64,5
"10768","201209300htx","Houston Texans",38,"Tennessee Titans",14,52,24,TRUE,"9/30/2012",2012,"September","2010s",71,NA,1
"10769","201209300tam","Tampa Bay Buccaneers",22,"Washington Redskins",24,46,-2,FALSE,"9/30/2012",2012,"September","2010s",89,52,1
"10770","201209300kan","Kansas City Chiefs",20,"San Diego Chargers",37,57,-17,FALSE,"9/30/2012",2012,"September","2010s",67,54,NA
"10771","201209300nyj","New York Jets",0,"San Francisco 49ers",34,34,-34,FALSE,"9/30/2012",2012,"September","2010s",67,50,4
"10772","201209300phi","Philadelphia Eagles",19,"New York Giants",17,36,2,TRUE,"9/30/2012",2012,"September","2010s",63,59,6
"10773","201209300gnb","Green Bay Packers",28,"New Orleans Saints",27,55,1,TRUE,"9/30/2012",2012,"September","2010s",64,58,7
"10774","201209300den","Denver Broncos",37,"Oakland Raiders",6,43,31,TRUE,"9/30/2012",2012,"September","2010s",72,26,6
"10775","201209300buf","Buffalo Bills",28,"New England Patriots",52,80,-24,FALSE,"9/30/2012",2012,"September","2010s",58,72,7
"10776","201210010dal","Dallas Cowboys",18,"Chicago Bears",34,52,-16,FALSE,"10/1/2012",2012,"October","2010s",80,NA,3
"10777","201210070clt","Indianapolis Colts",30,"Green Bay Packers",27,57,3,TRUE,"10/7/2012",2012,"October","2010s",48,NA,8
"10778","201210070pit","Pittsburgh Steelers",16,"Philadelphia Eagles",14,30,2,TRUE,"10/7/2012",2012,"October","2010s",48,68,4
"10779","201210070nor","New Orleans Saints",31,"San Diego Chargers",24,55,7,TRUE,"10/7/2012",2012,"October","2010s",65,NA,1
"10780","201210070nwe","New England Patriots",31,"Denver Broncos",21,52,10,TRUE,"10/7/2012",2012,"October","2010s",54,65,4
"10781","201210070sfo","San Francisco 49ers",45,"Buffalo Bills",3,48,42,TRUE,"10/7/2012",2012,"October","2010s",62,70,8
"10782","201210070jax","Jacksonville Jaguars",3,"Chicago Bears",41,44,-38,FALSE,"10/7/2012",2012,"October","2010s",88,53,3
"10783","201210070was","Washington Redskins",17,"Atlanta Falcons",24,41,-7,FALSE,"10/7/2012",2012,"October","2010s",52,77,3
"10784","201210070cin","Cincinnati Bengals",13,"Miami Dolphins",17,30,-4,FALSE,"10/7/2012",2012,"October","2010s",49,55,6
"10785","201210070kan","Kansas City Chiefs",6,"Baltimore Ravens",9,15,-3,FALSE,"10/7/2012",2012,"October","2010s",47,45,NA
"10786","201210070nyg","New York Giants",41,"Cleveland Browns",27,68,14,TRUE,"10/7/2012",2012,"October","2010s",51,84,2
"10787","201210070car","Carolina Panthers",12,"Seattle Seahawks",16,28,-4,FALSE,"10/7/2012",2012,"October","2010s",63,69,6
"10788","201210110oti","Tennessee Titans",26,"Pittsburgh Steelers",23,49,3,TRUE,"10/11/2012",2012,"October","2010s",64,52,2
"10789","201210140rav","Baltimore Ravens",31,"Dallas Cowboys",29,60,2,TRUE,"10/14/2012",2012,"October","2010s",69,45,1
"10790","201210140phi","Philadelphia Eagles",23,"Detroit Lions",26,49,-3,FALSE,"10/14/2012",2012,"October","2010s",66,58,1
"10791","201210140htx","Houston Texans",24,"Green Bay Packers",42,66,-18,FALSE,"10/14/2012",2012,"October","2010s",81,NA,5
"10792","201210140sfo","San Francisco 49ers",3,"New York Giants",26,29,-23,FALSE,"10/14/2012",2012,"October","2010s",61,80,7
"10793","201210140tam","Tampa Bay Buccaneers",38,"Kansas City Chiefs",10,48,28,TRUE,"10/14/2012",2012,"October","2010s",85,55,9
"10794","201210140sea","Seattle Seahawks",24,"New England Patriots",23,47,1,TRUE,"10/14/2012",2012,"October","2010s",63,80,9
"10795","201210140mia","Miami Dolphins",17,"St. Louis Rams",14,31,3,TRUE,"10/14/2012",2012,"October","2010s",84,72,2
"10796","201210140cle","Cleveland Browns",34,"Cincinnati Bengals",24,58,10,TRUE,"10/14/2012",2012,"October","2010s",70,65,1
"10797","201210140was","Washington Redskins",38,"Minnesota Vikings",26,64,12,TRUE,"10/14/2012",2012,"October","2010s",74,40,1
"10798","201210150sdg","San Diego Chargers",24,"Denver Broncos",35,59,-11,FALSE,"10/15/2012",2012,"October","2010s",78,50,7
"10799","201210180sfo","San Francisco 49ers",13,"Seattle Seahawks",6,19,7,TRUE,"10/18/2012",2012,"October","2010s",80,30,1
"10800","201210210car","Carolina Panthers",14,"Dallas Cowboys",19,33,-5,FALSE,"10/21/2012",2012,"October","2010s",62,43,8
"10801","201210210rai","Oakland Raiders",26,"Jacksonville Jaguars",23,49,3,TRUE,"10/21/2012",2012,"October","2010s",62,49,1
"10802","201210210tam","Tampa Bay Buccaneers",28,"New Orleans Saints",35,63,-7,FALSE,"10/21/2012",2012,"October","2010s",77,36,8
"10803","201210210htx","Houston Texans",43,"Baltimore Ravens",13,56,30,TRUE,"10/21/2012",2012,"October","2010s",84,NA,1
"10804","201210210nwe","New England Patriots",29,"New York Jets",26,55,3,TRUE,"10/21/2012",2012,"October","2010s",62,39,1
"10805","201210210cin","Cincinnati Bengals",17,"Pittsburgh Steelers",24,41,-7,FALSE,"10/21/2012",2012,"October","2010s",55,76,1
"10806","201210210clt","Indianapolis Colts",17,"Cleveland Browns",13,30,4,TRUE,"10/21/2012",2012,"October","2010s",60,NA,9
"10807","201210210buf","Buffalo Bills",34,"Tennessee Titans",35,69,-1,FALSE,"10/21/2012",2012,"October","2010s",55,75,1
"10808","201210210nyg","New York Giants",27,"Washington Redskins",23,50,4,TRUE,"10/21/2012",2012,"October","2010s",61,44,1
"10809","201210220chi","Chicago Bears",13,"Detroit Lions",7,20,6,TRUE,"10/22/2012",2012,"October","2010s",63,89,8
"10810","201210280dal","Dallas Cowboys",24,"New York Giants",29,53,-5,FALSE,"10/28/2012",2012,"October","2010s",62,NA,1
"10811","201210280den","Denver Broncos",34,"New Orleans Saints",14,48,20,TRUE,"10/28/2012",2012,"October","2010s",59,30,5
"10812","201210280oti","Tennessee Titans",13,"Indianapolis Colts",19,32,-6,FALSE,"10/28/2012",2012,"October","2010s",52,49,1
"10813","201210280chi","Chicago Bears",23,"Carolina Panthers",22,45,1,TRUE,"10/28/2012",2012,"October","2010s",49,51,1
"10814","201210280pit","Pittsburgh Steelers",27,"Washington Redskins",12,39,15,TRUE,"10/28/2012",2012,"October","2010s",45,88,1
"10815","201210280kan","Kansas City Chiefs",16,"Oakland Raiders",26,42,-10,FALSE,"10/28/2012",2012,"October","2010s",50,40,3
"10816","201210280phi","Philadelphia Eagles",17,"Atlanta Falcons",30,47,-13,FALSE,"10/28/2012",2012,"October","2010s",58,75,1
"10817","201210280gnb","Green Bay Packers",24,"Jacksonville Jaguars",15,39,9,TRUE,"10/28/2012",2012,"October","2010s",44,47,1
"10818","201210280ram","St. Louis Rams",7,"New England Patriots",45,52,-38,FALSE,"10/28/2012",2012,"October","2010s",49,NA,9
"10819","201210280cle","Cleveland Browns",7,"San Diego Chargers",6,13,1,TRUE,"10/28/2012",2012,"October","2010s",44,89,1
"10820","201210290crd","Arizona Cardinals",3,"San Francisco 49ers",24,27,-21,FALSE,"10/29/2012",2012,"October","2010s",90,NA,5
"10821","201211010sdg","San Diego Chargers",31,"Kansas City Chiefs",13,44,18,TRUE,"11/1/2012",2012,"November","2010s",63,74,1
"10822","201211040cin","Cincinnati Bengals",23,"Denver Broncos",31,54,-8,FALSE,"11/4/2012",2012,"November","2010s",48,59,1
"10823","201211040was","Washington Redskins",13,"Carolina Panthers",21,34,-8,FALSE,"11/4/2012",2012,"November","2010s",50,44,3
"10824","201211040clt","Indianapolis Colts",23,"Miami Dolphins",20,43,3,TRUE,"11/4/2012",2012,"November","2010s",44,NA,9
"10825","201211040htx","Houston Texans",21,"Buffalo Bills",9,30,12,TRUE,"11/4/2012",2012,"November","2010s",79,NA,3
"10826","201211040oti","Tennessee Titans",20,"Chicago Bears",51,71,-31,FALSE,"11/4/2012",2012,"November","2010s",50,63,6
"10827","201211040rai","Oakland Raiders",32,"Tampa Bay Buccaneers",42,74,-10,FALSE,"11/4/2012",2012,"November","2010s",71,55,7
"10828","201211040cle","Cleveland Browns",15,"Baltimore Ravens",25,40,-10,FALSE,"11/4/2012",2012,"November","2010s",39,69,8
"10829","201211040sea","Seattle Seahawks",30,"Minnesota Vikings",20,50,10,TRUE,"11/4/2012",2012,"November","2010s",60,89,5
"10830","201211040gnb","Green Bay Packers",31,"Arizona Cardinals",17,48,14,TRUE,"11/4/2012",2012,"November","2010s",39,57,7
"10831","201211040nyg","New York Giants",20,"Pittsburgh Steelers",24,44,-4,FALSE,"11/4/2012",2012,"November","2010s",44,58,5
"10832","201211050nor","New Orleans Saints",28,"Philadelphia Eagles",13,41,15,TRUE,"11/5/2012",2012,"November","2010s",69,NA,7
"10833","201211110chi","Chicago Bears",6,"Houston Texans",13,19,-7,FALSE,"11/11/2012",2012,"November","2010s",54,90,8
"10834","201211110rav","Baltimore Ravens",55,"Oakland Raiders",20,75,35,TRUE,"11/11/2012",2012,"November","2010s",61,56,6
"10835","201211110nwe","New England Patriots",37,"Buffalo Bills",31,68,6,TRUE,"11/11/2012",2012,"November","2010s",60,55,1
"10836","201211110cin","Cincinnati Bengals",31,"New York Giants",13,44,18,TRUE,"11/11/2012",2012,"November","2010s",69,30,1
"10837","201211110phi","Philadelphia Eagles",23,"Dallas Cowboys",38,61,-15,FALSE,"11/11/2012",2012,"November","2010s",63,45,7
"10838","201211110sfo","San Francisco 49ers",24,"St. Louis Rams",24,48,0,FALSE,"11/11/2012",2012,"November","2010s",55,59,5
"10839","201211110nor","New Orleans Saints",31,"Atlanta Falcons",27,58,4,TRUE,"11/11/2012",2012,"November","2010s",79,NA,1
"10840","201211110sea","Seattle Seahawks",28,"New York Jets",7,35,21,TRUE,"11/11/2012",2012,"November","2010s",43,66,2
"10841","201211110tam","Tampa Bay Buccaneers",34,"San Diego Chargers",24,58,10,TRUE,"11/11/2012",2012,"November","2010s",80,51,1
"10842","201211110mia","Miami Dolphins",3,"Tennessee Titans",37,40,-34,FALSE,"11/11/2012",2012,"November","2010s",78,52,2
"10843","201211120pit","Pittsburgh Steelers",16,"Kansas City Chiefs",13,29,3,TRUE,"11/12/2012",2012,"November","2010s",45,84,1
"10844","201211150buf","Buffalo Bills",19,"Miami Dolphins",14,33,5,TRUE,"11/15/2012",2012,"November","2010s",35,73,5
"10845","201211180car","Carolina Panthers",21,"Tampa Bay Buccaneers",27,48,-6,FALSE,"11/18/2012",2012,"November","2010s",53,15,9
"10846","201211180rai","Oakland Raiders",17,"New Orleans Saints",38,55,-21,FALSE,"11/18/2012",2012,"November","2010s",61,62,3
"10847","201211180nwe","New England Patriots",59,"Indianapolis Colts",24,83,35,TRUE,"11/18/2012",2012,"November","2010s",42,62,1
"10848","201211180kan","Kansas City Chiefs",6,"Cincinnati Bengals",28,34,-22,FALSE,"11/18/2012",2012,"November","2010s",59,37,1
"10849","201211180pit","Pittsburgh Steelers",10,"Baltimore Ravens",13,23,-3,FALSE,"11/18/2012",2012,"November","2010s",46,52,5
"10850","201211180den","Denver Broncos",30,"San Diego Chargers",23,53,7,TRUE,"11/18/2012",2012,"November","2010s",62,22,3
"10851","201211180htx","Houston Texans",43,"Jacksonville Jaguars",37,80,6,TRUE,"11/18/2012",2012,"November","2010s",70,NA,7
"10852","201211180was","Washington Redskins",31,"Philadelphia Eagles",6,37,25,TRUE,"11/18/2012",2012,"November","2010s",52,55,9
"10853","201211190sfo","San Francisco 49ers",32,"Chicago Bears",7,39,25,TRUE,"11/19/2012",2012,"November","2010s",64,52,1
"10854","201211220nyj","New York Jets",19,"New England Patriots",49,68,-30,FALSE,"11/22/2012",2012,"November","2010s",46,72,2
"10855","201211250clt","Indianapolis Colts",20,"Buffalo Bills",13,33,7,TRUE,"11/25/2012",2012,"November","2010s",45,NA,1
"10856","201211250kan","Kansas City Chiefs",9,"Denver Broncos",17,26,-8,FALSE,"11/25/2012",2012,"November","2010s",52,38,5
"10857","201211250cle","Cleveland Browns",20,"Pittsburgh Steelers",14,34,6,TRUE,"11/25/2012",2012,"November","2010s",34,65,1
"10858","201211250sdg","San Diego Chargers",13,"Baltimore Ravens",16,29,-3,FALSE,"11/25/2012",2012,"November","2010s",59,82,1
"10859","201211250tam","Tampa Bay Buccaneers",23,"Atlanta Falcons",24,47,-1,FALSE,"11/25/2012",2012,"November","2010s",65,30,7
"10860","201211250mia","Miami Dolphins",24,"Seattle Seahawks",21,45,3,TRUE,"11/25/2012",2012,"November","2010s",72,51,6
"10861","201211250chi","Chicago Bears",28,"Minnesota Vikings",10,38,18,TRUE,"11/25/2012",2012,"November","2010s",41,26,5
"10862","201211250nor","New Orleans Saints",21,"San Francisco 49ers",31,52,-10,FALSE,"11/25/2012",2012,"November","2010s",66,NA,5
"10863","201211250cin","Cincinnati Bengals",34,"Oakland Raiders",10,44,24,TRUE,"11/25/2012",2012,"November","2010s",41,47,9
"10864","201211250nyg","New York Giants",38,"Green Bay Packers",10,48,28,TRUE,"11/25/2012",2012,"November","2010s",34,60,1
"10865","201211260phi","Philadelphia Eagles",22,"Carolina Panthers",30,52,-8,FALSE,"11/26/2012",2012,"November","2010s",36,42,2
"10866","201212020rav","Baltimore Ravens",20,"Pittsburgh Steelers",23,43,-3,FALSE,"12/2/2012",2012,"December","2010s",57,62,9
"10867","201212020mia","Miami Dolphins",16,"New England Patriots",23,39,-7,FALSE,"12/2/2012",2012,"December","2010s",77,66,1
"10868","201212020den","Denver Broncos",31,"Tampa Bay Buccaneers",23,54,8,TRUE,"12/2/2012",2012,"December","2010s",64,16,4
"10869","201212020rai","Oakland Raiders",17,"Cleveland Browns",20,37,-3,FALSE,"12/2/2012",2012,"December","2010s",61,84,2
"10870","201212020sdg","San Diego Chargers",13,"Cincinnati Bengals",20,33,-7,FALSE,"12/2/2012",2012,"December","2010s",66,65,1
"10871","201212020chi","Chicago Bears",17,"Seattle Seahawks",23,40,-6,FALSE,"12/2/2012",2012,"December","2010s",61,76,4
"10872","201212020oti","Tennessee Titans",10,"Houston Texans",24,34,-14,FALSE,"12/2/2012",2012,"December","2010s",66,60,1
"10873","201212020gnb","Green Bay Packers",23,"Minnesota Vikings",14,37,9,TRUE,"12/2/2012",2012,"December","2010s",45,79,8
"10874","201212020buf","Buffalo Bills",34,"Jacksonville Jaguars",18,52,16,TRUE,"12/2/2012",2012,"December","2010s",52,87,1
"10875","201212020kan","Kansas City Chiefs",27,"Carolina Panthers",21,48,6,TRUE,"12/2/2012",2012,"December","2010s",61,60,NA
"10876","201212030was","Washington Redskins",17,"New York Giants",16,33,1,TRUE,"12/3/2012",2012,"December","2010s",55,98,1
"10877","201212060rai","Oakland Raiders",13,"Denver Broncos",26,39,-13,FALSE,"12/6/2012",2012,"December","2010s",57,73,7
"10878","201212090cle","Cleveland Browns",30,"Kansas City Chiefs",7,37,23,TRUE,"12/9/2012",2012,"December","2010s",44,70,5
"10879","201212090sfo","San Francisco 49ers",27,"Miami Dolphins",13,40,14,TRUE,"12/9/2012",2012,"December","2010s",62,44,3
"10880","201212090pit","Pittsburgh Steelers",24,"San Diego Chargers",34,58,-10,FALSE,"12/9/2012",2012,"December","2010s",45,80,1
"10881","201212090gnb","Green Bay Packers",27,"Detroit Lions",20,47,7,TRUE,"12/9/2012",2012,"December","2010s",33,92,1
"10882","201212090tam","Tampa Bay Buccaneers",21,"Philadelphia Eagles",23,44,-2,FALSE,"12/9/2012",2012,"December","2010s",69,92,1
"10883","201212090buf","Buffalo Bills",12,"St. Louis Rams",15,27,-3,FALSE,"12/9/2012",2012,"December","2010s",37,74,1
"10884","201212090car","Carolina Panthers",30,"Atlanta Falcons",20,50,10,TRUE,"12/9/2012",2012,"December","2010s",70,50,4
"10885","201212090clt","Indianapolis Colts",27,"Tennessee Titans",23,50,4,TRUE,"12/9/2012",2012,"December","2010s",48,NA,6
"10886","201212090nyg","New York Giants",52,"New Orleans Saints",27,79,25,TRUE,"12/9/2012",2012,"December","2010s",42,88,1
"10887","201212090sea","Seattle Seahawks",58,"Arizona Cardinals",0,58,58,TRUE,"12/9/2012",2012,"December","2010s",48,82,8
"10888","201212090was","Washington Redskins",31,"Baltimore Ravens",28,59,3,TRUE,"12/9/2012",2012,"December","2010s",51,95,7
"10889","201212090cin","Cincinnati Bengals",19,"Dallas Cowboys",20,39,-1,FALSE,"12/9/2012",2012,"December","2010s",53,96,6
"10890","201212100nwe","New England Patriots",42,"Houston Texans",14,56,28,TRUE,"12/10/2012",2012,"December","2010s",59,91,7
"10891","201212130phi","Philadelphia Eagles",13,"Cincinnati Bengals",34,47,-21,FALSE,"12/13/2012",2012,"December","2010s",36,55,1
"10892","201212160mia","Miami Dolphins",24,"Jacksonville Jaguars",3,27,21,TRUE,"12/16/2012",2012,"December","2010s",80,60,1
"10893","201212160crd","Arizona Cardinals",38,"Detroit Lions",10,48,28,TRUE,"12/16/2012",2012,"December","2010s",57,NA,3
"10894","201212160nor","New Orleans Saints",41,"Tampa Bay Buccaneers",0,41,41,TRUE,"12/16/2012",2012,"December","2010s",74,NA,1
"10895","201212160dal","Dallas Cowboys",27,"Pittsburgh Steelers",24,51,3,TRUE,"12/16/2012",2012,"December","2010s",72,NA,1
"10896","201212160rav","Baltimore Ravens",17,"Denver Broncos",34,51,-17,FALSE,"12/16/2012",2012,"December","2010s",53,74,7
"10897","201212160cle","Cleveland Browns",21,"Washington Redskins",38,59,-17,FALSE,"12/16/2012",2012,"December","2010s",59,67,1
"10898","201212160nwe","New England Patriots",34,"San Francisco 49ers",41,75,-7,FALSE,"12/16/2012",2012,"December","2010s",34,100,5
"10899","201212160chi","Chicago Bears",13,"Green Bay Packers",21,34,-8,FALSE,"12/16/2012",2012,"December","2010s",44,79,9
"10900","201212160rai","Oakland Raiders",15,"Kansas City Chiefs",0,15,15,TRUE,"12/16/2012",2012,"December","2010s",54,77,2
"10901","201212160sdg","San Diego Chargers",7,"Carolina Panthers",31,38,-24,FALSE,"12/16/2012",2012,"December","2010s",59,64,6
"10902","201212170oti","Tennessee Titans",14,"New York Jets",10,24,4,TRUE,"12/17/2012",2012,"December","2010s",54,83,1
"10903","201212230crd","Arizona Cardinals",13,"Chicago Bears",28,41,-15,FALSE,"12/23/2012",2012,"December","2010s",62,NA,NA
"10904","201212230rav","Baltimore Ravens",33,"New York Giants",14,47,19,TRUE,"12/23/2012",2012,"December","2010s",51,33,7
"10905","201212230gnb","Green Bay Packers",55,"Tennessee Titans",7,62,48,TRUE,"12/23/2012",2012,"December","2010s",24,68,9
"10906","201212230den","Denver Broncos",34,"Cleveland Browns",12,46,22,TRUE,"12/23/2012",2012,"December","2010s",51,22,1
"10907","201212230phi","Philadelphia Eagles",20,"Washington Redskins",27,47,-7,FALSE,"12/23/2012",2012,"December","2010s",40,52,1
"10908","201212230car","Carolina Panthers",17,"Oakland Raiders",6,23,11,TRUE,"12/23/2012",2012,"December","2010s",53,43,3
"10909","201212230nyj","New York Jets",17,"San Diego Chargers",27,44,-10,FALSE,"12/23/2012",2012,"December","2010s",39,54,1
"10910","201212230sea","Seattle Seahawks",42,"San Francisco 49ers",13,55,29,TRUE,"12/23/2012",2012,"December","2010s",45,76,3
"10911","201212230dal","Dallas Cowboys",31,"New Orleans Saints",34,65,-3,FALSE,"12/23/2012",2012,"December","2010s",63,NA,1
"10912","201212230mia","Miami Dolphins",24,"Buffalo Bills",10,34,14,TRUE,"12/23/2012",2012,"December","2010s",73,47,8
"10913","201212230htx","Houston Texans",6,"Minnesota Vikings",23,29,-17,FALSE,"12/23/2012",2012,"December","2010s",73,NA,1
"10914","201212230pit","Pittsburgh Steelers",10,"Cincinnati Bengals",13,23,-3,FALSE,"12/23/2012",2012,"December","2010s",35,56,1
"10915","201212230tam","Tampa Bay Buccaneers",13,"St. Louis Rams",28,41,-15,FALSE,"12/23/2012",2012,"December","2010s",59,28,8
"10916","201212230kan","Kansas City Chiefs",13,"Indianapolis Colts",20,33,-7,FALSE,"12/23/2012",2012,"December","2010s",25,74,6
"10917","201212300sdg","San Diego Chargers",24,"Oakland Raiders",21,45,3,TRUE,"12/30/2012",2012,"December","2010s",50,80,3
"10918","201212300sea","Seattle Seahawks",20,"St. Louis Rams",13,33,7,TRUE,"12/30/2012",2012,"December","2010s",41,77,1
"10919","201212300den","Denver Broncos",38,"Kansas City Chiefs",3,41,35,TRUE,"12/30/2012",2012,"December","2010s",35,41,1
"10920","201212300nwe","New England Patriots",28,"Miami Dolphins",0,28,28,TRUE,"12/30/2012",2012,"December","2010s",28,45,1
"10921","201212300nyg","New York Giants",42,"Philadelphia Eagles",7,49,35,TRUE,"12/30/2012",2012,"December","2010s",32,50,1
"10922","201212300clt","Indianapolis Colts",28,"Houston Texans",16,44,12,TRUE,"12/30/2012",2012,"December","2010s",20,NA,6
"10923","201212300oti","Tennessee Titans",38,"Jacksonville Jaguars",20,58,18,TRUE,"12/30/2012",2012,"December","2010s",39,50,4
"10924","201212300sfo","San Francisco 49ers",27,"Arizona Cardinals",13,40,14,TRUE,"12/30/2012",2012,"December","2010s",50,70,5
"10925","201212300nor","New Orleans Saints",38,"Carolina Panthers",44,82,-6,FALSE,"12/30/2012",2012,"December","2010s",42,NA,1
"10926","201212300was","Washington Redskins",28,"Dallas Cowboys",18,46,10,TRUE,"12/30/2012",2012,"December","2010s",37,53,9
"10927","201212300pit","Pittsburgh Steelers",24,"Cleveland Browns",10,34,14,TRUE,"12/30/2012",2012,"December","2010s",28,78,1
"10928","201212300buf","Buffalo Bills",28,"New York Jets",9,37,19,TRUE,"12/30/2012",2012,"December","2010s",28,53,1
"10929","201212300cin","Cincinnati Bengals",23,"Baltimore Ravens",17,40,6,TRUE,"12/30/2012",2012,"December","2010s",26,72,8
"10930","201301050gnb","Green Bay Packers",24,"Minnesota Vikings",10,34,14,TRUE,"1/5/2013",2013,"January","2010s",29,78,9
"10931","201301050htx","Houston Texans",19,"Cincinnati Bengals",13,32,6,TRUE,"1/5/2013",2013,"January","2010s",46,NA,6
"10932","201301060was","Washington Redskins",14,"Seattle Seahawks",24,38,-10,FALSE,"1/6/2013",2013,"January","2010s",52,44,3
"10933","201301060rav","Baltimore Ravens",24,"Indianapolis Colts",9,33,15,TRUE,"1/6/2013",2013,"January","2010s",49,36,8
"10934","201301120den","Denver Broncos",35,"Baltimore Ravens",38,73,-3,FALSE,"1/12/2013",2013,"January","2010s",13,62,8
"10935","201301120sfo","San Francisco 49ers",45,"Green Bay Packers",31,76,14,TRUE,"1/12/2013",2013,"January","2010s",48,50,5
"10936","201301130nwe","New England Patriots",41,"Houston Texans",28,69,13,TRUE,"1/13/2013",2013,"January","2010s",51,87,1
"10937","201309050den","Denver Broncos",49,"Baltimore Ravens",27,76,22,TRUE,"9/5/2013",2013,"September","2010s",83,30,7
"10938","201309080car","Carolina Panthers",7,"Seattle Seahawks",12,19,-5,FALSE,"9/8/2013",2013,"September","2010s",87,48,7
"10939","201309080jax","Jacksonville Jaguars",2,"Kansas City Chiefs",28,30,-26,FALSE,"9/8/2013",2013,"September","2010s",85,55,10
"10940","201309080clt","Indianapolis Colts",21,"Oakland Raiders",17,38,4,TRUE,"9/8/2013",2013,"September","2010s",88,47,3
"10941","201309080sfo","San Francisco 49ers",34,"Green Bay Packers",28,62,6,TRUE,"9/8/2013",2013,"September","2010s",69,67,6
"10942","201309080nyj","New York Jets",18,"Tampa Bay Buccaneers",17,35,1,TRUE,"9/8/2013",2013,"September","2010s",82,50,9
"10943","201309080chi","Chicago Bears",24,"Cincinnati Bengals",21,45,3,TRUE,"9/8/2013",2013,"September","2010s",73,79,11
"10944","201309080ram","St. Louis Rams",27,"Arizona Cardinals",24,51,3,TRUE,"9/8/2013",2013,"September","2010s",0,NA,NA
"10945","201309080det","Detroit Lions",34,"Minnesota Vikings",24,58,10,TRUE,"9/8/2013",2013,"September","2010s",68,NA,NA
"10946","201309080dal","Dallas Cowboys",36,"New York Giants",31,67,5,TRUE,"9/8/2013",2013,"September","2010s",96,NA,11
"10947","201309080cle","Cleveland Browns",10,"Miami Dolphins",23,33,-13,FALSE,"9/8/2013",2013,"September","2010s",70,80,13
"10948","201309080buf","Buffalo Bills",21,"New England Patriots",23,44,-2,FALSE,"9/8/2013",2013,"September","2010s",65,55,11
"10949","201309080nor","New Orleans Saints",23,"Atlanta Falcons",17,40,6,TRUE,"9/8/2013",2013,"September","2010s",86,71,9
"10950","201309080pit","Pittsburgh Steelers",9,"Tennessee Titans",16,25,-7,FALSE,"9/8/2013",2013,"September","2010s",73,76,9
"10951","201309090sdg","San Diego Chargers",28,"Houston Texans",31,59,-3,FALSE,"9/9/2013",2013,"September","2010s",70,73,10
"10952","201309090was","Washington Redskins",27,"Philadelphia Eagles",33,60,-6,FALSE,"9/9/2013",2013,"September","2010s",80,52,9
"10953","201309120nwe","New England Patriots",13,"New York Jets",10,23,3,TRUE,"9/12/2013",2013,"September","2010s",72,89,8
"10954","201309150rav","Baltimore Ravens",14,"Cleveland Browns",6,20,8,TRUE,"9/15/2013",2013,"September","2010s",75,37,6
"10955","201309150nyg","New York Giants",23,"Denver Broncos",41,64,-18,FALSE,"9/15/2013",2013,"September","2010s",70,33,3
"10956","201309150rai","Oakland Raiders",19,"Jacksonville Jaguars",9,28,10,TRUE,"9/15/2013",2013,"September","2010s",76,52,10
"10957","201309150chi","Chicago Bears",31,"Minnesota Vikings",30,61,1,TRUE,"9/15/2013",2013,"September","2010s",60,76,6
"10958","201309150htx","Houston Texans",30,"Tennessee Titans",24,54,6,TRUE,"9/15/2013",2013,"September","2010s",86,54,14
"10959","201309150phi","Philadelphia Eagles",30,"San Diego Chargers",33,63,-3,FALSE,"9/15/2013",2013,"September","2010s",71,40,6
"10960","201309150atl","Atlanta Falcons",31,"St. Louis Rams",24,55,7,TRUE,"9/15/2013",2013,"September","2010s",0,NA,NA
"10961","201309150tam","Tampa Bay Buccaneers",14,"New Orleans Saints",16,30,-2,FALSE,"9/15/2013",2013,"September","2010s",93,47,8
"10962","201309150crd","Arizona Cardinals",25,"Detroit Lions",21,46,4,TRUE,"9/15/2013",2013,"September","2010s",0,NA,NA
"10963","201309150kan","Kansas City Chiefs",17,"Dallas Cowboys",16,33,1,TRUE,"9/15/2013",2013,"September","2010s",72,69,6
"10964","201309150clt","Indianapolis Colts",20,"Miami Dolphins",24,44,-4,FALSE,"9/15/2013",2013,"September","2010s",72,41,9
"10965","201309150gnb","Green Bay Packers",38,"Washington Redskins",20,58,18,TRUE,"9/15/2013",2013,"September","2010s",56,100,4
"10966","201309150buf","Buffalo Bills",24,"Carolina Panthers",23,47,1,TRUE,"9/15/2013",2013,"September","2010s",65,59,10
"10967","201309150sea","Seattle Seahawks",29,"San Francisco 49ers",3,32,26,TRUE,"9/15/2013",2013,"September","2010s",64,81,6
"10968","201309160cin","Cincinnati Bengals",20,"Pittsburgh Steelers",10,30,10,TRUE,"9/16/2013",2013,"September","2010s",62,75,5
"10969","201309190phi","Philadelphia Eagles",16,"Kansas City Chiefs",26,42,-10,FALSE,"9/19/2013",2013,"September","2010s",73,43,4
"10970","201309220car","Carolina Panthers",38,"New York Giants",0,38,38,TRUE,"9/22/2013",2013,"September","2010s",75,52,15
"10971","201309220pit","Pittsburgh Steelers",23,"Chicago Bears",40,63,-17,FALSE,"9/22/2013",2013,"September","2010s",56,72,5
"10972","201309220oti","Tennessee Titans",20,"San Diego Chargers",17,37,3,TRUE,"9/22/2013",2013,"September","2010s",72,46,7
"10973","201309220nwe","New England Patriots",23,"Tampa Bay Buccaneers",3,26,20,TRUE,"9/22/2013",2013,"September","2010s",65,72,9
"10974","201309220min","Minnesota Vikings",27,"Cleveland Browns",31,58,-4,FALSE,"9/22/2013",2013,"September","2010s",67,0,NA
"10975","201309220nyj","New York Jets",27,"Buffalo Bills",20,47,7,TRUE,"9/22/2013",2013,"September","2010s",67,46,24
"10976","201309220mia","Miami Dolphins",27,"Atlanta Falcons",23,50,4,TRUE,"9/22/2013",2013,"September","2010s",89,58,8
"10977","201309220sea","Seattle Seahawks",45,"Jacksonville Jaguars",17,62,28,TRUE,"9/22/2013",2013,"September","2010s",61,87,17
"10978","201309220dal","Dallas Cowboys",31,"St. Louis Rams",7,38,24,TRUE,"9/22/2013",2013,"September","2010s",0,NA,NA
"10979","201309220nor","New Orleans Saints",31,"Arizona Cardinals",7,38,24,TRUE,"9/22/2013",2013,"September","2010s",72,87,13
"10980","201309220cin","Cincinnati Bengals",34,"Green Bay Packers",30,64,4,TRUE,"9/22/2013",2013,"September","2010s",63,52,13
"10981","201309220sfo","San Francisco 49ers",7,"Indianapolis Colts",27,34,-20,FALSE,"9/22/2013",2013,"September","2010s",66,63,5
"10982","201309220rav","Baltimore Ravens",30,"Houston Texans",9,39,21,TRUE,"9/22/2013",2013,"September","2010s",73,44,9
"10983","201309220was","Washington Redskins",20,"Detroit Lions",27,47,-7,FALSE,"9/22/2013",2013,"September","2010s",72,51,8
"10984","201309230den","Denver Broncos",37,"Oakland Raiders",21,58,16,TRUE,"9/23/2013",2013,"September","2010s",64,28,16
"10985","201309260ram","St. Louis Rams",11,"San Francisco 49ers",35,46,-24,FALSE,"9/26/2013",2013,"September","2010s",0,NA,NA
"10986","201309290rai","Oakland Raiders",14,"Washington Redskins",24,38,-10,FALSE,"9/29/2013",2013,"September","2010s",77,52,13
"10987","201309290buf","Buffalo Bills",23,"Baltimore Ravens",20,43,3,TRUE,"9/29/2013",2013,"September","2010s",67,57,15
"10988","201309290oti","Tennessee Titans",38,"New York Jets",13,51,25,TRUE,"9/29/2013",2013,"September","2010s",74,51,4
"10989","201309290cle","Cleveland Browns",17,"Cincinnati Bengals",6,23,11,TRUE,"9/29/2013",2013,"September","2010s",68,67,9
"10990","201309290kan","Kansas City Chiefs",31,"New York Giants",7,38,24,TRUE,"9/29/2013",2013,"September","2010s",66,65,NA
"10991","201309290det","Detroit Lions",40,"Chicago Bears",32,72,8,TRUE,"9/29/2013",2013,"September","2010s",68,NA,NA
"10992","201309290jax","Jacksonville Jaguars",3,"Indianapolis Colts",37,40,-34,FALSE,"9/29/2013",2013,"September","2010s",80,65,12
"10993","201309290sdg","San Diego Chargers",30,"Dallas Cowboys",21,51,9,TRUE,"9/29/2013",2013,"September","2010s",80,27,7
"10994","201309290den","Denver Broncos",52,"Philadelphia Eagles",20,72,32,TRUE,"9/29/2013",2013,"September","2010s",76,16,8
"10995","201309290tam","Tampa Bay Buccaneers",10,"Arizona Cardinals",13,23,-3,FALSE,"9/29/2013",2013,"September","2010s",84,55,5
"10996","201309290min","Minnesota Vikings",34,"Pittsburgh Steelers",27,61,7,TRUE,"9/29/2013",2013,"September","2010s",54,86,11
"10997","201309290htx","Houston Texans",20,"Seattle Seahawks",23,43,-3,FALSE,"9/29/2013",2013,"September","2010s",78,90,8
"10998","201309290atl","Atlanta Falcons",23,"New England Patriots",30,53,-7,FALSE,"9/29/2013",2013,"September","2010s",0,NA,NA
"10999","201309300nor","New Orleans Saints",38,"Miami Dolphins",17,55,21,TRUE,"9/30/2013",2013,"September","2010s",79,81,3
"11000","201310030cle","Cleveland Browns",37,"Buffalo Bills",24,61,13,TRUE,"10/3/2013",2013,"October","2010s",75,73,6
"11001","201310060crd","Arizona Cardinals",22,"Carolina Panthers",6,28,16,TRUE,"10/6/2013",2013,"October","2010s",0,NA,NA
"11002","201310060sfo","San Francisco 49ers",34,"Houston Texans",3,37,31,TRUE,"10/6/2013",2013,"October","2010s",76,40,9
"11003","201310060mia","Miami Dolphins",23,"Baltimore Ravens",26,49,-3,FALSE,"10/6/2013",2013,"October","2010s",87,56,5
"11004","201310060gnb","Green Bay Packers",22,"Detroit Lions",9,31,13,TRUE,"10/6/2013",2013,"October","2010s",59,59,10
"11005","201310060dal","Dallas Cowboys",48,"Denver Broncos",51,99,-3,FALSE,"10/6/2013",2013,"October","2010s",0,NA,NA
"11006","201310060oti","Tennessee Titans",17,"Kansas City Chiefs",26,43,-9,FALSE,"10/6/2013",2013,"October","2010s",74,83,10
"11007","201310060rai","Oakland Raiders",27,"San Diego Chargers",17,44,10,TRUE,"10/6/2013",2013,"October","2010s",70,0,2
"11008","201310060cin","Cincinnati Bengals",13,"New England Patriots",6,19,7,TRUE,"10/6/2013",2013,"October","2010s",68,93,7
"11009","201310060ram","St. Louis Rams",34,"Jacksonville Jaguars",20,54,14,TRUE,"10/6/2013",2013,"October","2010s",0,NA,NA
"11010","201310060clt","Indianapolis Colts",34,"Seattle Seahawks",28,62,6,TRUE,"10/6/2013",2013,"October","2010s",56,90,6
"11011","201310060nyg","New York Giants",21,"Philadelphia Eagles",36,57,-15,FALSE,"10/6/2013",2013,"October","2010s",66,100,6
"11012","201310060chi","Chicago Bears",18,"New Orleans Saints",26,44,-8,FALSE,"10/6/2013",2013,"October","2010s",60,49,10
"11013","201310070atl","Atlanta Falcons",28,"New York Jets",30,58,-2,FALSE,"10/7/2013",2013,"October","2010s",0,NA,NA
"11014","201310100chi","Chicago Bears",27,"New York Giants",21,48,6,TRUE,"10/10/2013",2013,"October","2010s",63,74,10
"11015","201310130rav","Baltimore Ravens",17,"Green Bay Packers",19,36,-2,FALSE,"10/13/2013",2013,"October","2010s",61,83,10
"11016","201310130min","Minnesota Vikings",10,"Carolina Panthers",35,45,-25,FALSE,"10/13/2013",2013,"October","2010s",64,0,NA
"11017","201310130sfo","San Francisco 49ers",32,"Arizona Cardinals",20,52,12,TRUE,"10/13/2013",2013,"October","2010s",65,55,5
"11018","201310130nwe","New England Patriots",30,"New Orleans Saints",27,57,3,TRUE,"10/13/2013",2013,"October","2010s",59,57,7
"11019","201310130sea","Seattle Seahawks",20,"Tennessee Titans",13,33,7,TRUE,"10/13/2013",2013,"October","2010s",51,80,4
"11020","201310130kan","Kansas City Chiefs",24,"Oakland Raiders",7,31,17,TRUE,"10/13/2013",2013,"October","2010s",63,41,7
"11021","201310130tam","Tampa Bay Buccaneers",20,"Philadelphia Eagles",31,51,-11,FALSE,"10/13/2013",2013,"October","2010s",82,42,3
"11022","201310130cle","Cleveland Browns",17,"Detroit Lions",31,48,-14,FALSE,"10/13/2013",2013,"October","2010s",66,78,8
"11023","201310130dal","Dallas Cowboys",31,"Washington Redskins",16,47,15,TRUE,"10/13/2013",2013,"October","2010s",0,NA,NA
"11024","201310130nyj","New York Jets",6,"Pittsburgh Steelers",19,25,-13,FALSE,"10/13/2013",2013,"October","2010s",62,68,10
"11025","201310130buf","Buffalo Bills",24,"Cincinnati Bengals",27,51,-3,FALSE,"10/13/2013",2013,"October","2010s",65,70,11
"11026","201310130den","Denver Broncos",35,"Jacksonville Jaguars",19,54,16,TRUE,"10/13/2013",2013,"October","2010s",59,53,7
"11027","201310130htx","Houston Texans",13,"St. Louis Rams",38,51,-25,FALSE,"10/13/2013",2013,"October","2010s",73,94,5
"11028","201310140sdg","San Diego Chargers",19,"Indianapolis Colts",9,28,10,TRUE,"10/14/2013",2013,"October","2010s",69,69,13
"11029","201310170crd","Arizona Cardinals",22,"Seattle Seahawks",34,56,-12,FALSE,"10/17/2013",2013,"October","2010s",82,NA,7
"11030","201310200atl","Atlanta Falcons",31,"Tampa Bay Buccaneers",23,54,8,TRUE,"10/20/2013",2013,"October","2010s",0,NA,NA
"11031","201310200car","Carolina Panthers",30,"St. Louis Rams",15,45,15,TRUE,"10/20/2013",2013,"October","2010s",68,42,4
"11032","201310200pit","Pittsburgh Steelers",19,"Baltimore Ravens",16,35,3,TRUE,"10/20/2013",2013,"October","2010s",57,49,14
"11033","201310200gnb","Green Bay Packers",31,"Cleveland Browns",13,44,18,TRUE,"10/20/2013",2013,"October","2010s",46,65,8
"11034","201310200phi","Philadelphia Eagles",3,"Dallas Cowboys",17,20,-14,FALSE,"10/20/2013",2013,"October","2010s",60,39,13
"11035","201310200jax","Jacksonville Jaguars",6,"San Diego Chargers",24,30,-18,FALSE,"10/20/2013",2013,"October","2010s",73,0,12
"11036","201310200det","Detroit Lions",24,"Cincinnati Bengals",27,51,-3,FALSE,"10/20/2013",2013,"October","2010s",68,NA,NA
"11037","201310200nyj","New York Jets",30,"New England Patriots",27,57,3,TRUE,"10/20/2013",2013,"October","2010s",63,36,11
"11038","201310200kan","Kansas City Chiefs",17,"Houston Texans",16,33,1,TRUE,"10/20/2013",2013,"October","2010s",70,36,15
"11039","201310200clt","Indianapolis Colts",39,"Denver Broncos",33,72,6,TRUE,"10/20/2013",2013,"October","2010s",57,51,11
"11040","201310200mia","Miami Dolphins",21,"Buffalo Bills",23,44,-2,FALSE,"10/20/2013",2013,"October","2010s",87,57,5
"11041","201310200oti","Tennessee Titans",17,"San Francisco 49ers",31,48,-14,FALSE,"10/20/2013",2013,"October","2010s",68,32,3
"11042","201310200was","Washington Redskins",45,"Chicago Bears",41,86,4,TRUE,"10/20/2013",2013,"October","2010s",61,39,13
"11043","201310210nyg","New York Giants",23,"Minnesota Vikings",7,30,16,TRUE,"10/21/2013",2013,"October","2010s",57,63,4
"11044","201310240tam","Tampa Bay Buccaneers",13,"Carolina Panthers",31,44,-18,FALSE,"10/24/2013",2013,"October","2010s",70,53,5
"11045","201310270min","Minnesota Vikings",31,"Green Bay Packers",44,75,-13,FALSE,"10/27/2013",2013,"October","2010s",65,0,NA
"11046","201310270crd","Arizona Cardinals",27,"Atlanta Falcons",13,40,14,TRUE,"10/27/2013",2013,"October","2010s",0,NA,NA
"11047","201310270nwe","New England Patriots",27,"Miami Dolphins",17,44,10,TRUE,"10/27/2013",2013,"October","2010s",53,45,13
"11048","201310270rai","Oakland Raiders",21,"Pittsburgh Steelers",18,39,3,TRUE,"10/27/2013",2013,"October","2010s",56,81,17
"11049","201310270cin","Cincinnati Bengals",49,"New York Jets",9,58,40,TRUE,"10/27/2013",2013,"October","2010s",57,45,3
"11050","201310270nor","New Orleans Saints",35,"Buffalo Bills",17,52,18,TRUE,"10/27/2013",2013,"October","2010s",69,70,2
"11051","201310270jax","Jacksonville Jaguars",10,"San Francisco 49ers",42,52,-32,FALSE,"10/27/2013",2013,"October","2010s",60,63,13
"11052","201310270det","Detroit Lions",31,"Dallas Cowboys",30,61,1,TRUE,"10/27/2013",2013,"October","2010s",68,NA,NA
"11053","201310270den","Denver Broncos",45,"Washington Redskins",21,66,24,TRUE,"10/27/2013",2013,"October","2010s",69,14,8
"11054","201310270phi","Philadelphia Eagles",7,"New York Giants",15,22,-8,FALSE,"10/27/2013",2013,"October","2010s",56,40,13
"11055","201310270kan","Kansas City Chiefs",23,"Cleveland Browns",17,40,6,TRUE,"10/27/2013",2013,"October","2010s",52,46,4
"11056","201310280ram","St. Louis Rams",9,"Seattle Seahawks",14,23,-5,FALSE,"10/28/2013",2013,"October","2010s",0,NA,NA
"11057","201310310mia","Miami Dolphins",22,"Cincinnati Bengals",20,42,2,TRUE,"10/31/2013",2013,"October","2010s",79,76,8
"11058","201311030htx","Houston Texans",24,"Indianapolis Colts",27,51,-3,FALSE,"11/3/2013",2013,"November","2010s",60,78,6
"11059","201311030was","Washington Redskins",30,"San Diego Chargers",24,54,6,TRUE,"11/3/2013",2013,"November","2010s",57,41,20
"11060","201311030nyj","New York Jets",26,"New Orleans Saints",20,46,6,TRUE,"11/3/2013",2013,"November","2010s",48,53,14
"11061","201311030car","Carolina Panthers",34,"Atlanta Falcons",10,44,24,TRUE,"11/3/2013",2013,"November","2010s",62,41,12
"11062","201311030ram","St. Louis Rams",21,"Tennessee Titans",28,49,-7,FALSE,"11/3/2013",2013,"November","2010s",0,NA,NA
"11063","201311030dal","Dallas Cowboys",27,"Minnesota Vikings",23,50,4,TRUE,"11/3/2013",2013,"November","2010s",61,NA,6
"11064","201311030cle","Cleveland Browns",24,"Baltimore Ravens",18,42,6,TRUE,"11/3/2013",2013,"November","2010s",46,54,9
"11065","201311030sea","Seattle Seahawks",27,"Tampa Bay Buccaneers",24,51,3,TRUE,"11/3/2013",2013,"November","2010s",48,68,4
"11066","201311030nwe","New England Patriots",55,"Pittsburgh Steelers",31,86,24,TRUE,"11/3/2013",2013,"November","2010s",44,44,6
"11067","201311030rai","Oakland Raiders",20,"Philadelphia Eagles",49,69,-29,FALSE,"11/3/2013",2013,"November","2010s",62,30,6
"11068","201311030buf","Buffalo Bills",13,"Kansas City Chiefs",23,36,-10,FALSE,"11/3/2013",2013,"November","2010s",36,58,7
"11069","201311040gnb","Green Bay Packers",20,"Chicago Bears",27,47,-7,FALSE,"11/4/2013",2013,"November","2010s",49,77,14
"11070","201311070min","Minnesota Vikings",34,"Washington Redskins",27,61,7,TRUE,"11/7/2013",2013,"November","2010s",0,0,NA
"11071","201311100clt","Indianapolis Colts",8,"St. Louis Rams",38,46,-30,FALSE,"11/10/2013",2013,"November","2010s",45,54,11
"11072","201311100atl","Atlanta Falcons",10,"Seattle Seahawks",33,43,-23,FALSE,"11/10/2013",2013,"November","2010s",0,NA,NA
"11073","201311100sdg","San Diego Chargers",20,"Denver Broncos",28,48,-8,FALSE,"11/10/2013",2013,"November","2010s",78,14,6
"11074","201311100oti","Tennessee Titans",27,"Jacksonville Jaguars",29,56,-2,FALSE,"11/10/2013",2013,"November","2010s",62,40,6
"11075","201311100sfo","San Francisco 49ers",9,"Carolina Panthers",10,19,-1,FALSE,"11/10/2013",2013,"November","2010s",62,65,6
"11076","201311100gnb","Green Bay Packers",13,"Philadelphia Eagles",27,40,-14,FALSE,"11/10/2013",2013,"November","2010s",45,48,12
"11077","201311100crd","Arizona Cardinals",27,"Houston Texans",24,51,3,TRUE,"11/10/2013",2013,"November","2010s",0,NA,NA
"11078","201311100nyg","New York Giants",24,"Oakland Raiders",20,44,4,TRUE,"11/10/2013",2013,"November","2010s",49,71,14
"11079","201311100chi","Chicago Bears",19,"Detroit Lions",21,40,-2,FALSE,"11/10/2013",2013,"November","2010s",47,51,6
"11080","201311100nor","New Orleans Saints",49,"Dallas Cowboys",17,66,32,TRUE,"11/10/2013",2013,"November","2010s",69,65,2
"11081","201311100rav","Baltimore Ravens",20,"Cincinnati Bengals",17,37,3,TRUE,"11/10/2013",2013,"November","2010s",60,36,17
"11082","201311100pit","Pittsburgh Steelers",23,"Buffalo Bills",10,33,13,TRUE,"11/10/2013",2013,"November","2010s",46,56,21
"11083","201311110tam","Tampa Bay Buccaneers",22,"Miami Dolphins",19,41,3,TRUE,"11/11/2013",2013,"November","2010s",73,74,5
"11084","201311140oti","Tennessee Titans",27,"Indianapolis Colts",30,57,-3,FALSE,"11/14/2013",2013,"November","2010s",44,36,3
"11085","201311170htx","Houston Texans",23,"Oakland Raiders",28,51,-5,FALSE,"11/17/2013",2013,"November","2010s",82,75,3
"11086","201311170pit","Pittsburgh Steelers",37,"Detroit Lions",27,64,10,TRUE,"11/17/2013",2013,"November","2010s",60,87,12
"11087","201311170nor","New Orleans Saints",23,"San Francisco 49ers",20,43,3,TRUE,"11/17/2013",2013,"November","2010s",79,NA,10
"11088","201311170tam","Tampa Bay Buccaneers",41,"Atlanta Falcons",28,69,13,TRUE,"11/17/2013",2013,"November","2010s",79,74,6
"11089","201311170sea","Seattle Seahawks",41,"Minnesota Vikings",20,61,21,TRUE,"11/17/2013",2013,"November","2010s",50,81,14
"11090","201311170nyg","New York Giants",27,"Green Bay Packers",13,40,14,TRUE,"11/17/2013",2013,"November","2010s",59,100,2
"11091","201311170chi","Chicago Bears",23,"Baltimore Ravens",20,43,3,TRUE,"11/17/2013",2013,"November","2010s",68,82,17
"11092","201311170jax","Jacksonville Jaguars",14,"Arizona Cardinals",27,41,-13,FALSE,"11/17/2013",2013,"November","2010s",76,0,8
"11093","201311170mia","Miami Dolphins",20,"San Diego Chargers",16,36,4,TRUE,"11/17/2013",2013,"November","2010s",81,67,12
"11094","201311170den","Denver Broncos",27,"Kansas City Chiefs",17,44,10,TRUE,"11/17/2013",2013,"November","2010s",43,34,6
"11095","201311170cin","Cincinnati Bengals",41,"Cleveland Browns",20,61,21,TRUE,"11/17/2013",2013,"November","2010s",62,92,7
"11096","201311170buf","Buffalo Bills",37,"New York Jets",14,51,23,TRUE,"11/17/2013",2013,"November","2010s",62,71,14
"11097","201311170phi","Philadelphia Eagles",24,"Washington Redskins",16,40,8,TRUE,"11/17/2013",2013,"November","2010s",64,71,7
"11098","201311180car","Carolina Panthers",24,"New England Patriots",20,44,4,TRUE,"11/18/2013",2013,"November","2010s",59,35,8
"11099","201311210atl","Atlanta Falcons",13,"New Orleans Saints",17,30,-4,FALSE,"11/21/2013",2013,"November","2010s",0,NA,NA
"11100","201311240ram","St. Louis Rams",42,"Chicago Bears",21,63,21,TRUE,"11/24/2013",2013,"November","2010s",0,NA,NA
"11101","201311240rav","Baltimore Ravens",19,"New York Jets",3,22,16,TRUE,"11/24/2013",2013,"November","2010s",33,23,26
"11102","201311240htx","Houston Texans",6,"Jacksonville Jaguars",13,19,-7,FALSE,"11/24/2013",2013,"November","2010s",45,55,15
"11103","201311240rai","Oakland Raiders",19,"Tennessee Titans",23,42,-4,FALSE,"11/24/2013",2013,"November","2010s",58,56,5
"11104","201311240mia","Miami Dolphins",16,"Carolina Panthers",20,36,-4,FALSE,"11/24/2013",2013,"November","2010s",82,55,13
"11105","201311240crd","Arizona Cardinals",40,"Indianapolis Colts",11,51,29,TRUE,"11/24/2013",2013,"November","2010s",0,NA,NA
"11106","201311240det","Detroit Lions",21,"Tampa Bay Buccaneers",24,45,-3,FALSE,"11/24/2013",2013,"November","2010s",68,NA,NA
"11107","201311240gnb","Green Bay Packers",26,"Minnesota Vikings",26,52,0,FALSE,"11/24/2013",2013,"November","2010s",19,52,10
"11108","201311240kan","Kansas City Chiefs",38,"San Diego Chargers",41,79,-3,FALSE,"11/24/2013",2013,"November","2010s",24,50,3
"11109","201311240nwe","New England Patriots",34,"Denver Broncos",31,65,3,TRUE,"11/24/2013",2013,"November","2010s",22,29,22
"11110","201311240nyg","New York Giants",21,"Dallas Cowboys",24,45,-3,FALSE,"11/24/2013",2013,"November","2010s",25,40,6
"11111","201311240cle","Cleveland Browns",11,"Pittsburgh Steelers",27,38,-16,FALSE,"11/24/2013",2013,"November","2010s",20,84,31
"11112","201311250was","Washington Redskins",6,"San Francisco 49ers",27,33,-21,FALSE,"11/25/2013",2013,"November","2010s",35,37,12
"11113","201311280rav","Baltimore Ravens",22,"Pittsburgh Steelers",20,42,2,TRUE,"11/28/2013",2013,"November","2010s",37,39,2
"11114","201311280det","Detroit Lions",40,"Green Bay Packers",10,50,30,TRUE,"11/28/2013",2013,"November","2010s",68,NA,NA
"11115","201311280dal","Dallas Cowboys",31,"Oakland Raiders",24,55,7,TRUE,"11/28/2013",2013,"November","2010s",0,NA,NA
"11116","201312010htx","Houston Texans",31,"New England Patriots",34,65,-3,FALSE,"12/1/2013",2013,"December","2010s",64,72,7
"11117","201312010min","Minnesota Vikings",23,"Chicago Bears",20,43,3,TRUE,"12/1/2013",2013,"December","2010s",66,0,NA
"11118","201312010clt","Indianapolis Colts",22,"Tennessee Titans",14,36,8,TRUE,"12/1/2013",2013,"December","2010s",51,53,7
"11119","201312010phi","Philadelphia Eagles",24,"Arizona Cardinals",21,45,3,TRUE,"12/1/2013",2013,"December","2010s",46,53,4
"11120","201312010car","Carolina Panthers",27,"Tampa Bay Buccaneers",6,33,21,TRUE,"12/1/2013",2013,"December","2010s",56,55,2
"11121","201312010sfo","San Francisco 49ers",23,"St. Louis Rams",13,36,10,TRUE,"12/1/2013",2013,"December","2010s",59,72,6
"11122","201312010cle","Cleveland Browns",28,"Jacksonville Jaguars",32,60,-4,FALSE,"12/1/2013",2013,"December","2010s",40,61,7
"11123","201312010kan","Kansas City Chiefs",28,"Denver Broncos",35,63,-7,FALSE,"12/1/2013",2013,"December","2010s",55,47,4
"11124","201312010buf","Buffalo Bills",31,"Atlanta Falcons",34,65,-3,FALSE,"12/1/2013",2013,"December","2010s",0,NA,NA
"11125","201312010sdg","San Diego Chargers",10,"Cincinnati Bengals",17,27,-7,FALSE,"12/1/2013",2013,"December","2010s",77,26,5
"11126","201312010nyj","New York Jets",3,"Miami Dolphins",23,26,-20,FALSE,"12/1/2013",2013,"December","2010s",48,59,4
"11127","201312010was","Washington Redskins",17,"New York Giants",24,41,-7,FALSE,"12/1/2013",2013,"December","2010s",43,72,NA
"11128","201312020sea","Seattle Seahawks",34,"New Orleans Saints",7,41,27,TRUE,"12/2/2013",2013,"December","2010s",41,62,6
"11129","201312050jax","Jacksonville Jaguars",27,"Houston Texans",20,47,7,TRUE,"12/5/2013",2013,"December","2010s",72,73,7
"11130","201312080sdg","San Diego Chargers",37,"New York Giants",14,51,23,TRUE,"12/8/2013",2013,"December","2010s",53,53,8
"11131","201312080sfo","San Francisco 49ers",19,"Seattle Seahawks",17,36,2,TRUE,"12/8/2013",2013,"December","2010s",43,49,5
"11132","201312080pit","Pittsburgh Steelers",28,"Miami Dolphins",34,62,-6,FALSE,"12/8/2013",2013,"December","2010s",25,73,9
"11133","201312080nwe","New England Patriots",27,"Cleveland Browns",26,53,1,TRUE,"12/8/2013",2013,"December","2010s",30,46,5
"11134","201312080phi","Philadelphia Eagles",34,"Detroit Lions",20,54,14,TRUE,"12/8/2013",2013,"December","2010s",27,56,6
"11135","201312080gnb","Green Bay Packers",22,"Atlanta Falcons",21,43,1,TRUE,"12/8/2013",2013,"December","2010s",9,80,6
"11136","201312080was","Washington Redskins",10,"Kansas City Chiefs",45,55,-35,FALSE,"12/8/2013",2013,"December","2010s",30,79,10
"11137","201312080cin","Cincinnati Bengals",42,"Indianapolis Colts",28,70,14,TRUE,"12/8/2013",2013,"December","2010s",25,85,7
"11138","201312080den","Denver Broncos",51,"Tennessee Titans",28,79,23,TRUE,"12/8/2013",2013,"December","2010s",18,63,5
"11139","201312080nyj","New York Jets",37,"Oakland Raiders",27,64,10,TRUE,"12/8/2013",2013,"December","2010s",33,51,6
"11140","201312080crd","Arizona Cardinals",30,"St. Louis Rams",10,40,20,TRUE,"12/8/2013",2013,"December","2010s",0,NA,12
"11141","201312080rav","Baltimore Ravens",29,"Minnesota Vikings",26,55,3,TRUE,"12/8/2013",2013,"December","2010s",33,67,7
"11142","201312080tam","Tampa Bay Buccaneers",27,"Buffalo Bills",6,33,21,TRUE,"12/8/2013",2013,"December","2010s",82,62,13
"11143","201312080nor","New Orleans Saints",31,"Carolina Panthers",13,44,18,TRUE,"12/8/2013",2013,"December","2010s",52,NA,5
"11144","201312090chi","Chicago Bears",45,"Dallas Cowboys",28,73,17,TRUE,"12/9/2013",2013,"December","2010s",8,63,14
"11145","201312120den","Denver Broncos",20,"San Diego Chargers",27,47,-7,FALSE,"12/12/2013",2013,"December","2010s",37,50,2
"11146","201312150clt","Indianapolis Colts",25,"Houston Texans",3,28,22,TRUE,"12/15/2013",2013,"December","2010s",20,64,13
"11147","201312150pit","Pittsburgh Steelers",30,"Cincinnati Bengals",20,50,10,TRUE,"12/15/2013",2013,"December","2010s",26,66,20
"11148","201312150mia","Miami Dolphins",24,"New England Patriots",20,44,4,TRUE,"12/15/2013",2013,"December","2010s",84,70,14
"11149","201312150jax","Jacksonville Jaguars",20,"Buffalo Bills",27,47,-7,FALSE,"12/15/2013",2013,"December","2010s",60,0,20
"11150","201312150tam","Tampa Bay Buccaneers",14,"San Francisco 49ers",33,47,-19,FALSE,"12/15/2013",2013,"December","2010s",70,64,7
"11151","201312150min","Minnesota Vikings",48,"Philadelphia Eagles",30,78,18,TRUE,"12/15/2013",2013,"December","2010s",66,0,NA
"11152","201312150dal","Dallas Cowboys",36,"Green Bay Packers",37,73,-1,FALSE,"12/15/2013",2013,"December","2010s",0,NA,NA
"11153","201312150ram","St. Louis Rams",27,"New Orleans Saints",16,43,11,TRUE,"12/15/2013",2013,"December","2010s",0,NA,NA
"11154","201312150atl","Atlanta Falcons",27,"Washington Redskins",26,53,1,TRUE,"12/15/2013",2013,"December","2010s",0,NA,NA
"11155","201312150nyg","New York Giants",0,"Seattle Seahawks",23,23,-23,FALSE,"12/15/2013",2013,"December","2010s",36,88,7
"11156","201312150car","Carolina Panthers",30,"New York Jets",20,50,10,TRUE,"12/15/2013",2013,"December","2010s",54,47,11
"11157","201312150cle","Cleveland Browns",31,"Chicago Bears",38,69,-7,FALSE,"12/15/2013",2013,"December","2010s",25,82,12
"11158","201312150rai","Oakland Raiders",31,"Kansas City Chiefs",56,87,-25,FALSE,"12/15/2013",2013,"December","2010s",64,39,6
"11159","201312150oti","Tennessee Titans",34,"Arizona Cardinals",37,71,-3,FALSE,"12/15/2013",2013,"December","2010s",37,64,4
"11160","201312160det","Detroit Lions",16,"Baltimore Ravens",18,34,-2,FALSE,"12/16/2013",2013,"December","2010s",68,NA,NA
"11161","201312220kan","Kansas City Chiefs",7,"Indianapolis Colts",23,30,-16,FALSE,"12/22/2013",2013,"December","2010s",22,84,10
"11162","201312220det","Detroit Lions",20,"New York Giants",23,43,-3,FALSE,"12/22/2013",2013,"December","2010s",68,NA,NA
"11163","201312220htx","Houston Texans",13,"Denver Broncos",37,50,-24,FALSE,"12/22/2013",2013,"December","2010s",58,79,3
"11164","201312220ram","St. Louis Rams",23,"Tampa Bay Buccaneers",13,36,10,TRUE,"12/22/2013",2013,"December","2010s",0,NA,NA
"11165","201312220cin","Cincinnati Bengals",42,"Minnesota Vikings",14,56,28,TRUE,"12/22/2013",2013,"December","2010s",53,80,11
"11166","201312220sea","Seattle Seahawks",10,"Arizona Cardinals",17,27,-7,FALSE,"12/22/2013",2013,"December","2010s",48,94,6
"11167","201312220nyj","New York Jets",24,"Cleveland Browns",13,37,11,TRUE,"12/22/2013",2013,"December","2010s",70,65,12
"11168","201312220buf","Buffalo Bills",19,"Miami Dolphins",0,19,19,TRUE,"12/22/2013",2013,"December","2010s",41,79,8
"11169","201312220jax","Jacksonville Jaguars",16,"Tennessee Titans",20,36,-4,FALSE,"12/22/2013",2013,"December","2010s",79,0,13
"11170","201312220was","Washington Redskins",23,"Dallas Cowboys",24,47,-1,FALSE,"12/22/2013",2013,"December","2010s",65,92,5
"11171","201312220car","Carolina Panthers",17,"New Orleans Saints",13,30,4,TRUE,"12/22/2013",2013,"December","2010s",72,84,18
"11172","201312220sdg","San Diego Chargers",26,"Oakland Raiders",13,39,13,TRUE,"12/22/2013",2013,"December","2010s",67,45,7
"11173","201312220rav","Baltimore Ravens",7,"New England Patriots",41,48,-34,FALSE,"12/22/2013",2013,"December","2010s",65,75,8
"11174","201312220gnb","Green Bay Packers",31,"Pittsburgh Steelers",38,69,-7,FALSE,"12/22/2013",2013,"December","2010s",23,78,13
"11175","201312220phi","Philadelphia Eagles",54,"Chicago Bears",11,65,43,TRUE,"12/22/2013",2013,"December","2010s",62,82,11
"11176","201312230sfo","San Francisco 49ers",34,"Atlanta Falcons",24,58,10,TRUE,"12/23/2013",2013,"December","2010s",60,49,NA
"11177","201312290sea","Seattle Seahawks",27,"St. Louis Rams",9,36,18,TRUE,"12/29/2013",2013,"December","2010s",40,93,5
"11178","201312290crd","Arizona Cardinals",20,"San Francisco 49ers",23,43,-3,FALSE,"12/29/2013",2013,"December","2010s",64,NA,5
"11179","201312290dal","Dallas Cowboys",22,"Philadelphia Eagles",24,46,-2,FALSE,"12/29/2013",2013,"December","2010s",0,NA,NA
"11180","201312290chi","Chicago Bears",28,"Green Bay Packers",33,61,-5,FALSE,"12/29/2013",2013,"December","2010s",26,88,16
"11181","201312290oti","Tennessee Titans",16,"Houston Texans",10,26,6,TRUE,"12/29/2013",2013,"December","2010s",53,61,4
"11182","201312290sdg","San Diego Chargers",27,"Kansas City Chiefs",24,51,3,TRUE,"12/29/2013",2013,"December","2010s",73,14,1
"11183","201312290nor","New Orleans Saints",42,"Tampa Bay Buccaneers",17,59,25,TRUE,"12/29/2013",2013,"December","2010s",56,NA,7
"11184","201312290nyg","New York Giants",20,"Washington Redskins",6,26,14,TRUE,"12/29/2013",2013,"December","2010s",40,100,2
"11185","201312290clt","Indianapolis Colts",30,"Jacksonville Jaguars",10,40,20,TRUE,"12/29/2013",2013,"December","2010s",43,68,13
"11186","201312290cin","Cincinnati Bengals",34,"Baltimore Ravens",17,51,17,TRUE,"12/29/2013",2013,"December","2010s",43,93,3
"11187","201312290min","Minnesota Vikings",14,"Detroit Lions",13,27,1,TRUE,"12/29/2013",2013,"December","2010s",0,0,NA
"11188","201312290nwe","New England Patriots",34,"Buffalo Bills",20,54,14,TRUE,"12/29/2013",2013,"December","2010s",39,100,8
"11189","201312290atl","Atlanta Falcons",20,"Carolina Panthers",21,41,-1,FALSE,"12/29/2013",2013,"December","2010s",0,NA,NA
"11190","201312290pit","Pittsburgh Steelers",20,"Cleveland Browns",7,27,13,TRUE,"12/29/2013",2013,"December","2010s",40,93,5
"11191","201312290rai","Oakland Raiders",14,"Denver Broncos",34,48,-20,FALSE,"12/29/2013",2013,"December","2010s",70,16,8
"11192","201312290mia","Miami Dolphins",7,"New York Jets",20,27,-13,FALSE,"12/29/2013",2013,"December","2010s",79,84,12
